,answers_question_id,answers_date_added,answers_id,answers_author_id,score,comments,q_score,n_score,total_score
7773,000b30fb534b41f7b716fa9ebf9c3f35,2016-05-19 18:54:34 UTC+0000,987a377658c0439a8f1e74117531eb2a,9d3d0927a8684e179eaf640c9dfd66ac,0,5,1,0,6
2766,002b07f6281a407ca49ee8b3538e5e45,2014-11-07 23:33:24 UTC+0000,698be6047aa246788a610aebc9f1f2db,c12dff6c1c844bac95ce8a96e8a47c61,3,12,1,1,14
3269,00361e5dda874e65abaeeceb12c8e10c,2018-11-14 17:40:01 UTC+0000,f6c60d3eda104ece8a8aa74745f4fe54,38780fb1cb0b4d5594af5c402ef4e3b3,0,1,1,0,2
7747,0037ccbe4467439490e660f606addf2b,2018-02-07 03:52:59 UTC+0000,478125b32a4f41d49a3d9eb37c3beef0,ef8a09c1c2af45aab9f7cefc16f98cd5,3,1,1,1,3
1190,006b9cf69cd0405ea0a8821c5f6641bb,2016-12-01 18:57:49 UTC+0000,0eb97b322dc84bea922833ca09168ccc,96bbbdd06a334805a0501034d9df1aa4,2,1,1,1,3
6651,006e23b28b5b4ae2b6b66ce5ae28d231,2015-03-22 07:15:54 UTC+0000,b1a3d16fa83c4af490ff1a64b1fe951f,9a0f09620c6640718c1792a74f3b8438,1,2,1,1,4
3502,007e32d9843d496580d8dd326d1038ab,2018-07-27 02:31:29 UTC+0000,2dff1e8dcf9348aa8c87533aa74f0ce3,1448eaee44de457f921e34fcdf3fc3d7,1,1,1,1,3
3233,0082a81f55d8445ea31d67b35ca5fc0c,2018-02-09 00:00:47 UTC+0000,3425b006cc2b417a8b8bdb8d1c668727,e6b29607f1504bc9bdb81783016df845,1,2,1,1,4
3617,00886edc59f34c89b52e210bc562def3,2017-07-07 13:48:30 UTC+0000,5f28e43bfdbe4bc8ae9341fb69b976ee,aed64d429e1d4bc8b07ea9c1d1ac477f,0,1,1,0,2
1285,009ad5c6266b4b029047872610f6a33a,2016-05-31 02:41:46 UTC+0000,02d0c8d3b5184aec8aa9df5043d7bd2f,d954f43c12544dbc8cc5f2f30215ac0f,0,1,1,0,2
7201,00a6447554d6452fa74e240989fac724,2016-05-19 00:56:08 UTC+0000,d0cdba9ef9a34621989b2c66c625764b,faa0fe0510804c4abeffc171acf37ba2,2,1,1,1,3
3119,00af17f102364c39803fd9d1c6712d30,2018-01-24 19:46:08 UTC+0000,635ca4175c6a4d59bceeb1677f5ccb4a,4f3f080d728144d9b57a72f6533101fa,1,2,1,1,4
5218,00b6f892cf014382aba96e32e355e0c9,2017-10-10 22:37:47 UTC+0000,1de366e81e7249dfa9caf5f0185bebb1,8a83ebd257fb4881a2a65ae490e489ed,1,1,1,1,3
5819,00bbc2e889c54feaae9f9afe1215ef6f,2012-05-24 04:19:35 UTC+0000,165eec1a177b48fbaa5c5f38b062a6db,9c5803ae43ca4cf6b27ea85871625116,1,1,1,1,3
873,00c35c40a847415ab369704238ecc233,2016-03-02 17:52:29 UTC+0000,abeebe85c0d64a0b84d1fe4a038ceac0,13b55ed4834e4814bb33a4c87001063d,0,1,1,0,2
7415,00cac59c62344eb98bd2c2c88035a382,2014-11-28 21:28:46 UTC+0000,f5af3eb8b5eb4154974973d432df06df,3d8847ddc8d04185976a9e78b190ebdb,0,3,1,0,4
6585,00d405da29124997990ccfed5a0992ec,2012-01-20 23:51:00 UTC+0000,5a1ab3a7033845f2af0215e63767304b,1e4cc96c24344c8b806c26c3e6746167,3,1,1,1,3
1634,00dade341ee14b8d958e60c3dedeb24f,2016-04-06 20:54:15 UTC+0000,cd5ed5d6beb0482587f405f2bed46dc2,26caab3de1234f71993dff7c914c42c8,2,2,1,1,4
6475,00e934af910e4c92a530e169764ca3f6,2014-04-09 03:55:45 UTC+0000,98eec7bbb3b44031b97a29dc2f86e58d,4b7737cb8c46400795bdba3a4f333997,2,4,1,1,6
6169,0101882734ae49bab36a0e26d63406ce,2014-04-07 20:58:33 UTC+0000,bc956f3ca92641579aad7c78b108f62d,c84b7719b1e14c80a5ad3ab52dddad3b,1,1,1,1,3
2166,010654d937aa427e9eaf794e6503f738,2016-12-12 23:49:44 UTC+0000,d50aa866903a46e3969f8102578caa79,416321b48a634ac8a53602625f0a5d40,2,2,1,1,4
4146,010f5ca446fd41d2a5a82c4b6d65462f,2018-03-20 03:45:48 UTC+0000,38f5dd14e95742928f394f739c9d65e9,720e334c824e48fa914ccdd60a8ed706,1,1,1,1,3
3284,011092d9921744529c62a3c4e3b06315,2016-10-13 00:57:16 UTC+0000,66d15fd3e9dd4b92a3d70499f345b826,e49afb6abdd945499c657e92dee5667f,0,1,1,0,2
1408,0112173b65854f6f9183e7e3a6c74b98,2016-01-06 17:13:06 UTC+0000,153a7f93d6654552817f1229a07a21bf,6ad3f70feab84008adc5d271190a813b,1,3,1,1,5
3869,0122d9d3f7d4419a9131bebba94a8072,2016-05-16 17:44:13 UTC+0000,a1ac9c5ab79c4e67943a36f62501cd6a,04df52cae7db418faf5f9b285799ea5d,0,1,1,0,2
806,012fe68d05d24405b749274cd24e35f5,2016-05-02 23:10:04 UTC+0000,dfd6fe9dd75749a29f7e8c48d5d9d53a,9ff0eb71ca934790859ca1bd0ed523a7,0,1,1,0,2
5685,013d0aca75b548348fc10b918d39a831,2016-06-02 13:59:11 UTC+0000,920ae495641643dbb0441e6f17bbb861,2e0e85c9b38f44c9be0e0834e15c1894,3,3,1,1,5
191,013f0ece517b4f428f80e768085a0cde,2016-05-15 13:24:10 UTC+0000,fa537564b5d143c98c6dda52c5d787b6,58fa5e95fe9e480a9349bbb1d7faaddb,1,2,1,1,4
1531,0145b78807054747b374185fc5eac383,2016-07-31 18:10:20 UTC+0000,a2f9c93853c041a58fd3eb77fe06c6b3,58fa5e95fe9e480a9349bbb1d7faaddb,1,2,1,1,4
4729,0148cdb3c71243449e1579bf71789557,2017-10-30 18:37:57 UTC+0000,329631501dbc4ec683db4536111aed56,96665262f1a841bc86f5a4fe7e24814a,1,1,1,1,3
5672,01494fcc92b14c688aa2e0f036798e2e,2017-01-18 18:48:45 UTC+0000,dff23c6bcaa84d60a0df69ab380b58da,dbfc21fbff414832beed41c7a5966096,5,8,0,1,9
1085,01556fb7ca424fb1b646fc4c2448faba,2017-04-01 15:37:02 UTC+0000,29b0614f65cf4b6cbd6620dbfbf8f2ce,be5d23056fcb4f1287c823beec5291e1,0,1,1,0,2
1817,01576b2e3102418388d3bd02c200ca4c,2017-04-27 01:16:45 UTC+0000,f15ee191d8aa46d99989bb08699f4e4e,78523f2890474f82b6b838d7b4ea12f8,1,1,1,1,3
134,016925d357484fbdaaafd81c8fb188a6,2014-04-28 02:36:23 UTC+0000,0e4a209f736a4fc0939d26dc0441f520,e4e7cc05a0b64cd6b02168d404a45d4f,4,1,1,1,3
2432,01823e920865463abff3ad98c5531688,2016-06-03 00:58:44 UTC+0000,161704e28df941c0a846b80f3b98824f,c232fdc3917c48ffbb7c9375a460d358,0,1,1,0,2
6505,01a7dd10813e49a68a4135ac13e75b61,2017-10-19 16:30:40 UTC+0000,5ea796911c7a44ffac8998bd721af09e,7919ea19db274c1fb862f3456cd25ac5,1,1,1,1,3
1201,01b0dc3884774163a7283f572aef8863,2018-11-14 17:57:50 UTC+0000,9d64730c5ce343ed81baed11e95e0ade,da0a1ad0a15b4679b71334c176bfd9fb,1,2,1,1,4
4494,01b203b2f6564c38a204c78544d3ac8a,2018-08-23 12:37:50 UTC+0000,1e4ba66f8ffa4b35b23faca5000e5cf4,589e6afb217b4445849ab7b12a871c7e,0,2,1,0,3
5311,01b7df7273454b88aec945a9b4c4caed,2016-03-01 18:58:37 UTC+0000,37b40a1be7324659b7c60b71ce98512a,ed54d56550da44a897658c588dd5032a,1,1,1,1,3
1966,01e57b939e2e4d018dea0aefee6b5ddb,2012-10-01 21:36:57 UTC+0000,b5ad68eff41447d2a353886f57933def,560a4bb63dad4df7b9a81efa29c11231,1,1,1,1,3
5563,01f50b35c9fb4013b7c7192f70670b35,2017-01-04 13:55:27 UTC+0000,bb7b582f1b3f400a8c650655275f7beb,369f1c8646b649f6997eae7809696bd5,1,1,1,1,3
7494,01fb0f9c3b1a4e32af6538e97b07859a,2018-06-22 18:44:11 UTC+0000,dceaec6280b9400e9f1a5e5b458a032e,cb3d08d074bf4e2eb4c94c66d3f26b19,1,1,1,1,3
3329,01ff2888e5fc4258b5d1af25fe9dd79c,2015-06-18 18:08:31 UTC+0000,260f236a8b7d4209bd0552fafa3ccf3f,a1006e6a58a0447592e2435caa230f78,1,2,1,1,4
4609,0227ac7df92842848cc531933b008e3b,2018-03-07 04:48:07 UTC+0000,c373189611f24b14924e83caa5526af2,1bfcd309eb354ee7b56ae36b60e86ef9,0,1,1,0,2
5605,0244584b7fd6416096d96d9dc6e31545,2016-05-05 21:43:37 UTC+0000,8964cc44cb004d08b679e56845ad86c7,97b06576926641838472728d198cefea,1,1,1,1,3
2558,024bff1d623044d685bf464d18dfcb42,2018-03-22 14:25:14 UTC+0000,850bd425a94d4ddfb31c74dc48dec95d,ba6c53e199cc466cb30ba3508f4286c0,1,1,1,1,3
1941,0270df45c1354eaba662cfce255e15b8,2017-01-17 00:59:10 UTC+0000,6c0da78acc2c486ab4b0875db7f384e2,a1006e6a58a0447592e2435caa230f78,0,2,1,0,3
6429,02729beecd9e4871be45c9a8284bb892,2018-06-16 05:40:16 UTC+0000,120b144ae67e4919874b363b3a7f3cf1,30a510b81eed40d08fc5e5fefdd87226,0,1,1,0,2
345,0273da1250624d8f80498be3481556fa,2017-04-29 20:57:21 UTC+0000,9dc61ed10d764dc2b76d7da388a582ae,be5d23056fcb4f1287c823beec5291e1,1,4,0,1,5
7419,027722cb9e284abda9b3f05dcd3baf0f,2016-05-24 23:05:02 UTC+0000,883d3c0dd70e4a0088220b9d20063281,030fcbbba31647938b176a90c04e38df,1,1,1,1,3
2282,027973e076fa412e8af77a89c89689f1,2015-02-26 00:23:30 UTC+0000,c7e94ad46a004f28a77a1412a13cf4dc,52878292c36242328763dceaf8002e53,3,3,1,1,5
4315,027ab0d4629a46988ea1776bf54b2be1,2016-04-17 00:16:23 UTC+0000,7eb96dc4f21142debc4bfa0db0e0f1a1,58fa5e95fe9e480a9349bbb1d7faaddb,1,5,1,1,7
6011,027ecc7704c346f598a0b6584e3f3c88,2014-04-07 15:42:05 UTC+0000,a63b61b577f54fb78ffe6f032d8b7efa,861fca48f47c4fccae43a799f4442684,2,1,1,1,3
7539,0281ea4572e248e3be4214e6f25687d2,2015-10-13 15:52:02 UTC+0000,4f7b889d90cd47eeb1fc2d13d7c0cdcd,c3c345b8e5044054a0544296ac29cb88,1,1,1,1,3
1545,0284380052104b3aba7e485541a36915,2016-03-01 17:03:57 UTC+0000,66172aaca725498c8042546576b7f31c,7d425e8d7cfb4fe7b0702fff4d6d84e7,1,1,1,1,3
2612,0285ed4ea0a348f9900f3526775b3648,2016-05-23 23:25:18 UTC+0000,cd3df35652fe4873a4c5e67ffaecd926,9798c8df06244283ba14d30978ec318a,0,1,1,0,2
406,028dcf3059fc4f80941505cbc9d5ca66,2015-03-04 13:25:08 UTC+0000,e9384a5bd54a4fc783002f888feda7fc,8526230b44c94173b69d71d5d2faa161,2,4,1,1,6
6682,02a8a9a67fb4420cad28401d9d1b37a3,2012-01-25 20:53:32 UTC+0000,7f3aea0e7e7f416ba2cc7b0ffe8297be,44b2484ecd3642c6a47514f3876cf14a,1,1,1,1,3
7197,02b4da1dec564e8490f33f02bdd8ef30,2014-08-08 08:59:28 UTC+0000,755704be7231469aa26543534309dcd2,16ab1a87349a47ceabf559df71f4cf4d,0,1,1,0,2
5757,02bb0b353a134b3ab6419f3363403e84,2015-01-27 17:26:53 UTC+0000,fc6cb34eabf14aa2bd371bff0812eeda,13b55ed4834e4814bb33a4c87001063d,2,1,1,1,3
1094,02bdb7101f904440af04c3c869136963,2014-04-26 22:16:07 UTC+0000,bcd537d6ed1f4ce2bbdcc9db38d55fe8,fe4543418c0846e5a65fa22b4ad9a304,4,4,1,1,6
3907,02ced82d7d3b4023a527453e143dcc85,2016-05-02 17:50:21 UTC+0000,7d2a5fcef3b74e11bb4f5402bd2e0467,fe5fc534894e45c191e87f8c2ea0c6bd,0,1,1,0,2
4061,02dac0fbf2804e9ab5e146a10178d26a,2018-01-16 18:59:14 UTC+0000,06544021914e42c0a47da4c72c499eb6,f46b9949552c49fcaea5c9aa624e2ddd,0,1,1,0,2
1580,02e3a794cf044a0bbf7f4bf67d5c4d3f,2014-06-03 19:00:27 UTC+0000,4794c024b85e4d6094e0504046954b2c,4e83c480115f4088863b058efd376760,2,1,1,1,3
1863,02efe7d75dd04a54959ee4b6b2b88890,2016-05-18 01:56:30 UTC+0000,b388e0de07d442aab88f3360b255c78e,8b00da59556b47ec82c295c4a5c911c1,1,1,1,1,3
6954,030234efee344a9587c9272b3b6c1848,2014-05-06 23:30:26 UTC+0000,c4ce423dc2914b67802dda05951582eb,e0fbfa616ab7409b8263f4afa590fcc1,1,2,1,1,4
592,0321db659be44db1a7b323204e403d2f,2016-12-05 08:28:25 UTC+0000,a83b19f7295940fd88169e54c67d73ad,c416c4824bb04d4faee8bc6f7f2ed6d7,0,2,1,0,3
2659,033462681c154af19ab53c1bbfe7e8c3,2016-04-27 21:26:26 UTC+0000,3a1b7465d804402c80dd1c38ec816565,c39329e6c790449f812590c3b897aca8,2,1,1,1,3
7765,0338e3d91ef647e09c769a050f545ba2,2016-05-23 23:57:28 UTC+0000,309959628002452aacbc4d503ebe238c,5b85a1dee8b74d79a87d53e758d897c4,0,1,1,0,2
1588,0373105e845441db9b258315fcbf8b6e,2016-10-27 14:40:27 UTC+0000,486759bde182499180d1012746bf1d47,1b3258746b82413dba89747b9dbedb47,0,2,1,0,3
221,0378368b9db74ee1bf8cee2ad970dac8,2016-01-13 21:31:06 UTC+0000,7068e06f182c4b00a4a60c3815348d4b,a1006e6a58a0447592e2435caa230f78,0,1,1,0,2
7676,038a860519f449efadeedcc62b244740,2015-01-02 22:02:52 UTC+0000,d13db9d074c04de4b5f1527d21b0bc41,b688e766eed04a37b7abc9218aca1ce4,0,1,1,0,2
6994,03b7422455c24c36ad3219686d863107,2016-11-16 01:53:10 UTC+0000,583771cfca9e428998941843c2bbcb27,c7174378cda74e0886100523dde4913a,2,2,1,1,4
315,03eee1ca07174470b160717027ab46d6,2014-03-17 13:12:48 UTC+0000,00893aa46dc34fc1acd22aff6dfeb294,79b841ed883c42c8a943f673a161f097,4,3,1,1,5
106,040c1e6667064595b796ed2df58da7be,2016-10-06 00:22:44 UTC+0000,74227f9ad9f44d0ba3e4153208057e89,c120bf1e8edf4d39a91b53cfb1bba482,1,1,1,1,3
6084,040f9c98fa5a49c98f54a91bc082b65d,2016-01-06 20:23:58 UTC+0000,ff76d1decf8e4b6e8028f18a50cac471,6ea2a8a29d904015959ae16913092ac0,0,1,1,0,2
2958,042b39d44791491e9207ebccbbbe5eb0,2018-04-12 13:04:13 UTC+0000,abf1b83d89414fce8b22e974705e7718,c44a6a7eca4545c6b67cd5450758aaa5,0,1,1,0,2
6936,042f1a12ba094d8baf2e9f6dea009be9,2016-06-22 14:22:03 UTC+0000,d400dfcef0574b509c4d3ecda030bc06,ed3d991e46944d7e95ef8eee2f0d555d,8,11,0,1,12
840,0448543f5f9a4b4e9eba5e014e8e5608,2017-02-12 21:08:25 UTC+0000,b807fd24c2b24d918dcda615e272a2d0,327e3aeb0e174b8bb49ab6bc75ca3f89,0,1,1,0,2
7843,04541dd0d8fb4ec2a6830b284db565f7,2016-11-24 03:39:41 UTC+0000,cb83340800ee48d08ab3c6b0382941b2,58bdb45dd1974b2e88ef9e76afa07b80,0,1,1,0,2
3294,0473478963714504854aefa9fd0fcbbd,2016-06-10 18:03:39 UTC+0000,a4bed13cee894cfa9755a8737b574852,e2e9695ffa174e2a900d9ba310edc836,1,1,1,1,3
3414,0478c08684f64612b9792e568cd481cc,2018-04-03 02:37:23 UTC+0000,c9423217734b429b966cbd34a8ea8f28,eb22c84af3e84552910964846054d2a1,0,1,1,0,2
6399,04870a521c9d42c0ac6de2d8cf9da6f5,2016-05-26 00:23:43 UTC+0000,64981e1373b74286bada4b11ca36db16,dcf1a523480f4051bebadea27b812821,0,1,1,0,2
7470,048e753bab4e45188365636750f7afca,2015-12-12 22:09:09 UTC+0000,05b8028b21e44db195de1a36e950d21b,a1006e6a58a0447592e2435caa230f78,2,1,1,1,3
7599,0493666966cb4a26b0ba7a8b7bf85910,2016-04-25 08:31:42 UTC+0000,7643cefbf18b4a9987775c3abf161275,e01894b52bfb4eabb8791beaef276fa7,1,3,1,1,5
4332,04a36d521abc4c0f92ee961d8b5bcf45,2017-09-04 10:51:34 UTC+0000,7255e4279e78408d9d4a595ca35db79e,b342ccddf46547bb924181e958432391,0,1,1,0,2
6310,04a7584b2f824f1980ee696a636523f2,2016-10-30 21:11:06 UTC+0000,820baf2dd4fa405e97e4004959a842d7,a1006e6a58a0447592e2435caa230f78,0,1,1,0,2
2472,04cc0ffd8cc4455d993b16e79354babf,2014-05-01 16:33:28 UTC+0000,8ccf15d50938406382b385e2d8ebd1c9,fe4543418c0846e5a65fa22b4ad9a304,2,4,1,1,6
2109,04ce49bb3d224e218f3368da961edc8b,2015-02-18 23:33:03 UTC+0000,fe25f7fe3526446c9eb99da965636c69,f4b9aa952f8b447898def2503bc540f3,2,3,1,1,5
5556,04f7cece3ea14beb8f1e52f6bbb92d73,2016-05-21 16:20:03 UTC+0000,17b2473a43fb4084b5d8c84ed12cbb1c,58fa5e95fe9e480a9349bbb1d7faaddb,1,2,1,1,4
6091,05029ae4d11d4467bcaf5c67a0af8542,2015-05-06 15:25:04 UTC+0000,e5616babd5f04be991aea1e94b3ec5af,369f1c8646b649f6997eae7809696bd5,0,1,1,0,2
7745,0513cc7b00be452db9bf6166b368b311,2014-04-28 01:31:40 UTC+0000,da27071e69214d4eb449b82fb279d0cc,fe4543418c0846e5a65fa22b4ad9a304,5,1,1,1,3
4242,0515341c26de432e981c0b41084d1718,2016-04-26 04:32:22 UTC+0000,bfc51a3491a14a8e8887da21b5137f35,19c30dfeabb64b108617c81d87f538fe,1,2,1,1,4
146,0518dbb8d67d4c29abf74921a6fa8f9b,2016-06-17 04:21:30 UTC+0000,3d68e651e316498fb6c8d7b777d75465,dbfc21fbff414832beed41c7a5966096,3,1,1,1,3
1474,051e94bf704646929682ca7bd357867f,2016-06-25 04:26:47 UTC+0000,2e04e502e8cc4e7781878838e99e2b92,58fa5e95fe9e480a9349bbb1d7faaddb,2,2,1,1,4
1391,05216938c2c542948767067c6029b34d,2018-02-03 13:40:17 UTC+0000,75c8481181bc48eb901333af29f9695f,a6d33c38902546849c36ea7e9e9f0870,1,1,1,1,3
6623,054b269a0f5c4cd3a4d618bde9ee52f6,2015-04-16 14:39:14 UTC+0000,9b831b7e2f8d43f582ec6582d4eaa80f,0895796423534563adcec1c208e9e0bf,2,2,1,1,4
2334,0561af2f70f14d5c9204456fd7655c54,2018-09-28 22:19:28 UTC+0000,cb29d7f3ff6545afbf6066cd758c9c64,4c1333590d234f9bb0f4cf0eac4c6efd,0,1,1,0,2
4237,0563b03c08454a3baaef34564e4f30f1,2016-04-28 22:58:45 UTC+0000,a31b4249fc494dceb21f44b4d5e2d1d6,10005df177a444198e4a6052d8ac7502,2,1,1,1,3
1984,056b405aac1a4be0bab4a3647e72a7e3,2018-08-23 11:31:17 UTC+0000,a7d764352c7f4a00b660700ba63a10aa,36ff3b3666df400f956f8335cf53e09e,1,1,1,1,3
5196,056bd5835bbe4c389948481f107555d2,2016-06-23 23:57:08 UTC+0000,2c3bb8cd31df4e48a5d1d6bc338e778f,7e355a8e3d9646d0bb64cabdbcabec03,1,1,1,1,3
6452,056f437cfa9846b19f69d36a819f4b85,2017-12-02 13:47:20 UTC+0000,f7ac7f56f01a4e9d868b1328766b9259,eb22c84af3e84552910964846054d2a1,0,1,1,0,2
1158,0577aea6b7bf41fc9282d6673c7420b7,2016-07-28 10:53:13 UTC+0000,fc864a728faa45e1b1bbb7f6d5465b1d,d7b49abd3c014c9c8226d13eb15e2b75,0,1,1,0,2
7648,057e9dcc3c7e4b93825170808839e08a,2014-02-13 20:21:01 UTC+0000,a711ac08a1cc4ef3a0a218b719a3a2a9,4b7737cb8c46400795bdba3a4f333997,1,1,1,1,3
5719,059a4c2acba846de9dde48d46611e24a,2016-10-04 18:45:04 UTC+0000,c593bb5333ea47dd9951e7b0b7d01a05,369f1c8646b649f6997eae7809696bd5,1,1,1,1,3
3771,05b1f17cb07b4b619e2b6b9884fdd8a8,2016-07-12 15:24:59 UTC+0000,74616fb56b2a478bb8b362953ab02ef5,1f52a53f782c46298b933a5f70d28f67,3,4,1,1,6
3486,05ce67c162c9488bb74170a4471f9bd3,2016-05-19 21:52:03 UTC+0000,adba66328bcb489bb257be3079845784,06eebab6ea4f421daa1c7ebfb4467021,0,1,1,0,2
4362,05d4d0c2b3bf49b6a789c5e766d72724,2015-09-04 20:23:59 UTC+0000,758128bde2b04973970014a913f7bfd5,a1006e6a58a0447592e2435caa230f78,0,1,1,0,2
2625,05fb19acbfe04a11992057e94abe9f23,2016-05-30 01:47:54 UTC+0000,ebf2198062174238af9c65aa02517135,58fa5e95fe9e480a9349bbb1d7faaddb,1,2,1,1,4
4278,05fdfa6ae9c14a9b8582b819cecbb7ef,2016-05-11 11:23:30 UTC+0000,5862953c729c4932a61cd811696faa00,31b36a4f8fbb4ff68acbbf357c09a899,1,1,1,1,3
4000,0605a344a48a4670a3638ff3e6627109,2016-05-13 21:02:16 UTC+0000,aa25e48fe0934218993d1f612dccf817,31564c8758784fa29062ff4b26f8739c,0,1,1,0,2
3450,063f2e9540504b06b83dcaca45771797,2016-03-02 00:18:01 UTC+0000,5b069bfc1aef4b75a6a1dfad3275d52b,b0c0a365e2f34e55a607c3f30796a14f,2,1,1,1,3
5450,0646ee69c0a04c9db01f2b286ba8229e,2017-01-30 22:14:56 UTC+0000,05cae8b36163403697d1a9083f73cbf8,036358eed7044c66a6058d1006fedbad,2,2,1,1,4
7266,065a8e254bcb48bf90b04760369c40a3,2016-07-22 21:37:38 UTC+0000,7165950ec41047dd9a2a0c9f4ee9b232,8147e4d83ebc47b689901dc534981de8,1,1,1,1,3
1244,06630466f0394f148e2dc1d74cf9d785,2014-03-11 22:02:49 UTC+0000,6378a84ba38644a4b8ed49144449bbf5,564ef581bed64addb3cf0ff0ab652ffd,1,1,1,1,3
1108,0668158d1319460fa16c6ddc92896423,2015-04-09 23:08:56 UTC+0000,38fd627423434ee6b22f3c86e6f6fecc,c43e769ab4e049f38d04aacc8e7d21cb,1,1,1,1,3
6732,068db16771de46c992b4070b5b4ae357,2015-05-12 14:09:57 UTC+0000,b0ebb7e81bc24ddab790da040ab763e4,28f81c09773b462887bfef08edb7d874,0,2,1,0,3
527,06959542e5ae45acbcb5cdb695d3a3f3,2016-05-12 02:16:00 UTC+0000,7123d3e0d62c445295239585c1bd3d5e,2706ab56034d4ead87747b981d4aa741,0,1,1,0,2
1260,0699a9fd770641c5b5d987c465f97e41,2016-04-28 22:09:00 UTC+0000,4f15760b2dca46c3b236663b50311f5b,500156c3bc7147b987ed97001f45853a,1,1,1,1,3
1884,06ab800396e0457a973affbfa935777b,2012-05-28 16:00:19 UTC+0000,490f211ff2874a24a0ec8664e590accf,5a4a16842ec64430ac3f916aacf35fe1,2,1,1,1,3
2959,06b2958339874893b9e909cbf764be5f,2016-05-07 15:06:56 UTC+0000,c16ff81e9a5e468d98f2e0021ee8257f,e2c160ebc83b4f93af07af4850f0ae4c,2,2,1,1,4
5383,06b54e4384cf4686bc2cd4e0ecac89da,2016-09-07 22:25:38 UTC+0000,d922741eb4ce4f4fa881d474ba7754fe,a1006e6a58a0447592e2435caa230f78,0,1,1,0,2
4423,06c03b18ba5d42a7aa190f6c3065cf2c,2018-04-30 01:36:27 UTC+0000,20fcbeac7375423fb2bae52afb06acf1,6528a2e859cf4409be758ad4ee913067,0,1,1,0,2
1342,06c8890592fa4f19889d247a3ab1b664,2016-06-18 10:52:49 UTC+0000,ba82e5dae7094d54bc9b670964743759,58fa5e95fe9e480a9349bbb1d7faaddb,3,5,1,1,7
5661,06edbbb885274a6e8484ba49a3b657ab,2017-02-10 17:30:31 UTC+0000,1dabf596e16b4f13b7020bd39157a046,f4caf68d62934486952305044ebbf19c,0,1,1,0,2
470,06ef3395a6a542de9bf3499c8ca87f01,2012-09-09 05:03:30 UTC+0000,3147b169cd4a4f71b9db4bc28ed59573,29066f5ff3504a91bb7bb304ae6890cb,1,1,1,1,3
6157,07033105cd554519a727ba52fd5a8a03,2016-09-11 15:52:37 UTC+0000,a5a4ac4eac5f47328d64778c6c3e4fce,668fcd23f6944bdd816d636d777ed7a9,0,1,1,0,2
7436,0706b77d13194540b390a52e3cb2ff49,2017-03-02 20:32:07 UTC+0000,4e43d397fdee47ed89da9d894b93f9f0,a6ebcb55beb5417e9b35320b4067c7d4,1,2,1,1,4
911,071b8b511f7245d9bd1de3c0981d71bc,2017-12-03 01:08:29 UTC+0000,0f542fda385d495197af4be56c058e9b,ffbcfa4902b143c388d378296c1ba697,0,1,1,0,2
6780,072160079aab4feab1db189557e3edd2,2015-07-29 17:07:42 UTC+0000,30e110de83534889b8da1fab8b65b00b,ee883f40aeb444f8a535503253349eb4,1,1,1,1,3
4965,07328304dfaf49749c387676a7f2245d,2015-10-23 14:45:48 UTC+0000,d0ad5ed4920b42c0aebf6e63e34ce7a6,369f1c8646b649f6997eae7809696bd5,1,1,1,1,3
3261,073ad29b69e74e448f8a215b73068dde,2018-10-24 05:44:47 UTC+0000,dab79be83eb64330bfa5f144919ba0b0,9942549e0af847c6b6aaa1906f9fa208,0,1,1,0,2
3178,074435275d5a4034a6274b80520ddbbb,2017-01-19 19:25:25 UTC+0000,08bfee3b75b2431f96ed0b0c7dee7879,41d28ab2ad464f2b996625af681afe7c,0,1,1,0,2
5178,076890e8db734f308ad48565ef755c22,2016-05-30 22:38:36 UTC+0000,a065f0fab67d474d8f434ade9e788a98,35da171c6a334dbd939ac938c47c4052,0,1,1,0,2
7746,0772d1ebf8aa4b5aab26107464eb5f26,2015-06-25 17:57:16 UTC+0000,d42fcec7e523418587184f341e3b52b1,05444a2f42454327b2ac4b463c0adbe0,1,1,1,1,3
927,0792fcd76a4e47c8a65ae77d5b095c5f,2017-02-06 20:35:07 UTC+0000,d9f64ee1259b43ac8a77f1e3dd0ecffd,9fe81ed27a9b4926b5d2944d69d5e0c8,2,1,1,1,3
4685,07a27951d536419e84ae5f78f7cf1d6a,2018-01-29 16:18:18 UTC+0000,b16b7c66a1264ed583536ac363037295,2a54e5aad834443bba5dffd2a728430e,0,1,1,0,2
560,07b3f794ef374e96baad5dceacee808e,2016-03-09 13:13:56 UTC+0000,c357791103e045158b49d12a7901315b,a1006e6a58a0447592e2435caa230f78,0,2,1,0,3
4005,07b501cc812e4fe7ba13aa8f690ae3ee,2018-01-22 00:13:03 UTC+0000,1040905d63304ba6878367cc3ab04d06,cf4d747b013247c08775128477da5502,0,1,1,0,2
2204,07bef029c9f94e589cbc25fccc6afcb0,2012-05-02 00:15:09 UTC+0000,5f60bf04681248178242208fcc54254e,9c5803ae43ca4cf6b27ea85871625116,0,1,1,0,2
5068,07cf138173464fd9bceeb0d79530ae3d,2018-06-01 11:26:11 UTC+0000,62d385835e674119a53fe4ecc77db3ad,36ff3b3666df400f956f8335cf53e09e,1,1,1,1,3
5473,07d31089452846588cfbcd6898c1bf4f,2016-05-27 13:55:02 UTC+0000,10b95d02d9e841fea99fe1396b329ccf,eb4c694e0451439bb93aa9b463297b38,1,1,1,1,3
7078,07d61f3ffacd4c3ba1e863983787dd8c,2017-05-08 21:31:01 UTC+0000,8e38e02a73e5426b9b05b1b1bbe13f36,36ff3b3666df400f956f8335cf53e09e,0,1,1,0,2
7638,07e08a34718143ecb9719e448d0892aa,2015-04-23 11:12:15 UTC+0000,8d399c2d1b2e4a06a195c490c2de24c2,dda4737dfac6405d808b746ca9bc3a21,0,1,1,0,2
6836,07eb58cb9cf84a0c94adc8d6e3a294d5,2018-03-16 16:30:40 UTC+0000,42e0602dcf764a33b04728ecbd10490e,d7f9afe721af42b1a03a993909e0568c,0,1,1,0,2
6496,07fd29854b5048088465df494e922f53,2018-04-27 22:26:39 UTC+0000,1bfe32124e6745aabaacaaa1f2e9cbc2,3fca39d997234c15843d43e88a083cdc,0,1,1,0,2
7456,07fdad149fd7459a987c7386797abca3,2018-05-07 20:56:18 UTC+0000,058a674a001a42d8a3ac82b6bdfeaba6,950898c71c6b4616b00b1d984ee71024,0,2,1,0,3
3456,0800977c3a8c42c08deaf2fee1536bc9,2016-08-09 18:25:28 UTC+0000,70acb68a69604dd48f56ba1efc7a84ba,369f1c8646b649f6997eae7809696bd5,1,1,1,1,3
2986,080df1df8dba4a27a836d83b5fea2e6b,2013-10-11 02:31:04 UTC+0000,c19224568c644748b8072e8ea60ea35e,47e48174d0854928908e62ca34b026bf,1,1,1,1,3
5847,081b618254ef4a7a87a83580cec8c16a,2016-05-09 03:09:22 UTC+0000,f8705b01807c4dceaa24e549be94d8d9,58fa5e95fe9e480a9349bbb1d7faaddb,1,2,1,1,4
3288,0820ecdd72b94c6d97ce807692eb1e66,2018-03-02 14:22:25 UTC+0000,7d9babef9af64e0d8da0998a56b8ccdd,78b5f45dc5104ac6be1862e9ff8b5b1d,1,1,1,1,3
5695,08307166acfc4907afeaeb6aa535cbfd,2016-08-03 23:20:49 UTC+0000,9f19fa6911e64793b75fecc8814f273c,be5d23056fcb4f1287c823beec5291e1,0,1,1,0,2
7445,08358aec180a436193348d59a4eae6a1,2012-01-09 04:36:20 UTC+0000,9472f02673ef4570a19d40f8d4e7a6eb,05444a2f42454327b2ac4b463c0adbe0,2,3,1,1,5
1259,087bc210dff447fab4b444d8be36abf7,2016-03-02 23:09:38 UTC+0000,b42916c1eac54b09a7d2986df88bdcda,5bde22f47cc04936a9d90e5ea2fa458d,0,1,1,0,2
7864,087ce9aff7d247749cdb48a2b9c90af9,2015-07-06 19:13:07 UTC+0000,580a0d7a30314b05af5aeed85930727b,369f1c8646b649f6997eae7809696bd5,1,1,1,1,3
5119,08a480cd883d4c8294b53f02e3041c91,2014-04-11 16:01:09 UTC+0000,474853f7fdce40868ee1248ac66c7a23,fe4543418c0846e5a65fa22b4ad9a304,0,1,1,0,2
7040,08bc6a70278f49b7bb3c74a0a9336613,2016-10-28 23:08:22 UTC+0000,48d87a07b7a14a8c8686b063d75ce66d,a1006e6a58a0447592e2435caa230f78,2,1,1,1,3
1036,08c393e9a7c74f258d9fb99d7e3fb799,2016-06-24 06:14:40 UTC+0000,ae541f25a944444cacc276eb61d67e9e,614ba4c0aa534b759b73e8473fd5ec88,1,1,1,1,3
5591,08c447a21253485a84f97105b6ab9969,2017-11-10 18:14:48 UTC+0000,8d61c6a4af8d46f0839bbf71acdba4b6,e4b617982f7541d88dd091849596d92d,1,1,1,1,3
2436,08c8abe419d44371936d6ea8f5832cde,2018-09-17 12:40:51 UTC+0000,433972eec8da4747941a9c25ecaf4ff5,36ff3b3666df400f956f8335cf53e09e,0,1,1,0,2
3807,08db1237e42b4d1ea68b27b1deec4a0e,2016-07-08 18:29:36 UTC+0000,bd2a5c6ce3514cd08fbe7fc8302a5da6,17613500e1584f6480218ef42080e54b,2,1,1,1,3
3578,08e1ebd6db824709976fc70e81bf6609,2016-05-25 23:36:39 UTC+0000,5d35cdb50d34408b9833bda76c52eea5,5611d52913a8466c8f5e5b80b6c48dbf,0,1,1,0,2
3375,08ef990c2d504984808dd9890003de02,2014-01-30 18:07:55 UTC+0000,30135a56df034728b873cc06e91ae3db,e248a06a65c148dbb3f2c166dbdb2148,2,3,1,1,5
7480,08ffa0953ccf4dd4a236938647f03a94,2014-12-27 15:36:12 UTC+0000,0062a44423da41d79044f3b9dfe6db2f,fe4543418c0846e5a65fa22b4ad9a304,3,2,1,1,4
6042,0914db8647f14ed18ab2a7b321d0b81d,2012-10-15 01:02:00 UTC+0000,72798b8492314e12980a1503633d6569,0c673e046d824ec0ad0ebe012a0673e4,0,1,1,0,2
5545,0919ee0cbdea49d2a136d4c7cbeeedf1,2016-05-02 23:27:56 UTC+0000,04462e69a54d4034ac23cf54569b251c,5b85a1dee8b74d79a87d53e758d897c4,1,1,1,1,3
6205,092055f6c13049079596150a7f01b753,2014-10-21 17:16:09 UTC+0000,c93bd386325e45408da15174850c21b1,a5a854e1959642f48559c65b10d0bafe,1,2,1,1,4
3690,095787dbf69444a792aacdd2521c3f31,2018-04-23 07:02:21 UTC+0000,eccbb6cde9a442c4b0fbf6a245f29cba,e44c2855fd6649ae869fe145d167cbe4,1,1,1,1,3
6490,096853349e3f4cc98cc4dc087eff65c7,2018-02-22 19:00:49 UTC+0000,ec8bcfb6f02648c19b2bfd8965f0bc88,13b55ed4834e4814bb33a4c87001063d,0,1,1,0,2
2416,0970d51a9c31434cb489f20c4a15511d,2014-07-18 14:45:43 UTC+0000,a7c980dfe0f1421ea74ad5dc1da1e2ac,b7d1223032c446d686cb258c654aa115,4,1,1,1,3
2785,097b382b869148439246e6c2b82130b7,2016-05-27 16:29:56 UTC+0000,ea56831621274b04af888637897d6caa,eb7c7f666e074c93944f3228128924d6,0,3,1,0,4
5631,097d45d8c9f3467caba7a377f35a7ad3,2016-04-13 16:47:57 UTC+0000,5519dd4ac5184355b1ab2f3a2862a2e3,f4653ac2b6c34bd89fb0b6e236e513d3,0,2,1,0,3
6937,099160259bb0461daf32c1e2c8d17fa9,2018-01-19 19:07:51 UTC+0000,a04e2b566ff64eeeb1f88893df0b7ab9,4726d9fe14ca49d981b08890cc373993,0,1,1,0,2
5506,09a4cc5ba6134fdea95cbea02c86a54a,2014-04-18 03:28:40 UTC+0000,4704f4f6010b44bba53918bb7566f9d1,fe4543418c0846e5a65fa22b4ad9a304,0,1,1,0,2
3745,09a75c896b2a4ac589630e741a2cc5a2,2017-01-24 15:52:43 UTC+0000,ef34d3abf89d442ea39461a2891f4166,84e08b7c127e4e309a0f9853f5e0ea1f,0,1,1,0,2
7654,09a7db8e35a34796a379f10bb50df8fc,2016-05-04 19:23:10 UTC+0000,6e3ce78ab522402498638692b64956b5,e4e7cc05a0b64cd6b02168d404a45d4f,2,1,1,1,3
7770,09aca6bec7374118aa1caf4b22575e59,2015-09-08 19:07:46 UTC+0000,777cc01d538c49c283ccd5a099dd5d5c,a1006e6a58a0447592e2435caa230f78,1,1,1,1,3
2265,09affaba013e46b588b7d8aa95eb7b41,2017-01-13 15:27:27 UTC+0000,1093612b86b14ba192014e1027a4fbfb,ea76f7c1aec747848d86d9990d9d0713,1,1,1,1,3
7362,09c1bcd0507f4f2899db37b3e7c2439a,2018-02-14 19:42:32 UTC+0000,f417441df0974dff9979acec203061a8,8ce1dca4e94240239e4385ed22ef43ce,2,1,1,1,3
1526,09cbe9464fbb405da81c24b7412b8683,2012-01-07 14:58:28 UTC+0000,cd241d001bea4300b77a323c96c7062c,d67201e5fcdc4a339c6d6e1e0b0eecfc,3,1,1,1,3
7955,09d23bfd3e774c31a958a9e6cb311cd5,2016-05-26 03:50:04 UTC+0000,2957684a8364459c95e891f353b1bc89,a14d2d2cc61d4275a722eeb7204cda90,2,1,1,1,3
700,09dbdd71ab04459bbb2f9667bffcfbc8,2016-05-03 01:31:52 UTC+0000,6c26a0a3cc814e7e86414285b81b0a17,4d97862b69dd40738e40c427667cc2c6,2,4,1,1,6
5003,09e32ad6fd034b3caf3cef44f51c46f0,2016-12-02 05:11:39 UTC+0000,57dfa18d8f13420cacbf2a86866f8c46,c3b4e11154f74a858779be7ba9b6f00c,1,1,1,1,3
1341,09e3bdc69a6149aa8656bbc18162ac37,2014-09-27 09:30:56 UTC+0000,0b3ff01b944648bdbfa9716d576c6f95,56444eb4b925439186a995602e9d7037,1,1,1,1,3
1971,09ebaba8edeb4f2a82bcddb6c0cd0cd3,2016-05-18 18:09:48 UTC+0000,5134a79604e44cc484aece563cbecc6b,36ff3b3666df400f956f8335cf53e09e,1,2,1,1,4
2206,09f0a731f5f2405690f82d1aacc5dd39,2016-05-02 19:47:09 UTC+0000,3f6320463e5c4b73911a40a555f9a2ad,000d4635e5da41e3bfd83677ee11dda4,0,1,1,0,2
3337,09f0d2a003aa4c2fa89a5f206885483a,2016-05-20 03:25:44 UTC+0000,88b66d5fe34049dc81c70b8c1a34679e,c8bff6d4efe64b999f7fe7b8635d0610,1,1,1,1,3
2907,0a0c9a6684c6453e87909d0178bc144b,2013-08-05 22:26:35 UTC+0000,3993ea0cb8814d5a94e03300fbe28cf8,06bde59ab81a46978f3d8724b33e17fd,1,1,1,1,3
7903,0a23587a96e6475cb9e0b04e76908016,2016-11-08 18:20:30 UTC+0000,5948cd9f66204bb1afac7cd1a0ad1212,13b55ed4834e4814bb33a4c87001063d,1,1,1,1,3
5445,0a273475854844f787215da5c167a93f,2016-11-12 02:27:40 UTC+0000,b5297300cab54f0bbd99edfda98cd38b,fafeba89ca764bd891862fb8440a2962,1,1,1,1,3
1136,0a460a7d7b5f46e981cb6a840e7e0c5f,2016-05-10 15:57:32 UTC+0000,d3dcdeae40484fe392ae304c94f6093e,634baba43a9e4721ac0bc4dacfbd4214,0,1,1,0,2
6041,0a6f8a5a53a94ea49fa6859d5e63eb10,2015-10-28 16:21:35 UTC+0000,ae12cc844fb64146af8c0d21578bab47,c1a24b8f746b47488da02a0e5044a7a9,0,1,1,0,2
2232,0a7657168e2144bab91c4a63d2b11b21,2016-11-28 23:16:19 UTC+0000,f1a66cce842648e2ad82e65194e5e2fd,ab0b1c1190a64715b0433885d5c88df1,2,1,1,1,3
4906,0a7782212b424ec585034c23692b8ec1,2016-05-21 18:28:52 UTC+0000,8d1ab6a20d0f49a9a2bb314b922ac51b,7bffa1792d474359b922e5de700d7a82,0,4,1,0,5
6764,0a7d21738a9a47448998f73e4a5bf5a4,2015-04-16 14:45:14 UTC+0000,638bcd81ec5c491fb7959c57b9a21a67,0895796423534563adcec1c208e9e0bf,2,1,1,1,3
3040,0a7f0c994fe246dab79b1691ef923532,2014-10-01 03:23:42 UTC+0000,44b1eeff75cb46abbc9010ab85d9c70a,ed79058b91794ca897810dcbb7f61fb9,1,1,1,1,3
1698,0aa4b2fa941d4d26bf7236f3f85e3c61,2012-02-05 04:34:13 UTC+0000,6ba2deb7dea94d5badf52ab4b1e40ef2,9c5803ae43ca4cf6b27ea85871625116,2,1,1,1,3
5687,0aa6b8a7a73c445ca18643234fd11a10,2016-07-20 13:26:40 UTC+0000,8346dcccdcf7483cabb4423e55d1555b,0355aaad83704ad98e6d71b79db85849,3,2,1,1,4
5586,0aacfcf9487e427db52ed486bd55fc64,2016-05-09 20:48:52 UTC+0000,1df16961bdb84b4698bf4e12da9df2c1,13b55ed4834e4814bb33a4c87001063d,1,1,1,1,3
1343,0aad821ddbaf4c50a7ec348681fb3442,2018-05-20 18:35:18 UTC+0000,6c359687c5924be7a466409182ad3de6,cff9a9679be1434f93afd0caadea94bd,1,2,1,1,4
6998,0ab49300a00c4e27b89b9bd096055acd,2018-01-18 15:38:40 UTC+0000,8a2077f3de5c44aab017840327a21449,a209eed08b8846adaf95f352b1325815,0,1,1,0,2
343,0abedaeb33274ad4a62164f32a017d96,2016-05-22 03:20:59 UTC+0000,e7e78696215843ab8b7de5ac94a3459a,a93be32ae9fb48ce9b3194e17cc2b398,1,1,1,1,3
7238,0ac0104dce074b8db9fbb27be3b01b87,2016-12-19 21:01:02 UTC+0000,712a9e3e505646f396f260f9fac32bf1,36ff3b3666df400f956f8335cf53e09e,0,2,1,0,3
4436,0ad8d510b6b146739216e04d1a2ae76a,2017-05-10 18:45:26 UTC+0000,2ab98a786dac46418382bfa7d57021cd,cdceddf41de84bbe9677c2530662e921,0,1,1,0,2
1599,0aebfaf2666e424d974137a09e358b8c,2016-10-31 02:28:39 UTC+0000,399b5b1625af4fd180e3354a8277c102,926c156d54a44a1780332ba20efc9f8f,0,1,1,0,2
3458,0b257d0b49164ac7ab9803d071f089b2,2016-05-10 16:59:21 UTC+0000,e115a4bfab394570bd89e77e0c3f69d8,9de484765ff74eac904e53e6b3072107,0,1,1,0,2
7630,0b44b95b0d974ccfac87fa4a25d69a6d,2015-11-05 18:31:41 UTC+0000,a2a480d0ca534be3b3333601b160801c,a1006e6a58a0447592e2435caa230f78,0,4,1,0,5
5512,0b58132a0b224b51bf909284b3a5a1bd,2016-05-17 22:15:09 UTC+0000,e0e4e1572d1940b5b56355b5dca36416,f1a64ae4e7ed49d6b2e04bf7e033bb4c,2,1,1,1,3
1206,0b5a3393b46e4085822747921e6e3c1e,2018-11-14 18:45:34 UTC+0000,759041645c2240298df165b7704b9860,517b8394734d49288108a498fde0f853,0,1,1,0,2
6371,0b713f2a37e34d2880d500fc8ae929af,2016-05-12 10:39:23 UTC+0000,7845a529b86f451aab901e536b4b8d6a,54976f119d3a42d3ae3d85956c1b6338,1,1,1,1,3
946,0b87c7665ded49aeb926d3f9f4e6e719,2016-10-16 20:12:43 UTC+0000,86b5f74fbb2a423a90d05ed1ae369c43,38493b19ae8c427e9e398a6c6ceb9586,1,1,1,1,3
6684,0b89be37448a4895a5b3c16d16ae1d4f,2016-04-11 17:51:13 UTC+0000,1be3081b29af488d92824818918ddb85,8d525762ada04f7abea2bbbaece94be5,0,1,1,0,2
1746,0b8a838c6d1b429f91ca23e782105f02,2014-05-09 22:46:10 UTC+0000,e145ba0e6cfa4c609bd3cd44f76221c5,ca1c49a2744b4d1abc1a2d7c154cadd0,3,2,1,1,4
7186,0b8ad551ee57439e94a462ea1ed3d837,2017-10-18 12:03:27 UTC+0000,5e1b99a63f0549c781b8b45508b9d0f9,01d85b9badfb44f2954b5990c668556e,0,1,1,0,2
5012,0ba162e22db44e4882e485b94c708289,2015-05-21 15:31:58 UTC+0000,e0c128b648df4114893be7b592de0956,88a5a403a1184b23be37d56f0f042fd3,2,1,1,1,3
5148,0bace93137f9445e9661ee13bfa78d02,2014-03-12 22:26:02 UTC+0000,a58418696c8b45f6a0565fd064dd1038,c1bda2764ee642b3859b1ca6839fa16c,6,1,1,1,3
1469,0bb7ff3edb61499e8dde110cba8a19b1,2016-06-01 22:08:14 UTC+0000,fd77d96f4d5a489b8eefe4fcf990c74e,60b50d4d77334a9b9e6a9e353ded4858,0,1,1,0,2
805,0bd8f284f265490389bd3e969feb19c7,2016-06-11 19:22:38 UTC+0000,74b3aae9185e4011876778b0ab4abfc9,58fa5e95fe9e480a9349bbb1d7faaddb,0,1,1,0,2
5924,0bec824e0e6d49228f6beb499e5a8204,2016-05-30 15:31:27 UTC+0000,01559dc4b412442ba364acd7f694fa55,6a1fd36949a04c7dbd45260e36c6895e,1,1,1,1,3
4400,0bf5e180ed014c2c80b421521845b626,2016-11-03 10:27:55 UTC+0000,c6d1b1eedb63451f98f661f9ecfc8ac3,189a4ae2494e4f6d8278342c46b2ad16,0,1,1,0,2
2642,0bfd2853655d4daaa13333d42b2cbeed,2018-02-16 22:11:53 UTC+0000,9ff6877ff05b468d97799a1a65299700,ac83901fad384461ad33630aa2d823d7,2,3,1,1,5
1682,0bfe88d73faf4b29838c1f78b53a28b4,2018-03-18 17:36:11 UTC+0000,2af6945ec75a47a29b0837e83b36c46f,8b30413febb749f582781486ea22f40b,0,1,1,0,2
253,0c08fbca91434b6490b1511bb02f1558,2016-05-18 23:15:43 UTC+0000,5f12ea8c91c448bb915b1075db56f86a,fafeba89ca764bd891862fb8440a2962,3,4,1,1,6
2779,0c0b5232f23949b299f2793b905d9a56,2015-03-25 08:02:36 UTC+0000,4109c0bb34c54a0cb6e554d7360fa835,e251a8a9f1944b2f9a30f559bbecdf86,2,3,1,1,5
3950,0c0fb2a36b6841dbb4fd4c8f9891297a,2016-08-08 01:05:55 UTC+0000,af0aafa3e0b9409886658c4d3165e065,5b85a1dee8b74d79a87d53e758d897c4,3,1,1,1,3
5367,0c1e1323f1fe482cbbb1c417b17eae86,2017-02-13 01:26:35 UTC+0000,2b88fca5cb974473b69920a735856546,58a39fde2cdb4036a4e414624afcc0cc,1,1,1,1,3
2385,0c26b75f6b3643a6b458e32ba03450b8,2016-05-08 19:59:08 UTC+0000,970b8392a33c4834ab6a471487faafd3,58fa5e95fe9e480a9349bbb1d7faaddb,0,1,1,0,2
3610,0c2ab4bbcc704533ad2d56f620401cf8,2016-03-04 16:57:31 UTC+0000,beea71c1f0824cc78b153f20e925a9a7,1972751ff4ba4c38a4b53cee74a600a7,0,3,1,0,4
6866,0c2affbe78024dd68b04703923513c45,2017-08-29 07:14:18 UTC+0000,c8c6131b7bc34a2db55364325935f691,be5d23056fcb4f1287c823beec5291e1,11,1,1,1,3
6648,0c3a9217b8f54d1d92650eb8b911904d,2014-04-29 20:33:05 UTC+0000,a22c1201a0f64b7983216ece6976899f,fe4543418c0846e5a65fa22b4ad9a304,1,1,1,1,3
672,0c43cc35ad0c4dcb83c209f2f2b046fb,2014-04-08 13:39:14 UTC+0000,c7e746c5fb9c4519be760c185f11d9c0,95f1104e8b604c98ae237020a98921c4,1,1,1,1,3
4370,0c470a53ccfc42cf8015e1552bf3d0b5,2013-03-28 06:50:51 UTC+0000,c82b73e8e5e7467181e2b6dde7261888,29066f5ff3504a91bb7bb304ae6890cb,2,2,1,1,4
4962,0c50a70d21f24322947db973be45c306,2018-09-20 02:57:26 UTC+0000,ca7a9d7a95df471c816db82ee758f57d,f0717a8271674ff6a28748de7a9b9dab,0,1,1,0,2
6987,0c5dc922debd4c808ce944f1f92c3849,2018-02-17 23:16:21 UTC+0000,52e0ce5a2f504d36bfd5e46a4db514eb,733003960d17445eb214ff8529b10c48,1,1,1,1,3
1813,0c8567800451472d809cb0659c1c3d6f,2018-11-13 18:37:45 UTC+0000,020c2ed97fcb47e1ba47ae7f46fef605,9182c8fef0df4ace95290b0164b9a579,0,2,1,0,3
4655,0c918e6a14f74b66ab4c9ced77cd48ed,2016-07-23 11:58:03 UTC+0000,3f43fbff428b4aa598f7064624e5d44a,36ff3b3666df400f956f8335cf53e09e,1,7,1,1,9
6228,0c9f923d32734ba79c532fea847791c9,2015-09-09 18:11:45 UTC+0000,1c917c83b127406aa2bb94af9d716bed,a1006e6a58a0447592e2435caa230f78,3,1,1,1,3
6224,0ca646b9dcb04a70951fdf708f38c677,2016-07-28 18:42:37 UTC+0000,a4895aa447f2411a821232f003be436b,a3f6d682096743b2b88e7d3540f3dcff,2,1,1,1,3
4148,0ca75abcca7d4abe91c55e282ae2a888,2014-12-03 15:00:42 UTC+0000,c5ca2fe19b8945acb9c060588ae845fd,7d425e8d7cfb4fe7b0702fff4d6d84e7,1,1,1,1,3
938,0cb72295a5e346718015a6d00d056e6a,2016-06-23 00:36:58 UTC+0000,4eb82c84bdad4886b46c06f88b2da498,327e3aeb0e174b8bb49ab6bc75ca3f89,2,4,1,1,6
1003,0cce33d5cdd140469f820a6eaafe4beb,2016-12-04 01:27:11 UTC+0000,ecc81218c5624ff58df4e2e45c2f571c,be5d23056fcb4f1287c823beec5291e1,0,1,1,0,2
3765,0ce44621632843d38cb8555a1e8caa45,2016-07-12 00:24:16 UTC+0000,0ac095bd65a04ea1b7c08be1088cd499,5b85a1dee8b74d79a87d53e758d897c4,1,1,1,1,3
4249,0cf0615a14f545fea2aae42f909ddf8e,2018-09-26 15:32:27 UTC+0000,95254a5e2de149d38b34eee3146cb68e,3102d008cfe14340bb8d1ed9b6026fa1,0,1,1,0,2
2106,0d048ab595a549008e4a1f4d5721ac01,2016-06-23 23:14:58 UTC+0000,8317b72074ca4d08a21e70bc82358be4,d6907111df5e4090986469b30fb49656,1,1,1,1,3
1467,0d0641b42c514922968d7e7cd4dd9974,2017-09-27 21:49:37 UTC+0000,b19ac6432a7e4038876beded71541c15,4b7737cb8c46400795bdba3a4f333997,2,3,1,1,5
4383,0d3d36398dce4a6a97b717f1b80a4d40,2016-05-24 23:26:15 UTC+0000,5c3f61133873457398b58677f20a9bd4,030fcbbba31647938b176a90c04e38df,0,1,1,0,2
1919,0d40a81b6c4f4166b3a5ba1128187650,2018-04-18 18:11:57 UTC+0000,8228d20fffb34e86bc64baf28318a356,04dd575ba4ab44d0a6c37141ab922123,0,1,1,0,2
6963,0d741acf1b794365abc09a4f7ad0ac68,2016-06-29 18:47:43 UTC+0000,d289e6cc9bd34f718ab44292a1a9b34a,58fa5e95fe9e480a9349bbb1d7faaddb,1,5,1,1,7
6770,0d765721646f4615a4651de9ac311d80,2015-01-22 18:09:07 UTC+0000,0009d7c4da2e49ba81eab299e3f88c6b,6c45a5332ff44c09b6c3dfdf53d2bc56,3,3,1,1,5
91,0d786267f7da49078a5b5e2df5be4ce2,2016-05-29 21:27:40 UTC+0000,c09edbb408944a3fa183d6fab03e68cd,36ff3b3666df400f956f8335cf53e09e,1,2,1,1,4
1822,0d7ee56b812b4f359c70526c2f47d5cd,2017-02-10 01:03:08 UTC+0000,b000ee1b3ec34e31b65a21aa2a54abb8,fe5dbb9f3e9746f6a0a1d063207e2fe6,1,1,1,1,3
4891,0d7fab391dc145a384da4af0a078b77f,2015-03-25 20:29:48 UTC+0000,633f3f3522a84619b6401dafe18203ff,a313d41a323041a6b716d4ebf7ca5372,4,4,1,1,6
7300,0d863b9244054ae2b96a035ec858a01f,2018-04-25 14:07:30 UTC+0000,c6546e57f21140a4aefefcddae9021c6,9d9525da47214621acd218745f5ddd0b,2,1,1,1,3
7809,0d9944fa068f48b1b961bb602b38d2e3,2016-09-24 01:12:54 UTC+0000,59d5df5b534a47308e6dea701b57f057,f221bf19f433493b8666e093c2365e54,0,1,1,0,2
1001,0d9d7a0cd6c54ad492d7ec43b99a3fae,2016-05-28 16:14:59 UTC+0000,484606db1d8f49a9bd3e43f55380c804,c232fdc3917c48ffbb7c9375a460d358,1,1,1,1,3
2747,0da09db7e6ad47389405fd4fa9e94067,2015-02-26 11:49:07 UTC+0000,9a09e375dcf34f19896c1e90b72c4e14,7cce25cc8c1042b1b4f135bcacfdad82,2,1,1,1,3
4997,0da559c9445e4ad59a98611e164c3ddd,2018-01-30 04:23:05 UTC+0000,1bb1535b852844b791d1c4f2a670a1d3,4b7737cb8c46400795bdba3a4f333997,1,1,1,1,3
6820,0da5b8c42fbb4768ae120d4f378de898,2015-09-03 21:34:23 UTC+0000,05c9680c3d67476cb0367f6ae80e6c9d,484ba21a3e19494aa036d3baeabd89dc,2,4,1,1,6
3073,0db051f33a4541dc80866e73aebbb916,2016-04-13 15:23:56 UTC+0000,6403f6c570944b829dda976a763ad1b6,fa51201b10a141dfb6d84cced4be06f8,1,1,1,1,3
6004,0db6ed5d24df42f18d19958ccb32cd6e,2016-07-19 06:05:39 UTC+0000,df290f9b7f7548898627ef02c0107c3b,df0b6c5d41554412ad9383d7069a8e2a,2,1,1,1,3
5696,0dbeea95cfdd43908172a6c8617ec2a0,2015-10-26 18:25:58 UTC+0000,570144fc861a43fea49c520a96caef90,a1006e6a58a0447592e2435caa230f78,0,2,1,0,3
7070,0dc777d28cf3485f8aa4714d5b80251a,2018-01-10 21:33:49 UTC+0000,75d497c1066d4b79b39ce348a055c8d0,8022e3cb63e840c98c27148713777ce3,0,2,1,0,3
7624,0dc88cb0e40e4f0883d40f1dfca31b23,2012-10-01 04:52:44 UTC+0000,8dcb0fb92f2f4a658857da2d1bbd1678,f05b33a454c048f3bbc73f5f3f7f5127,0,1,1,0,2
3819,0dfc67c7e0a949379c232e06156e179d,2017-06-01 23:19:58 UTC+0000,a3c4f8879d434298af4f6bba74bf3c4b,6299c67935c74e748cb2b10b3461d525,0,1,1,0,2
7252,0dfea20f032545c9be22a5d3ca7ae77f,2018-03-02 00:18:29 UTC+0000,ba5da8f975e54a4a99a1d1bf75c65608,49e2beb688b648fcb3373bcee71882d5,1,1,1,1,3
6094,0e0b298c38dd48ecbc42e31ed5af24c8,2016-07-29 15:52:01 UTC+0000,5f1e090482834262905f2a96c9adb31a,8dcef0937fe345d3bbf4cdfaada8ca5f,1,1,1,1,3
1906,0e13b9b4d4c34a8b9056a6fda76dc257,2018-08-23 04:20:43 UTC+0000,4243ec8d790b4ca7b05ac803fa038a1b,564ef581bed64addb3cf0ff0ab652ffd,1,1,1,1,3
5884,0e37d30c10cc437ab424b55efa3414af,2016-04-28 19:08:06 UTC+0000,cfcaaf5689bb49e8a3bcdc2ce7660952,90275e799320405bbd2521b88a580ee9,1,1,1,1,3
3528,0e597e13c05245189e4c2a17882bab92,2017-06-25 07:07:34 UTC+0000,00b830e57cd44af78e7a4209532f0ad4,c1bdc3d063b14ad89b4fed049bd92e06,1,1,1,1,3
2187,0e59d26b107a48ba92795b0a82558086,2016-09-14 15:22:29 UTC+0000,23e2771824fc441cb2345958e4b61477,dc76158aa87a4d6fb6bda6d2752216e0,1,1,1,1,3
3270,0e64eee1ed7445a29e4dd752bf513f4f,2014-04-08 20:46:21 UTC+0000,f9766e96c30349b4ad135a0d4351eb1d,c84b7719b1e14c80a5ad3ab52dddad3b,0,1,1,0,2
2952,0e86efc0c5234332b409b8384fca1740,2015-04-22 00:15:14 UTC+0000,fd6bebc64148494ca47e468b5b066684,e98bd839b4f14cd6a3fa1cd9833d44be,0,1,1,0,2
362,0e8812db2abd4b728b1569f29e32e8d8,2016-09-08 13:40:30 UTC+0000,c2fe1e16c0c54551b8f9fda3e9308c75,a1006e6a58a0447592e2435caa230f78,0,2,1,0,3
5291,0e8d57b216ef4d4f844f917ed291d82f,2016-05-19 15:11:00 UTC+0000,468f413961d847c3b67cc306867720c1,cd76be283bf24fc4975b6e94418f6e20,1,1,1,1,3
7821,0ebf5eff96284af5b296aa03fa29eaee,2017-03-27 15:00:02 UTC+0000,95ebea29bc344c83bfa6fab8a4d9c674,369f1c8646b649f6997eae7809696bd5,1,1,1,1,3
854,0ec6a785dd5c471a8d7d1107b68b8617,2016-10-23 18:55:33 UTC+0000,c2dd9db8484640b4850f1088bbfd37a8,a7a8e9fc6f0849dab3d825c39b22262b,0,1,1,0,2
6626,0ec6f6a4e8664646ac8b71863e2f0931,2014-10-18 02:11:27 UTC+0000,58dd16418fc44b00b777e6feba06a0a5,2749add250814499b1d2a3e7ddcfe33e,1,1,1,1,3
287,0ec6fc016def486c8002746bc8f92d16,2016-05-22 06:23:05 UTC+0000,8ab0ced6285d41739f625d8f9ac3de0d,ce331ab2f21e4b1b99cbbb6383566612,1,2,1,1,4
6536,0ed91d0a84a644e58e4537fc80c3e135,2018-03-01 12:57:06 UTC+0000,8864fd0a549143998ab22239c6141e00,eefd04d904cb4be7a441ec8bb2af84ba,1,1,1,1,3
6622,0ed9fbf1e42a46ed9494b0791291d8f6,2016-05-08 20:39:51 UTC+0000,e8fc7e7235f5488a98effa11cbfefda8,24cfcef51f0e4a0d86a7d331ae6cb3c8,0,1,1,0,2
6795,0ee219a79de94095b0301a8953d74df6,2017-05-30 23:51:02 UTC+0000,666c76cd113e4aafb4011707dd8a9f80,9421dd803d164e5da26436a01a92ce13,0,1,1,0,2
2624,0ee57c5109eb48708797a3c86979acdc,2018-05-31 15:29:51 UTC+0000,300cdf58cc064fee89326765247dee15,e2d4a22779d244dabec2c8b50a484143,0,1,1,0,2
7453,0eef63fdceb545eeb9da8cc860463173,2017-09-15 14:22:38 UTC+0000,89108e4be8db4953837031844ad89ea5,92b3a98b6065495d8102f04565d228f3,0,1,1,0,2
6567,0f091880b9c24554816f0cf6fc3a3ace,2016-09-19 23:51:34 UTC+0000,f9af3269c0d742e0b13b5391d2cddd6e,36ff3b3666df400f956f8335cf53e09e,1,3,1,1,5
6378,0f3db8b26e734cff9c62f9fb17753524,2017-01-01 19:49:53 UTC+0000,5ddb30a79a3943688af54aa5a408b286,faa0fe0510804c4abeffc171acf37ba2,1,1,1,1,3
4912,0f4316ba69924bee840ebfa3578bcebf,2017-02-21 18:37:42 UTC+0000,cedd67ee263347ad914a9328128eb246,47ba124be5db44bd848ea9ce87f31a7b,0,1,1,0,2
4466,0f46c078fece455da6550e722506d31e,2017-03-07 08:11:08 UTC+0000,3fbfa96e092f4c618854cc999eec2e51,211e39ac71694bb5af233b205a0f2057,1,1,1,1,3
7052,0f4aedd177b64dd18224c70a87849928,2016-05-14 21:39:18 UTC+0000,697af3d5950b4ac19cbdd61f0e10b327,58fa5e95fe9e480a9349bbb1d7faaddb,1,2,1,1,4
1643,0f53ccf720794a6f92162d831e75c27a,2016-05-12 15:26:44 UTC+0000,6a247a9ad1464aa295b11202462f0755,73f8740bd68b4c02b1ddafffdfb0c37a,1,1,1,1,3
1109,0f5ca3b2c27b45409321a829ddce55ec,2016-06-26 23:51:59 UTC+0000,3232aa9c1ca044e48249595589c55989,58fa5e95fe9e480a9349bbb1d7faaddb,1,2,1,1,4
4340,0f6b1b245f8c41bc9dcaaade1963aa56,2016-09-21 14:01:32 UTC+0000,6dc68a3381fd486eb2e12a76ef90de63,a2b49c84ad60493d9d49a57be6dcd5fd,1,1,1,1,3
1869,0f78d6fbe3f047a3909ff02507e95d93,2018-08-17 12:56:13 UTC+0000,56fce33021ce4e6283b59e2523f0aef2,36ff3b3666df400f956f8335cf53e09e,0,1,1,0,2
5098,0f86476e9a4e425eb775e3218377a5ea,2016-12-19 10:39:06 UTC+0000,bf3b4542962d464ab5850011aca6d1bd,6267ab789f0c466aa34773ec069bc822,2,1,1,1,3
7011,0f8ebd24629f4133b4073183d58b8278,2018-02-22 03:14:19 UTC+0000,b27f2a71238c41068fbdc04e2615841c,e6b29607f1504bc9bdb81783016df845,2,2,1,1,4
3503,0f915eac660744a1b396f1f270578fe1,2016-11-01 19:02:59 UTC+0000,f1205dfbb67e4e00acd676ca2326c7e7,7b86ca42543646b2bc1641f8aad4399f,1,1,1,1,3
1112,0facdf4d85294d849ce5885f641fc774,2014-05-13 00:07:01 UTC+0000,8e038dc3341443b99adebd8a2a2f471d,05444a2f42454327b2ac4b463c0adbe0,8,4,1,1,6
7860,0fbd3e8626f44a44b8ff63c781d44525,2017-04-06 13:54:10 UTC+0000,8df85df8cd474e4c92d8c39688b172f1,369f1c8646b649f6997eae7809696bd5,2,1,1,1,3
3634,0fc183241f034f51a9c2e28dc1dcd553,2018-04-02 07:42:46 UTC+0000,635bc01edc0b4a5cb2036ac37afe2821,ff2723d4ec9c4a96b4a2df2bbca3db98,0,1,1,0,2
6497,0fc40a63be16450790ff96ed12717274,2016-10-25 02:25:05 UTC+0000,0080910fe1ee4c3799c8fca8fa904191,d7ba3e9d430143d0906c13580410c37a,0,1,1,0,2
1497,0fd98bc6b5ce4565943351d0c2f51210,2016-07-07 03:13:36 UTC+0000,03642e2bca8c4958bb5d42934c581c72,588f357fb2f74666b4fefbc9c6564b24,1,1,1,1,3
7254,0fde4d00aa4b40139481e5ab5be10146,2015-03-19 15:46:45 UTC+0000,f77689234181404aa32f98b849dfa361,5fe1c1ebf97d43349c1ea42ba3cbc0e4,1,3,1,1,5
138,0fe80ec905d446c7929a39c4402e1df0,2016-05-24 19:20:52 UTC+0000,82176f4f47bd475fbdb354675ebdf262,d5f86387dc4b496d9280a99337dfe1b9,0,1,1,0,2
6160,0feb78ea43a34ab3b132e58f42c5f625,2016-05-21 00:35:41 UTC+0000,1316496b65b34d968f150769406b88eb,bc46e3699d92477ba8c7aa723e54a151,1,1,1,1,3
4668,0febc6770b844445a2fff0e67d785585,2017-03-13 12:57:59 UTC+0000,bc96e3d1e78549b494d7c88ccf326dc7,ab0b1c1190a64715b0433885d5c88df1,2,1,1,1,3
1178,1041683f215b410b984735c10589be16,2016-05-19 13:45:41 UTC+0000,2a7e4a7e8e45458386fee7cacac7c1b6,7e721be7613246dd9f1aee1fb31271b2,1,1,1,1,3
2376,1055cdc745654697a66a2b7fbf98b197,2015-05-24 06:59:54 UTC+0000,809e7e025fd8433e999ba577c510b2ba,9a0f09620c6640718c1792a74f3b8438,0,2,1,0,3
7825,105b8728d4cc44e2bf556a0125540b8c,2012-01-12 15:00:40 UTC+0000,8b4e0f31332644ac8b928151de4b0662,a6a8b236321646069558ef93844cc9e9,3,1,1,1,3
3984,10906338ed6844388dc85e71db8f5841,2016-06-23 17:37:22 UTC+0000,5c77c71a3f9f4dc1844ba9c7d52529ca,47972c78ca3e44a591de3f258069aed5,3,2,1,1,4
4533,10a0d9eb7e4b4e96a400b270ec5c54dd,2016-05-10 16:21:55 UTC+0000,d1ef26a25c344a0ba9d3a5b8fbf7c2c3,d4d8f2de77454f64b23b333b7cae636e,3,2,1,1,4
6569,10a75bcc620d441ebaa4a84ab5491b01,2017-05-20 06:47:36 UTC+0000,51550e34c2e84cdf8d1353400d654891,97da3942e54140a5b8fd088267b7482c,0,1,1,0,2
3350,10b50fe2556843bf8eb49952dc259346,2014-03-18 00:12:36 UTC+0000,6aaa92ad01db428f9349ec65c6c3fe34,d90f99de84174be081195314d627117b,1,7,0,1,8
3956,10d9160cc0a6477f8e56a7b2aff5309f,2017-04-03 22:49:29 UTC+0000,875883dbfa2a49719d591c3a5b5c3f00,96bbbdd06a334805a0501034d9df1aa4,1,1,1,1,3
4339,10f4a0abc25a4a418ac5b50782b1be32,2015-09-17 21:42:36 UTC+0000,e6d03cba8e6e42769fd397e5e99d8a45,a1006e6a58a0447592e2435caa230f78,0,1,1,0,2
6120,10f7d3b8c6584697b56716f6785b7344,2016-11-28 00:14:29 UTC+0000,2b8160ebb0ee480f9544df8d0d68bc8e,83cfc4f44b9d4fef8cb95530319d8b53,1,1,1,1,3
907,10fc067c9b8342c59c154abc6badaeab,2016-09-10 19:54:49 UTC+0000,3b8e102f9ca0418ca48c925e3d32fdb0,a1006e6a58a0447592e2435caa230f78,0,1,1,0,2
363,1103eacd8d884860ba84daeca95ea42b,2018-09-01 03:21:39 UTC+0000,5a2545188bc84c40b28f2055d97f3435,f0717a8271674ff6a28748de7a9b9dab,0,1,1,0,2
2912,111ae82a0d5d4fbe98207e0873b5d26d,2015-06-25 19:55:07 UTC+0000,5c031663c7294769b9207fd592fbf16b,5dba31c694e54a4d93f780448ec199d1,4,6,0,1,7
7426,11375729758b402894f331bd9ff5158b,2016-05-21 15:00:10 UTC+0000,40d9f6a4368048438d88b6be82d6717b,3ddfcacb3aec499fad320c2a46651c0a,1,1,1,1,3
7565,1141d4e37d1340bcb26dbb4ba84a2311,2016-05-13 03:57:09 UTC+0000,16827dbae85a4a9db4de5af5633173b7,7d425e8d7cfb4fe7b0702fff4d6d84e7,1,1,1,1,3
4376,115bfe574c7840a3b8484225bfdbe68d,2016-05-31 10:48:00 UTC+0000,fbfdc1cd76b34ac2a6ec623c1ca6b529,b922b6b62ae24a61a42caf559f62f9ae,2,2,1,1,4
6564,11651d2d2c2348f1823c6121ec65f39d,2017-02-11 02:07:44 UTC+0000,1d0036f8376a477199e2358494587150,c258f388f42b4f608dd6fd8e9b6c1dd6,1,1,1,1,3
3440,118bf2e5ee364185a0700fd31f438e2c,2018-02-19 20:03:56 UTC+0000,b01b298048224067b00b5628f2395947,a6d33c38902546849c36ea7e9e9f0870,2,3,1,1,5
5797,118f0699d09f4470aba7d0df5adf763a,2015-08-27 17:40:31 UTC+0000,bc798e47163341b0a4a999a3865b8b47,13b55ed4834e4814bb33a4c87001063d,2,3,1,1,5
5050,1195062f9e434956b252ef80d0500e9f,2016-06-24 03:54:04 UTC+0000,59ea7f27d1f24d4cb80d431dcd49bace,e963b61ee35c47c49551d0b3eee97782,3,3,1,1,5
159,11a7c481598042ff9f0d1df39a05b7e9,2015-12-24 01:20:16 UTC+0000,42de5824dbe14306b2e4a8377811c133,c1bda2764ee642b3859b1ca6839fa16c,2,2,1,1,4
970,11ad0d8964d546a1be585586e6d4a2ca,2016-06-22 13:53:18 UTC+0000,bbbec09910964efe98f677ac5977feb6,548863f92b2c4052b15b99856490fd65,2,1,1,1,3
62,11d4f13a474845bda3e5153202bea675,2018-03-01 19:00:18 UTC+0000,21d35377d96b4bcdb760bf43e8ccef5d,34324b758f854ceb896c6c0e0f16d8a9,1,1,1,1,3
4139,11ebaf6e155645c29981c5d56693980d,2016-06-08 14:49:16 UTC+0000,20dead737d6a456d9a35fabb8b3290bb,976b9fe0968a4032ad42f2bb2a94d9a4,0,3,1,0,4
7529,11eda21f48904f369bcb888f2f926fe9,2014-03-12 18:37:13 UTC+0000,ca782f6cddcc49d58524af003c4d5eea,3610651286574769b899efd7204265f9,3,1,1,1,3
5493,11f71eb1f0a649568e1aeb5bb0817d2e,2018-02-18 22:00:24 UTC+0000,1e1e477bc4894839b70c8226d8979f46,9bd823bb95e543b4bbc2916af91a8f6e,1,1,1,1,3
1426,11fc820b8039496a863059044c04fc65,2017-01-14 21:54:51 UTC+0000,f3beda32e9f34881a09b81c517bb78ee,36ff3b3666df400f956f8335cf53e09e,1,2,1,1,4
7471,1205ab3cb4ca4e2e884dcb6b24407971,2016-05-09 03:26:56 UTC+0000,938dd408dccb44718c257d64390cff78,f966f30233b9447abd294b72f92cc7da,0,1,1,0,2
1224,120e19c58adf423abfe6e0b52b377363,2017-09-28 14:19:51 UTC+0000,8f8b0032ac6148219d09887f8d4e42e6,a624d3aeb35c4ec3b335c66b450e5433,0,3,1,0,4
4238,12128abc8339413a8b29aa698494ce58,2014-04-08 13:31:41 UTC+0000,d61c393ed2304c0a98843643d6917f5c,5f4c8c5868cd442e8e0bc218b9a10e03,1,10,1,1,12
3429,1218ca9e127c4c57aa0903ffbdb991c6,2018-02-07 03:02:07 UTC+0000,20750192511546678807341c2161e66b,2694d61072bc46be9d657652403c3fb3,1,1,1,1,3
6712,121bab4eeb96488fb53d13f16a75538b,2017-06-24 16:05:08 UTC+0000,f3d0f8fb4fb84860bb86e95236b00fbf,c222ab66ccf34c0899364a36484a68d5,0,1,1,0,2
7345,122174e3612b4be59f58d4dae0d18c7d,2016-11-01 00:45:08 UTC+0000,3bde453d9b524f638ac1ed131e2ae00b,c8ffe6358764451982263916bd7fac79,0,1,1,0,2
2969,1221d83b6b394e80b13b4d14b51e28ee,2019-01-30 15:49:42 UTC+0000,5bf762c8501d450a97af992800980242,e00981daf5ee4f928b2e1459d531eb83,0,1,1,0,2
6056,122eae3011e4439181b4699ae1fa1f1f,2016-05-18 14:15:07 UTC+0000,646dbeb9ac554496b7d64c3fa4fe0c57,43177a3bad0944e4af0c4c4a3551883e,0,1,1,0,2
7312,1273aa9cf2a04878a48ec767f0fef617,2014-05-31 12:58:48 UTC+0000,adb08d1126514a869fa80dbd91a26172,f0ef81ac187b4ba9b81b6ea0ac7d4e70,1,3,1,1,5
4472,127cbd28c98d4f4d98dc8531d6349cdc,2014-04-07 14:46:29 UTC+0000,de1f26b7a116401da3be37ae656e76a0,250ab63dc871447da66ca3ea9e36fc94,2,2,1,1,4
6721,128169ebc7f34159bf030db0a6a49c02,2015-10-26 15:58:07 UTC+0000,3ee2f540b89b45e5be9ff9da89ce7eac,369f1c8646b649f6997eae7809696bd5,0,4,1,0,5
1780,1285c2b20dcc41d7aa3480488bdbdf98,2018-03-29 16:24:30 UTC+0000,accb5d3dfced420b94c3a37781199207,12a3438429924d3cb9726f4d5834f42d,2,1,1,1,3
6187,128b423233dc466bb0a671a04aae96e7,2016-05-13 18:24:12 UTC+0000,dc20a469a8494e06bd4a1d748be77fe2,a511df5378da447e99de53ac92a76e7b,0,1,1,0,2
1433,128bdfe6f6354efda7e2126e5d1b5806,2014-04-10 02:53:01 UTC+0000,0c2b8b2cf2e44ba68860397f3bcabdd3,6774ee9e8f9247728dbbe896726e911a,4,1,1,1,3
7142,129ad79ae0e8403f966f1048a19edb05,2012-09-09 05:56:19 UTC+0000,a830ea5c62df4bb5bd9bdec5de5eded2,f05b33a454c048f3bbc73f5f3f7f5127,2,1,1,1,3
3114,12a1ca4dc47a466194d5046a7451c013,2017-03-23 19:35:09 UTC+0000,0f20fc56b8524dd5bb0e863949dac360,2319e2d6b4a544d69b3c446d9c6b6d9d,0,1,1,0,2
7253,12af67ce4b824fcf8e2a1695faececf7,2016-03-02 02:55:37 UTC+0000,de26407b09b54b3ba019ba710f734522,20bfb598d1ea4cd28bf45e9184c0d0bb,0,2,1,0,3
7134,12b27fecfa8f49bb96e13cb48cb4ca1d,2018-03-22 18:29:15 UTC+0000,0c3bbe054ba84152a0ec089b81193caa,42f4ba1c036946e195e5ac5db3b74be8,1,1,1,1,3
3733,12b380dff9134b42b8df08ea292dabcd,2015-03-12 23:08:10 UTC+0000,28d2c857122049f8994d1aa9eb88ea19,5fdd771b9fed43d9bb7a0730c6d4f3fe,1,1,1,1,3
8030,12b3e98f9ef34002ba17df1d94484d36,2014-03-10 22:23:18 UTC+0000,afde6db0aef045af9e7ad1892fadbf83,05444a2f42454327b2ac4b463c0adbe0,0,1,1,0,2
1075,12bb526dc0f14028937f2433f60e6caf,2018-02-02 15:22:57 UTC+0000,b04cf7d167f7457e995a4f95fc2213fe,599fdcd031934f08854b56fe4a03bdce,1,1,1,1,3
6244,12c3892730874f88b75fcf51db3ac3d0,2016-05-13 18:55:05 UTC+0000,875a85ab270744f5a07746f843d02c3b,393da108c1814afca98503ebaee2c99f,1,1,1,1,3
7932,12cdf671a31d4a9c862b46cc4b21eae2,2012-09-09 03:58:53 UTC+0000,5b3f438f3fe748de9b925323f3a4e2ef,05444a2f42454327b2ac4b463c0adbe0,1,1,1,1,3
3871,12db3ee303534aabb458b24e78bcbf5d,2016-06-23 18:35:39 UTC+0000,dbe885ad983b4c9ab6302352f19ab015,e01e491a6b7a4f7791798ffb4ddf75e0,1,2,1,1,4
1916,12df450752974efb96a7e8b28181e6ef,2016-05-25 23:30:56 UTC+0000,9f93eb14803b4b5599dda2bb438b3ac8,b342ccddf46547bb924181e958432391,1,1,1,1,3
7204,12ed4b7752a0499991e704dd119e8051,2016-06-24 23:43:32 UTC+0000,882f7a14b6ed45c1be61dc6698f6e70e,6ea2a8a29d904015959ae16913092ac0,3,2,1,1,4
3744,12f2c09f31f84c5dae4f6899d100dd56,2017-05-06 07:52:34 UTC+0000,5e49df392f194ec4a177b8d9bafbfdec,f29723e24646426e935274a15e0f13bb,6,1,1,1,3
311,12f41553094442d5a2e90280e2faf879,2015-10-22 16:01:57 UTC+0000,8564caefd41d4ad9b6eb0b023c690bcf,13b55ed4834e4814bb33a4c87001063d,1,1,1,1,3
7414,13039b09b8004beb8c8398d28e8c1ea1,2015-03-03 00:57:14 UTC+0000,d13b1c723b2f454a881983e12c4821bf,f4b9aa952f8b447898def2503bc540f3,0,3,1,0,4
2005,130ce642fb1649fab55840288d6b0613,2016-10-22 13:55:52 UTC+0000,9ecbf326c10a4a6bbf41fe86e8c72680,3d8847ddc8d04185976a9e78b190ebdb,1,1,1,1,3
541,1313c5a1da444ab98e4fb1bd663c1c0e,2016-06-11 06:40:45 UTC+0000,3f53b45fd46d42bcb3a26d46cf87a001,99206e8d6d8c4d049498e2dca31468d4,1,1,1,1,3
2253,131caa78ff6b45a1a6c23ab495edd8d1,2018-05-14 14:45:14 UTC+0000,a7376fa2ef5c4562af4939b80dbb38eb,272bbb3460454ebbb49c7d7c48948b42,0,1,1,0,2
6777,1347a981ab76403e8f213d019eed93a6,2015-11-19 17:59:49 UTC+0000,786b90816b7e456b9b2de89b8c4721a9,a1006e6a58a0447592e2435caa230f78,0,2,1,0,3
1167,135d4ec7a2794370ba3177c119a54308,2014-03-19 21:58:36 UTC+0000,913a1e24e2ac435a9214c17546dedd98,24fac8940aff427c848b2a59265c1204,0,2,1,0,3
1065,1361c07cc27943a3a16930cee5eaa567,2016-08-22 18:22:34 UTC+0000,d8913e8ac7634d7ca11e64f398c6d949,e1049f7f1b8c4f90b7db30e14cd0ace3,1,1,1,1,3
5913,1362d2ca4b6647859f0fd51d0748449c,2015-10-12 20:55:00 UTC+0000,83cad0e197dc48088c62d310bc8ce348,97c21ac9240942248e0a3f0cc4ff6d61,2,2,1,1,4
347,136410a06a5a45a9a71112b827fb533f,2017-02-05 23:42:25 UTC+0000,9a0aed2e1f1346ac81dd4f5c9ad92199,5f95b0ac821e4e8e9b4fa9fc8eb9ff61,1,1,1,1,3
6762,1370f52cc94841f49c1a46188dacba7e,2014-10-27 20:12:14 UTC+0000,84c700e6f54c423da96803b7939a4bc0,6d3aeebadc6a403a814b2ceafd79862b,3,1,1,1,3
7206,13825f031086413982097ac7c311777a,2016-10-24 13:53:35 UTC+0000,d3bf6491a0f2472bad2fa754cfd6c5ed,2356a99867fd4fb8a01b2cb60ac7617c,1,1,1,1,3
3016,1385942a4407480c8dfd5b22363ede80,2018-01-25 04:16:05 UTC+0000,67dc913070f2425da045b8d6c0e640bd,914aaa31bada4f3b878ba78e0a76ccc2,0,1,1,0,2
5878,138709d087024adc938c6abeb0b3a9d9,2017-04-26 00:55:04 UTC+0000,ccc572b2a8b04d1fba33099c957f7043,966b0b4cae16426aa26be5b024189127,0,1,1,0,2
7613,1396e76623484526b83115a1eae71172,2015-05-06 14:53:11 UTC+0000,07cfcdcfa1b04ac1bfd91f18a62e4fc2,575f14b5c01141db8da965082970240d,0,1,1,0,2
7807,139f96479420491d94671c2d9cd545c1,2017-02-10 00:39:35 UTC+0000,a753da0534c74e14bf5c7b7e0d6cd3f2,d97aaa6b7f7e4b1e9a6d65d5a0958183,1,1,1,1,3
1323,13b4da0f233c41e5a61a17433bacedb4,2018-09-11 22:03:56 UTC+0000,347cbf0247424baa8792bc64ad48d48b,36ff3b3666df400f956f8335cf53e09e,0,1,1,0,2
6167,13ba6831bf9e4b74bcbcbf49d7c711e7,2016-06-02 22:52:56 UTC+0000,245b63ceb5a8410d89c9006c3478a444,c0f7489f842f4ebfa548af41402d9571,1,1,1,1,3
2515,13c6f1ad5401423abf0836832ab521b5,2017-10-03 01:48:42 UTC+0000,8ba7414c5fe7435782e7ff105825a00f,03cf1fd186ce43229b93f29557216762,1,1,1,1,3
4350,13d70a27dd1345bd81358ae474d274ee,2016-01-29 19:27:08 UTC+0000,80664369cef14e7db8c3e8e6656ed441,99d69aaef7064fbb873298ba98cfc9ac,1,1,1,1,3
7170,13df323cd0eb4c72a78ca6eb40c06081,2015-02-18 20:50:40 UTC+0000,814f1d0ddc8a45e69487c16f77104b84,b953b3a5cd564558a13b7bbe04dd0fd2,2,1,1,1,3
5559,13e408d2010842eea3518420c093e155,2015-03-17 20:18:36 UTC+0000,ef1832c94d0c49d09afad66198e24a55,a1006e6a58a0447592e2435caa230f78,0,1,1,0,2
1522,13e4139ff9e24642856cd654c01d0d09,2016-10-19 02:28:03 UTC+0000,82605a305faf4423b0e48caaea8ba339,91a66853dd164250b6df8a22115e9f88,1,2,1,1,4
7056,13f74680480148d8aeb2733acc3af092,2016-05-19 01:47:00 UTC+0000,580ee17f229a42f3a712b302e31b2a7b,b472644419d141c79fbb3b3745750ed7,1,1,1,1,3
4557,1403f8cd119d42518b2a0a910b49f218,2016-06-20 04:18:44 UTC+0000,f91f84b91b6a422a976ed584a5738bae,58fa5e95fe9e480a9349bbb1d7faaddb,0,2,1,0,3
5138,140c5c8cc19446f4b771325296a9eba2,2016-05-31 00:57:57 UTC+0000,f6ebd62206a24a1a8a35470038bd9d21,13707b3409e744ff9ead8a087b22140a,1,1,1,1,3
2839,141946b25a5b4d8ea2eff1a8ad3a1a14,2014-04-25 20:15:56 UTC+0000,de25e5ba7393451b8379bbeba99795a9,fe4543418c0846e5a65fa22b4ad9a304,3,1,1,1,3
4171,141c7c83fedf4771b17aee21326ada89,2016-04-28 21:36:56 UTC+0000,125bb1f8fe464f62a601c2cd2e30bf22,321c814862994462955c82b73116a1d5,0,3,1,0,4
3625,142584d2b112444ebf8e8597e5008ee5,2018-01-25 01:08:53 UTC+0000,12c8157009e84149a391c53f77c472e9,5a14109840c24b21b81eec989db259f6,1,2,1,1,4
4403,14258ac639f54cbbac668e2fb52c4939,2015-10-28 04:32:59 UTC+0000,a5fefb08269e4621bf4e7d49692fe272,8435fd16c86e492885acc2cf5b6e372a,1,6,1,1,8
600,14262de068a3423f81290ab6e723ab43,2016-03-01 15:52:55 UTC+0000,51ff081d91824b6a9566cd5f359ef11d,1fe1ac082d054b62a494abb56dbbb793,0,1,1,0,2
4618,1426fd64bcb24c49ad89d54c681befd2,2016-10-27 17:11:44 UTC+0000,79c380eb34d34f1fac209b1816dae0ee,24fac8940aff427c848b2a59265c1204,1,1,1,1,3
7936,142b921e9dbe460a82a0a151dd30c08c,2017-01-25 15:55:52 UTC+0000,42158b4d7830403eab81f977d338e9dc,b5d9c99800134cff9d05fe9a52b8682d,0,1,1,0,2
1758,14524162adf744d8a565996996d764c2,2016-05-12 16:58:15 UTC+0000,11d68a8694c44f2ca879ac619e766512,387eabd8aa1143a1a38e175b65925bc3,2,1,1,1,3
6469,145384f8a8fa496587a2027c01683d5b,2014-03-04 23:16:54 UTC+0000,8d8f3b68396941c1b61d240ad19c1478,fd17b2c99949412999f878ca3e777c98,2,1,1,1,3
7557,1454e5bfc60d47159f8ba3f37bb1f923,2016-05-23 12:06:34 UTC+0000,ebbbaa9c6121472a8a8b67c72f5d9ed6,d1f04208de3643c088f4a25e57f1cb2d,0,1,1,0,2
2305,145e7456a0ac4ac6a3bbc64413b90c16,2016-05-08 16:16:23 UTC+0000,dde61758da1a4031b5c9f812ec6483b9,58fa5e95fe9e480a9349bbb1d7faaddb,1,4,1,1,6
1547,14685189a4104c19a419e46078e0aa00,2018-04-24 13:57:13 UTC+0000,c774a81c7384483582172e073dc42208,a6d33c38902546849c36ea7e9e9f0870,1,1,1,1,3
3619,1476993e56c04124a58b486728ded082,2016-06-12 17:01:24 UTC+0000,626e84a8c41c4448a563ac2a49b3c09e,58fa5e95fe9e480a9349bbb1d7faaddb,0,2,1,0,3
2035,14796b4858c9415f9d676cf18895e909,2018-10-31 13:21:00 UTC+0000,b68a6e6a64984f47a89efe6ae7cca607,9f621b62d22845a9b8e2eeb024db3625,0,1,1,0,2
6938,1489ca23b75543308e3d9e5d969105f0,2014-05-10 17:18:34 UTC+0000,83aabcce8b8348faaa6c6cb1ed2648bc,ca1c49a2744b4d1abc1a2d7c154cadd0,2,1,1,1,3
7006,1495401c178f451fb5e7cedd7ee7f29b,2012-06-03 04:40:34 UTC+0000,6f3af43f79c344c4aa79bcda9b29ff08,05444a2f42454327b2ac4b463c0adbe0,0,1,1,0,2
596,14ad3b15123e454bafde17c225f74a26,2018-11-12 19:43:38 UTC+0000,7b2450db8fd14bfc98471cc5414aeca1,be5d23056fcb4f1287c823beec5291e1,1,1,1,1,3
7795,14b17df4a93240eaba5f53150699aeb7,2018-01-13 17:41:10 UTC+0000,99d333f497dd4c38bda37ecb46e20b0c,be5d23056fcb4f1287c823beec5291e1,1,1,1,1,3
1786,14b69ac3f78c40b9b55795245f8bdba2,2017-01-12 22:34:31 UTC+0000,cc88cd6606b64a8c8ecc641e27d8d867,9496418c2b6a4c059442c81cd73d55e1,2,1,1,1,3
5985,14b75be33ec14ad3891e7f8b0816118d,2018-01-24 19:45:58 UTC+0000,403a9f76f35347c1a70c1d05ccc8ee35,a8296abaaa3f4a62991aadfa9cd39d42,0,1,1,0,2
1254,14d5b22ef2234a65ab7dd9627b46bec3,2018-10-16 20:13:47 UTC+0000,5d9ff607354240559281c1536f1bbbdf,a036812a3ada4168bbfe89be4a41ddc6,0,1,1,0,2
5658,14e3cc02accf48f4bbfafe1697f6c553,2012-01-24 20:15:47 UTC+0000,20af10c44d0f4a0986b9fdbe7d1eddc2,624194ea296c49a6a8ef1180787476dc,2,1,1,1,3
7926,14e66104e46a41dba6b0e9ee00faad4d,2018-03-21 21:16:12 UTC+0000,c127a48826e547aabe7b2baab165680a,b1488415466948b5bee3896efbc31fdd,1,2,1,1,4
2544,14eaf64f4f564f79b7ff66b70145937a,2015-06-25 15:22:35 UTC+0000,8b4d23359e9241a49ca79af89e749bb3,05444a2f42454327b2ac4b463c0adbe0,0,1,1,0,2
5279,14f7bc005fca4fbdbf4f533d5e9a3403,2016-08-13 22:37:25 UTC+0000,0fb37b8505ce4bfa8183c615bb38c3d4,58fa5e95fe9e480a9349bbb1d7faaddb,0,1,1,0,2
3174,1514ae35b42f403c9b553f1aef3fdc24,2016-05-12 02:31:52 UTC+0000,302eee9b25784e2f91bb7fa2dae1b845,2706ab56034d4ead87747b981d4aa741,1,1,1,1,3
1756,1522ab2c91c74c9b8a44cf294417a75f,2018-09-04 15:09:14 UTC+0000,2b0ba2323f42428bbf361c664b47292f,36ff3b3666df400f956f8335cf53e09e,1,1,1,1,3
5652,152465f349d94114b38a99532bfe4e69,2018-02-16 03:28:48 UTC+0000,12affd60ac31400a8c9ba01570e115d9,6a551fda6a564e0698999e2edf0049dd,1,1,1,1,3
7246,154594d78c36478984f90a03d2c47e60,2016-09-26 18:24:30 UTC+0000,15953915bd5743ad8aa6fce2f9ff5ed5,327e3aeb0e174b8bb49ab6bc75ca3f89,1,1,1,1,3
7990,15541431881a43378b2864ec10b46a9a,2014-11-20 20:11:21 UTC+0000,d3bf20b1636b488f9e406876a9165c9d,3e0f8b09451c4a8b9ddce027951685f4,1,1,1,1,3
5854,1554f6b9aae146909f7328c6dacfe6c5,2014-03-23 02:41:21 UTC+0000,4d79c5f8ff7243ca92eb6fd72f431baa,05444a2f42454327b2ac4b463c0adbe0,0,3,1,0,4
7554,156cc6a4f0f64dcc998204d6f32fb318,2018-05-22 16:34:04 UTC+0000,a81e516579e74824b119180d594d34ed,4e9fe7ffb54c42eba0987c6119da9975,0,1,1,0,2
1064,1574dcb0065a4a4288a7b5751d7bd607,2014-04-24 02:42:59 UTC+0000,7c80d88dca984358a945777def07da53,fe4543418c0846e5a65fa22b4ad9a304,1,2,1,1,4
3882,158c35b61a96416cbf67b1aca761f745,2016-05-17 02:29:20 UTC+0000,2f2193e1d084481593ef6b839987d088,58fa5e95fe9e480a9349bbb1d7faaddb,2,4,1,1,6
6271,158c8044979e48889fba695c438898b7,2016-10-10 15:09:28 UTC+0000,24dc29e187d64fffa0edbf097109ca7c,01b8333db0ed420c865624e8984ef6ed,2,1,1,1,3
5036,15ab25229ef041b3b9021bb087851995,2016-03-27 22:45:27 UTC+0000,68bc505d39844920aa2a4c51b0a65833,58fa5e95fe9e480a9349bbb1d7faaddb,0,2,1,0,3
715,15b052afd55c463dbe1e0d1587f44ffc,2018-03-22 00:32:08 UTC+0000,c6b7c809123b4b72886f5612204a60a5,7e183a1f7b314eca968ba6cf252e61dd,2,2,1,1,4
2259,15c470bb9ad14725991f17e827dd2f19,2017-09-14 16:00:39 UTC+0000,7cf7bea5ceaf452ea4a4c7ff94d97dcd,eade66f4c07a4316b01e34d82e4b836a,0,1,1,0,2
367,15d2ff7dafe446f6ae9bbb91cdcb36e9,2018-08-16 04:00:15 UTC+0000,e8a4e53286c44520b69e27e1875b48e3,81eb2470138d44abb5e5a16053f75e6a,1,1,1,1,3
3957,15d3facc2b7b4da6bbf250c336383cc3,2017-03-27 15:38:34 UTC+0000,39fa458089574b7997f90e434b71bb3d,416321b48a634ac8a53602625f0a5d40,2,1,1,1,3
6990,15eb9df8c4d7411a9a9e178cc5355884,2014-12-11 15:53:25 UTC+0000,1999024390be442dbabf3d7489c8d48c,2adab7916b3747af85b2d82e188c1dc3,5,1,1,1,3
6432,1629e60d6e9147b9aa193d808f891812,2016-05-10 18:58:06 UTC+0000,f92d7dc7b360459bbc55c20d8cbb26d0,7b86ca42543646b2bc1641f8aad4399f,5,5,1,1,7
3887,162b4c1ec15c4984bf73a2bb93ab9e80,2017-02-27 22:02:49 UTC+0000,eec245f8ed1042e5b90e481d3311cc22,36ff3b3666df400f956f8335cf53e09e,2,5,0,1,6
4491,163c8fdb1c4f477a8fc7adf19ba9f700,2015-11-10 16:33:42 UTC+0000,989344c068da454ca590b9c39fabb25a,a1006e6a58a0447592e2435caa230f78,0,2,1,0,3
7535,163ff24fa5d14b82acdd17deb9f0ad5b,2014-12-19 16:05:48 UTC+0000,a5a8b3e4278d43cca2329bcbe36bedfa,2ad6164ce1e14cc4b76048e0652fb1ce,1,2,1,1,4
2832,164522e7595649729deebf48cad87e1b,2018-01-30 04:14:14 UTC+0000,eebfb94fd7734ca8a4070a991e17f34e,4b7737cb8c46400795bdba3a4f333997,1,1,1,1,3
2396,1652e344c48d417dbaf60423419af230,2017-06-22 12:28:43 UTC+0000,17a21ea81ae243bc86dc4e25c15a81fd,369f1c8646b649f6997eae7809696bd5,0,1,1,0,2
7117,1662ac1e71d94362b24f3d5623d57891,2016-08-17 16:44:25 UTC+0000,5c19e57b2e42420686e427d2e5e449df,97d44742b7e840608d45c1f55a103f11,0,1,1,0,2
7033,166602406aa14ad1bb8235feb3e53561,2014-04-08 13:54:32 UTC+0000,1de90675b3a44f8184c366ab81c581b9,3b7e352267da403695a5c0f50f28da8b,3,4,1,1,6
877,1674fef4af1f4cd4bfae2b0fa745a9e2,2015-09-03 18:12:20 UTC+0000,6f2e90f9e03c48e786a60320aac86cc4,d1f04208de3643c088f4a25e57f1cb2d,0,2,1,0,3
4181,1697e53ae0cb45d7b1a739fe6db580c5,2016-05-04 19:50:12 UTC+0000,de37da0c9f574491b7c31a86139e1523,d6b3e8620ed44fdaba397c853a0024af,0,4,1,0,5
400,16986671941d4bba8ad8b40cf234ac1f,2016-06-18 11:37:19 UTC+0000,f27a8cb4919143639fe09006a018d3f5,ff347be2a46543598867792e3e6a54b9,3,2,1,1,4
302,16a06fcb95884e0493d71d601260f3e4,2018-02-24 15:34:13 UTC+0000,be0a413af2e24c0a9905842f5a8eca7c,a6d33c38902546849c36ea7e9e9f0870,1,1,1,1,3
6834,16ab1012942047558308544dcdd82b05,2016-10-30 23:31:34 UTC+0000,1642f22c55114674ad3bb939588c6d9a,36ff3b3666df400f956f8335cf53e09e,0,2,1,0,3
4416,16ba306c96074ee9a3d21b7d1de0fd8f,2015-11-15 17:54:31 UTC+0000,fecc09d9b9cb4dac8c4374b5c8b1c079,a1006e6a58a0447592e2435caa230f78,1,7,0,1,8
7023,16baad4a12dd41cbb533faa05eccfe8b,2018-03-21 12:52:33 UTC+0000,bf082d42b3cd44a6b653f752ffd08d5f,5afd9426d98949ab919104f2fba93ebc,1,1,1,1,3
6247,16bad4e060b6476e801ca9226294d0e5,2016-10-20 23:54:16 UTC+0000,d196e0e3dda0402e9a094e3cc13c2497,dd656a2432074039ba52cd10e554b242,1,1,1,1,3
6829,16c1a82b8a3a4f2299534231f9c594c0,2016-09-19 17:19:04 UTC+0000,862f3e014b45422b9ae02e4066acec44,a1006e6a58a0447592e2435caa230f78,2,1,1,1,3
4047,16c4acb51cc348dea9d25b8e4b257b58,2016-05-07 20:37:19 UTC+0000,7d39bfa02d3f42b0bfd6381444ca4638,58fa5e95fe9e480a9349bbb1d7faaddb,0,1,1,0,2
1964,16c4f551f9fe4dc59a124d049565ec27,2017-04-16 20:50:17 UTC+0000,cd0356ab6d694471a92eed71d41cc95a,be5d23056fcb4f1287c823beec5291e1,0,2,1,0,3
2534,16d6ad5504b94da5a1313239c4f7a715,2018-05-25 22:57:29 UTC+0000,9b3d58cad6474ae7a88358202b97d219,05444a2f42454327b2ac4b463c0adbe0,5,2,1,1,4
3232,16e0e3646d63437f9e3747e91f8fd805,2016-05-27 16:09:20 UTC+0000,2a7aaa93b6764783928caaaa64f26a54,331c075b95c74215b0435818457f0324,0,1,1,0,2
5223,16f1780c6591499dac410e3c2f7255bf,2014-03-17 05:32:03 UTC+0000,41f0f00ccfe845248819471b858db4d6,4bce59e2537b4228adb73b856d2c6102,2,6,1,1,8
3049,170347d7b7404ac08d3721cae5364ad5,2018-11-18 02:54:40 UTC+0000,29aa416a5b594414a988beeeb3738718,9fc88a7c3323466dbb35798264c7d497,0,2,1,0,3
650,170e7293325a4cc9ac29621eaa4ecff2,2015-10-25 20:35:33 UTC+0000,10d6b21365c241e4acc450307628c717,a1006e6a58a0447592e2435caa230f78,1,3,1,1,5
65,1752a4c329d04fdca228dcea013db775,2016-08-15 16:06:42 UTC+0000,d743b29222b5478683982069c2e79055,373809641ef04ce68113c70f3d50ef98,1,1,1,1,3
2827,175b380bf8524e8ab58aedcd41a8bd39,2017-01-06 18:16:03 UTC+0000,0c785d93d44c4fec8d910a5933a4d5de,f64df9b489864952917cb631be1ddac7,1,1,1,1,3
7623,178ca92a3b674d39ad4b1053a9bba29f,2014-03-26 21:28:30 UTC+0000,55cd9fd4cae84bfd805378a890bc7c61,3d8847ddc8d04185976a9e78b190ebdb,2,1,1,1,3
238,17b08a0d491443fd997241637330054f,2016-05-27 02:16:56 UTC+0000,0bf942709fe2444fbdcf2be553a0d372,81a594b683d54e6dbb4b04ea00a5e25b,0,1,1,0,2
5254,17c2d31e9a0d42f89433ebf95721b27d,2016-07-22 21:59:04 UTC+0000,18284571b03c4c0fa09aeac2c49a7803,8147e4d83ebc47b689901dc534981de8,1,1,1,1,3
5369,17c8e3b600f54959a6ae133d5bccd3a8,2016-05-17 23:55:05 UTC+0000,fdb1fcd36d084fe493a4df4d04ad0320,fafeba89ca764bd891862fb8440a2962,2,1,1,1,3
3581,17cb42f7f7904217ab85566c677712d9,2015-10-23 23:01:08 UTC+0000,6c99ba27424943c398a6de45684c63e0,c3c345b8e5044054a0544296ac29cb88,1,3,1,1,5
7753,17e6bfae4a454b189e33eb2fee5f0c61,2014-03-06 00:17:52 UTC+0000,4f14d11e3e83488d9bcfc427ccd43be7,3d8847ddc8d04185976a9e78b190ebdb,0,1,1,0,2
1563,17e781ea755b4d758f07b2c419bc54de,2016-06-22 13:33:12 UTC+0000,bc468cab215c426dbb70a9ca12882480,c9dcc1c3a5ab4c81afbb1de418c9510b,9,10,1,1,12
4183,17f0f737b1f64215bc6af243f832dbf2,2016-10-20 14:36:07 UTC+0000,6509114681cd4531b59b1fb817c2399b,e0375e2a3a354088aa36762cae83d2c2,0,1,1,0,2
2613,18004ce617904096940445e510098284,2016-05-16 16:18:49 UTC+0000,2527fddce082497a99f4e304aaca302d,ed29d7ba2f4d469ebc04b038e724e784,1,1,1,1,3
4186,1811df71a7634167aaa8ccad44d6d975,2016-05-02 03:00:55 UTC+0000,de8611e3dea5416ea63094cf2c3b6848,44ecf414c6914a82b2b7bdd03db2f59c,1,2,1,1,4
4017,1814a48f396a4425ad3d442d2c108822,2017-04-20 02:39:27 UTC+0000,af73db295a72480aa7f22e7c05af0622,cdc811f964f74479a5a8db13aca4698c,0,1,1,0,2
86,181d0fe5fee440d0bc0054e618407649,2016-05-22 20:39:55 UTC+0000,76fe41df76b0458bb813f2de18580846,f123a7e8ad2345b49378d51b2238c50b,1,1,1,1,3
4692,182b38fd84944f70884548b99b1899be,2016-04-11 23:09:30 UTC+0000,427b16eae63743f0a9a163e450d65ee9,a1006e6a58a0447592e2435caa230f78,1,1,1,1,3
1709,183a48a9c908480695b399518d3c55e3,2016-01-12 22:15:41 UTC+0000,a2dd0bdb20b2499db76d036655027f5d,a1006e6a58a0447592e2435caa230f78,0,1,1,0,2
7663,183f31c886e6410ebccab8224c4b3a42,2015-04-02 19:49:09 UTC+0000,470dd511cfff4a28b7f97bdf319c537a,2c285600a07f43508baefa37cd53cc02,2,4,1,1,6
6609,18498b3b7aa94958ac63773399f2d413,2016-06-27 05:32:45 UTC+0000,8e3c05655bf44949a88426342b6d88d5,f4759af9b17f44c9865b041a0469dc45,2,3,1,1,5
3549,184dea63aacd4a75a2016bf98176c619,2018-05-11 21:27:23 UTC+0000,5eee3cc99b104a2eb3b436d1071880ce,527bc8c35c8541f898bac819b29beea5,0,1,1,0,2
2355,18697906bf27455397c5908daf9a8858,2016-03-01 20:17:22 UTC+0000,2e4809c5c78849a08de9e4041169c62f,1a2e7e89bb9740eda5afdbd207261538,1,1,1,1,3
733,186c31ee4fad4c6fa3953f4f6d66a1dd,2018-03-01 01:11:31 UTC+0000,b093a13a7520477aaab3331eb500a053,e4e7d8f67e9c42918e24d2ce80e4e7bd,1,1,1,1,3
3230,1879c51e5d2148a8a87fc87f56442801,2016-03-13 22:26:16 UTC+0000,2c9f6f88fd8c4a048178cb0de19a5ab9,58dc8847d1e649878b8bb712ca3134e1,1,1,1,1,3
1724,1883b797ddbc4a2ead18305f56d0a7f5,2012-09-09 12:31:44 UTC+0000,9a42082c4b4f4a7fa8f1ca9bebd6822f,b1776598991649088c0a00a6e0a2c766,4,2,1,1,4
3396,188f4c997f7246f9bfe3e446b5298ee8,2018-01-08 15:56:04 UTC+0000,da22d537149947c0b27b9cdbab9a51a0,cb5efdb6742143169de54ee11b9eb314,2,2,1,1,4
6557,189883e6b9384ff68b05b4e64b566fa5,2017-12-15 16:16:11 UTC+0000,350cfccda22d428aa559857f46e3bdbb,f00cc95e7cd149e989c278f9d74995f6,0,1,1,0,2
4002,18ae20f786b64646a865bd23f7c3c9d8,2015-05-27 00:21:05 UTC+0000,58ae8a1206f54e5fbae3f5e97c2c8723,3bc676e80adb4c1a8f4e8432ee5848a1,2,1,1,1,3
5541,18cf20596eb94fcfa5d76647942d2294,2016-05-15 21:57:35 UTC+0000,8f5a3534c1bb4b0483bf6e7e95826cca,f08343a936ae4551b51ac5b7534a163d,1,4,1,1,6
5692,18d00ad4f2c44f97820d72c438f2aedf,2013-04-12 03:25:38 UTC+0000,e406d9444e5b416a8a0c4737ccb5a7df,f05b33a454c048f3bbc73f5f3f7f5127,2,1,1,1,3
2865,18ef20bc067e478fbd1230e7fd0c39f9,2018-11-21 00:14:56 UTC+0000,26f909f9fb384626955a35b2e139d13f,0dc881d6b8564bc7ac2d70d7cf8befb7,0,1,1,0,2
2951,18f29866e74646cdac28b75ff4eb8cfa,2016-11-02 16:26:12 UTC+0000,353db94965f143d88e9fb6b46ebd145e,bb4fe08bb5424f08972927d90bad9642,0,1,1,0,2
7575,18f591e95060453b8df3654454fcf734,2017-02-24 21:19:28 UTC+0000,d412a5307e8e47c78e78b1ba52848c80,36ff3b3666df400f956f8335cf53e09e,1,2,1,1,4
3467,18f8485afa0e4f559197beb9ee0ca195,2015-08-19 21:36:53 UTC+0000,95dec048e9ef4710a83fddd9c93f308c,a1006e6a58a0447592e2435caa230f78,3,2,1,1,4
637,19059d27c29d408996f865fa4ebf5134,2016-05-06 13:13:13 UTC+0000,47c927148e9342dfad094fd41be09304,36ff3b3666df400f956f8335cf53e09e,0,3,1,0,4
3908,19062539d5864e6fa0bd1b82f476b928,2016-10-25 23:39:29 UTC+0000,49150076be294cc3bafca5441b22d3e7,7eb73efbfb974d92b24408d514f7c213,0,1,1,0,2
4100,1914b683e8f2479d88106084dbdefd54,2016-07-16 19:43:40 UTC+0000,c316171bb1294566b5ebdbc91974297e,b472644419d141c79fbb3b3745750ed7,1,1,1,1,3
662,1924bf7a6d8b4bf3b95b0169e290a5ab,2017-06-09 12:47:38 UTC+0000,6558ce2013cf40ddb131ec536a7ae8ae,91ae6749fe4b4d3a8d49892fa5e103f4,4,1,1,1,3
3753,19297aca19764e948ba8561ccc5a5a37,2016-05-10 18:31:19 UTC+0000,bcbf5128934247b7bcc0bacdddf83320,3e03883293e94a8782beb98e18f37d2d,0,1,1,0,2
5143,192ad03a3b644b648aa5aad575ee55b1,2016-03-17 18:39:23 UTC+0000,4734160a09004aa39b855e941847f06b,c84a9b4a99a64aae831a476251dbeb82,1,1,1,1,3
5874,192d41533d1f496aacfc23bc560b975e,2017-05-26 18:18:08 UTC+0000,5bef00fdef7d4e6393a5f330d2e11237,8c1ed7125e6840bd935fd317dd9fb219,0,1,1,0,2
7524,1937a8b7411046aa939bc8dfc96bad42,2018-05-10 17:39:19 UTC+0000,41506e3cb7b048238a2610031ac18e95,4dc61581ec7b409bbd037e483f53ba0a,1,1,1,1,3
1241,19547fe39d644da3b9d56fb1792ad129,2015-04-07 15:20:29 UTC+0000,7bce5da83e354623892021674c189770,d4806789158f4d57bd69f047d25ad217,1,2,1,1,4
7083,1957b11351c74b5c80e34c47f85e91ca,2017-05-19 20:06:17 UTC+0000,dfa307758f114fc68492d211ebaefafd,8dcef0937fe345d3bbf4cdfaada8ca5f,1,1,1,1,3
641,196292d72e994e8c9c95680ca19f0544,2018-03-02 23:07:05 UTC+0000,538fec327d124dbda3f816512aaa3031,9156066c36d6479aa5b4abdde6882b1e,1,1,1,1,3
5155,1962d04c21e8466fb44660ac41088936,2016-08-12 16:18:42 UTC+0000,288600ce3da946dc810225faeaf98873,de51e745b6354185a0ca5d02dc628416,0,2,1,0,3
3749,1966cad97df74105b9f14f8822521c9e,2016-05-10 14:24:52 UTC+0000,1a8d8b740d284420aa658a56935a6e68,422412a0f6154a4ebf8f7dd026d66a5b,1,1,1,1,3
1470,19828fce6acf4951ad99d4b05d4f1e61,2016-06-24 06:03:59 UTC+0000,d548988b04e7479caa8b91761388217e,c85420d41be7444d9588f806457025b4,5,1,1,1,3
797,198c4d5ca4ac44cf91dddbd53894186b,2017-12-05 20:24:01 UTC+0000,fb074ac7814b415ab1e605889541d445,a0341977cdff4747ab6bdb31124a2271,2,1,1,1,3
6665,19a166a9aeb544b4a09f0d308511b638,2016-04-19 21:15:40 UTC+0000,ed449d018fa14c6083c3657050df91ec,36ff3b3666df400f956f8335cf53e09e,1,2,1,1,4
1079,19a832323d384645883380b00a57c3b8,2018-08-31 13:09:38 UTC+0000,01afb5e8644f4790b9443a85cd153800,36ff3b3666df400f956f8335cf53e09e,0,1,1,0,2
696,19b0bf27683e4204a7c874ce7d9794f1,2017-02-18 16:25:15 UTC+0000,813de0ef95b342ddb3e486d8cbd91d0d,d3a1a8f852a7409c8dbf511df4068cdf,1,1,1,1,3
7645,19b57f20d4fb4c189600931eeb91d6a4,2016-05-28 15:24:56 UTC+0000,09c4bae1731c40c8833ca5288e4e15d5,36ff3b3666df400f956f8335cf53e09e,0,1,1,0,2
4887,19bb8b5977be4f4ea4976dbf16033d9a,2018-02-18 19:19:57 UTC+0000,67deed0a5b2e409a9853a106c74548a7,ac83901fad384461ad33630aa2d823d7,2,2,1,1,4
6197,19c33f355f974992afdc1717dfc4081b,2015-10-09 16:31:01 UTC+0000,4e3b05220abd4742b5a1fe2694227359,a2ec54ab6e52447c81fead2e9fa2483d,0,5,1,0,6
4449,19c91052b8d7484ca09667369a3bcd8d,2018-03-22 18:35:04 UTC+0000,04a9bd33e4054c2f92fa46f56e06a166,36ddb593ca5742f29ed9b5ac66cf24a3,1,1,1,1,3
5581,19c97a407e724d40aa18cb0b76b352ca,2012-09-09 14:10:40 UTC+0000,ac1f842f48394998a3fcc0ad2d7e8c3b,4cf8fd05248647a088f3e2c4118f052f,3,4,1,1,6
8035,19e1b4fb883f4a55a1e6d1fa449b4422,2014-10-14 05:03:42 UTC+0000,6289924ba6b345caaf4cdfe76cdd134e,56444eb4b925439186a995602e9d7037,0,2,1,0,3
107,19ec28c74586474a826a34adf58a7350,2015-10-22 22:01:31 UTC+0000,71c2d20e62fa41a2ab96178c1a6a1504,36ff3b3666df400f956f8335cf53e09e,0,3,1,0,4
5668,1a00aa1323ca4e5db2bdee6beea05f50,2016-05-02 23:40:07 UTC+0000,917d47ff394349eca987e9aa1c7d8a89,5b85a1dee8b74d79a87d53e758d897c4,1,1,1,1,3
4587,1a039cb9f3064f76b386f84f303edc43,2017-04-25 22:35:44 UTC+0000,eb83927bab57477a922801b4061974f3,93ba5b112ade4704bb5e22a7a4c86d20,2,1,1,1,3
3071,1a1db78507dd4255b7ff4c7ac83d7ef7,2016-05-13 15:28:38 UTC+0000,e4bff9d8745e48f5a0a6b7f8f7e5b44a,de51e745b6354185a0ca5d02dc628416,0,1,1,0,2
92,1a24c7efb36345419ab2514a04b1cc43,2017-07-15 00:48:52 UTC+0000,5d650048ddcc4263b7555509bdff86d2,a2af59f297e240da8119dcbaf804db2e,1,1,1,1,3
7010,1a37c15638f0427ba61d95786b184884,2014-03-07 17:42:27 UTC+0000,cba071019c554054a4242fdf2e33c61d,3d8847ddc8d04185976a9e78b190ebdb,0,1,1,0,2
4577,1a3fe39f345645c588956f0bfee8be0c,2018-01-28 18:21:00 UTC+0000,10c6299ddf8f4fff85bc85a7df0dff9f,d3ba15fee0584d72971b06fb5cff6fae,0,3,1,0,4
6828,1a444e5e5824446eaf37f31effd72ce0,2016-08-05 16:07:21 UTC+0000,5f95ae6c324646dd98a75224928b9575,a0d46de21792450faf9c10588695d3a6,0,1,1,0,2
7027,1a463c1540f54fa082c20c4cc5b7ba5c,2017-12-19 22:07:15 UTC+0000,9fd8265a130f4438988b0fc8d2bf61d7,f2cf4f06be6b4795aff6258dcbbfad37,0,1,1,0,2
780,1a76a23c408341fca977d5c57ca96557,2018-11-27 09:57:36 UTC+0000,011b2f87c3314a60b4d9948132ae2f89,04ef7b7f004a4c11b606d24c92643c07,1,1,1,1,3
7769,1a8060a350d04e7fa14eddcfbf83753e,2016-12-05 03:56:41 UTC+0000,9e42cb029ed741e8a3827a0fe5759a17,36ff3b3666df400f956f8335cf53e09e,1,1,1,1,3
1528,1a94a8656a9e4c3a97f4500e3f2b40f4,2017-03-17 03:57:13 UTC+0000,c2cb9c0cbffc45fc89736f74aeee1566,1d09800aa6804f3c92a89decf1bd7fa5,0,1,1,0,2
5362,1aa64a380fe5458e8c444ac7458f68c6,2016-05-15 12:26:49 UTC+0000,ae311276cb6b4469a106900b4a6ff336,85a655fd8522486f927733eb4fe50b93,0,2,1,0,3
4622,1aaa9774a2364764b4d7fe65f0cd7547,2014-04-06 02:24:10 UTC+0000,6943a4924f7e4ee1ba568e2718104406,fe4543418c0846e5a65fa22b4ad9a304,1,2,1,1,4
6017,1ab78a6725724cdcb8f70efb375c743c,2016-10-31 19:47:19 UTC+0000,6a329dd942d84e318eb1abc62b7dee92,7eb73efbfb974d92b24408d514f7c213,2,1,1,1,3
667,1ac3f097ba194bbe8d94ad5b38689a07,2013-09-25 16:54:15 UTC+0000,e4270a3b00e14b468ffd6aa40c195d7d,34df5c19a4044e9791978f8ed867a350,10,10,0,1,11
6499,1ad04d93772648808b48a2cdf1fc86a9,2016-10-18 23:16:28 UTC+0000,1e28e360e40e47a3b5ddad1799439726,f07c63b5e5774d5480fe005279efe9bc,0,1,1,0,2
6059,1ae4e884ba7d499aa1b0945196ccdf39,2016-05-10 18:56:15 UTC+0000,0976e01ceeef4c59b86b8032af4b63ab,ee5c7a460ee14f6380b2b3e292b4aa30,1,1,1,1,3
7564,1b130c0c33ce4fe9b3e0ea5d5f57aa96,2014-03-07 19:44:42 UTC+0000,d9de9af7f9734a24ac559825bd7d5e26,50f4b7e7ee2140fcb66a70e575984328,1,1,1,1,3
8047,1b1ebe9afc5046ccbb328704e88e5cc0,2015-10-21 20:22:39 UTC+0000,e554bc001ece4cda9ef9524a83239fbc,597cd583fb1049deb9b68ce308a992a8,2,2,1,1,4
7717,1b47b9567960459daa2db5b3fb052d65,2015-10-09 15:24:19 UTC+0000,019aaa011b3d4c3aa085a0ef8fa00385,394b643d929044f8b14f991772e1a2fc,4,1,1,1,3
1132,1b4b1ab826184b12a13e711ec38440d4,2019-01-28 20:40:21 UTC+0000,ef4b6ae24d1f4c3b977731e8189c7fd7,4bf6e6bc431b4c398ab784b1b0203b38,2,1,1,1,3
886,1b61ef5f9d5c40568101dcd65240f896,2018-11-01 14:50:56 UTC+0000,b6d287e5e0154066a542bf16ccdc6f4d,747ac6263b4349a4ad1c5d9c3584b8c4,1,1,1,1,3
3686,1b63cd13455f4f0189ffa9c161fc13ea,2014-03-05 00:32:20 UTC+0000,ef3c60fb19a64f44a9b5554f6e5dc9a1,cb5efdb6742143169de54ee11b9eb314,1,3,1,1,5
3556,1b75d2b21a7546798d86db630d8248cd,2014-08-04 15:21:24 UTC+0000,98be1b720e6a431a8faa9f26490b90e8,05444a2f42454327b2ac4b463c0adbe0,0,2,1,0,3
1790,1b8591158aa34c3b8d171d4fd551fb1a,2016-06-21 20:47:27 UTC+0000,fd9e3ec4a36743948af0c65c6ade7f54,edefbb692fba4e3a90a7b426dbc4d9a7,2,1,1,1,3
817,1b8ab84104a6498db51984a024d8eb1c,2017-01-24 15:17:56 UTC+0000,658be7cb4221496f83ee4bb1ff8e8c1f,a5d53a25174e4b8a822ff13bc5aaaa2a,1,1,1,1,3
2413,1ba479fc57a74f039d9dc216a8465602,2014-03-17 21:43:52 UTC+0000,4dcaa323eff4470f840c9a86d930a22e,1fbcd8b315de45c29ff87cf912b535fc,1,4,1,1,6
3892,1bb6ddd3cd804fbdad8bb0d853907e92,2015-05-15 20:21:10 UTC+0000,6c4090ce70a445d3837b6522a3b5dede,4bf1020c28714181b8d47bdf4246f134,0,3,1,0,4
2708,1bc8f44cc6af4d52bd581d98199438be,2016-05-18 21:28:01 UTC+0000,0a94c434573a454a82082d6b708467cd,91576804d1794b25a49ffef6d836966f,1,1,1,1,3
1609,1bd43eaf15234bfd89516e337afd7438,2014-04-25 02:40:57 UTC+0000,c3f4c36a5af543108165ac7835749ba0,fe4543418c0846e5a65fa22b4ad9a304,1,4,1,1,6
4045,1be78a0df2b34c778c62958a004d060d,2018-03-15 22:01:43 UTC+0000,9224c648b88146d7b2f7c3dd1542a955,8f0d5eef37dc432a8597eaf2078c2b20,4,3,1,1,5
226,1bf73997969244f7b9f90bd20a5691d4,2016-05-16 18:36:44 UTC+0000,3234a356b9b740888f0d18a657292ba8,7667c23d26ab409ca3e49758f5367925,4,3,1,1,5
4725,1c007d3ffb2448bf9bcca3c881a15102,2017-03-09 00:02:39 UTC+0000,318c3dafb57c4cfe9abbccb59e11f96f,5c4960f30bf04d4aaf100551bb9c349f,1,1,1,1,3
706,1c0894adec0945a18906ba3c24c0cf9d,2015-01-27 02:03:20 UTC+0000,0bf08aa2aacf4caba9d12a5164d4750f,1bb341c8874d4dae9235cb6480ef7d57,1,1,1,1,3
1219,1c09dff9d7224e26acc06a2b179ee1a9,2016-08-09 00:45:06 UTC+0000,51ddcd7ae46a436d93960d1d1a559141,6f5e381db8c74de5b9dfd5cc3759fded,1,1,1,1,3
1550,1c0f348262aa465b8d119adb2312e555,2016-05-29 01:28:42 UTC+0000,fd91bb6102bf4ef09114129fe0bc5722,c8ffe6358764451982263916bd7fac79,1,1,1,1,3
1319,1c12198d1cba452ba0f22b4ab056e452,2017-07-07 23:45:31 UTC+0000,8dc091ea0cf2402b95c86b87863357a0,be5d23056fcb4f1287c823beec5291e1,0,5,0,0,5
2399,1c133aa5a7644a48a99eaf6b806b6246,2016-04-29 16:32:25 UTC+0000,4dfdfa0ce97e4d10936eac6c4b541a58,215b430910074aeaaf24538cee33e35a,15,4,1,1,6
6171,1c2bd17cd4c54358a6ea7cb1a407917b,2016-05-13 12:46:45 UTC+0000,94cb2d9b48bd43c8a004be9d82831cf1,58fa5e95fe9e480a9349bbb1d7faaddb,2,2,1,1,4
825,1c2cd3b063394184b123f89efd4b2fe4,2018-03-07 18:45:23 UTC+0000,b82307e102da4c4fbb5a85b69f075ae3,05ab77d4c6a141b999044ebbf5415b0d,0,1,1,0,2
5875,1c3bbdcebf9e402b96941c7c5addb3d4,2014-04-22 23:22:40 UTC+0000,6c9962f52d984d2fa11fde65aa6e30ad,e4e7cc05a0b64cd6b02168d404a45d4f,0,1,1,0,2
1199,1c6a24138df047f49c3a07928ee56658,2018-04-25 13:10:07 UTC+0000,0734551f85ed45588002a8eb8fa6fe87,b9d984e161c64171a9018e02b03eab3e,0,1,1,0,2
7422,1c7da8155ac14229887ec2fc33a17274,2015-04-20 17:12:32 UTC+0000,e98f58b8ffa540a8bfbd4bb93d3ab078,207c8c62bcaa4033885a24a8a5a10d51,2,5,1,1,7
7219,1c8d34482960419faf9b5c83f1e4e6fc,2013-10-01 00:00:44 UTC+0000,8918374c2b00438dab184e19e6f3dd86,207c8c62bcaa4033885a24a8a5a10d51,4,1,1,1,3
1881,1c8ea583dd4e4e0488c4ec62a8800ed3,2017-02-07 01:42:51 UTC+0000,9771d443c16749799d545b1a0c3511c0,d97aaa6b7f7e4b1e9a6d65d5a0958183,1,1,1,1,3
6878,1c931b1ccfc141c4b9705972b007d012,2016-05-03 22:39:38 UTC+0000,0854f0b420ef404f89d0dc6df0202d2a,fafeba89ca764bd891862fb8440a2962,1,1,1,1,3
2185,1ca478168fad4052adfe0caf47ffd1b7,2016-07-26 21:47:27 UTC+0000,2c86832a1d1a47eea7a5791cd1560fcd,dab1ccb54ed44b9dada34f70ae039814,0,1,1,0,2
5390,1ca5506655b6400a8c4b3a431c5db116,2017-03-27 22:42:25 UTC+0000,b83ea87da9fd4e6d902506c34d1c382f,731578535aed427985c63484c371a35b,1,3,1,1,5
6296,1ca6499b0d554aa496d124184f85809d,2014-04-09 17:25:40 UTC+0000,e67a6f4b1c8a417aa6e859a37ee3562d,fe4543418c0846e5a65fa22b4ad9a304,5,1,1,1,3
109,1cb5e60912fb4c52a088904eb3cf1d27,2017-07-14 17:59:49 UTC+0000,b625503c8b784faaac39d39f68ad0c27,9de113bc7a134a289ef2244b9826128e,1,1,1,1,3
5433,1cc0a45a6c804ebfba1c054e01cfeb6a,2015-10-29 18:59:45 UTC+0000,92b6cf7f679b4cc0ba652c14ff219204,36ff3b3666df400f956f8335cf53e09e,0,4,1,0,5
4813,1cc1b8b42a384d048cf76341b88a1815,2016-05-13 11:33:47 UTC+0000,03b171c2e30f4009a3bd53545a767d1a,e1d39b665987455fbcfbec3fc6df6056,2,1,1,1,3
7802,1cd79e42ac044f1bab53f356c096b956,2016-06-27 23:58:19 UTC+0000,6496abd9a9bd46469317df39f2997327,e3605142dffb4d87a0f8b950da727f73,2,1,1,1,3
591,1ceb77c4b14540f28970a2dc4dd3872f,2017-02-27 22:11:06 UTC+0000,4fb4b6bd28804f48ae6f20f0157e0067,3c22741e82b14d1484261e4263416fa7,2,1,1,1,3
2889,1d104af4c29c47a191a6c230e747c187,2016-07-17 14:11:25 UTC+0000,796ad42f1df046e89e53f012fa21a9f5,c39329e6c790449f812590c3b897aca8,0,1,1,0,2
6039,1d20a3bc2e9e41de8157389d628f5951,2016-06-03 20:11:41 UTC+0000,8b51d929762042f5941f528edbbbd480,bb4fe08bb5424f08972927d90bad9642,1,1,1,1,3
952,1d2970200861421a9abd98e7d5d61c90,2016-06-16 15:07:34 UTC+0000,036304d121b246e5b7edcbaaef041416,58fa5e95fe9e480a9349bbb1d7faaddb,1,3,1,1,5
2460,1d32af9174e54e478dcb7a7d2a96890c,2012-09-09 13:18:11 UTC+0000,27d320b3a8ae4e6c95f872a1e3256ca5,b1776598991649088c0a00a6e0a2c766,2,1,1,1,3
3432,1d344fb8fab84fa6bdecb5497d4fb885,2018-08-03 19:42:37 UTC+0000,f9c380ce92f74cc89a7693a122a36ddc,599fdcd031934f08854b56fe4a03bdce,2,1,1,1,3
7156,1d37059969924e2a8680075416144cf6,2014-07-18 17:34:10 UTC+0000,cb61ebc9b1b243ce985efe3dd4df6cd4,0c0ed374391349fda6d982624bd0bd4a,0,1,1,0,2
633,1d37482ddd534627bfcb1826c729cb0a,2018-02-19 15:20:29 UTC+0000,6b9458e1d2ca478286ed531cc91eefa3,be5d23056fcb4f1287c823beec5291e1,1,1,1,1,3
6867,1d47528fad944c7db50df71324706576,2017-11-05 01:37:25 UTC+0000,0d9e332572d741e9b65d95e82792c41b,b49a8456b8f84c7fa9665aa42f7987a6,0,1,1,0,2
5828,1d4a6b357c084529923a1d45f56e408a,2013-12-11 08:55:09 UTC+0000,98d9e88070a34a46882ae7e8d5a36e36,bc7501d85c4c473a925c54864b459d44,0,2,1,0,3
4079,1d6f4e9508c942c798c07964d3402e7a,2017-05-01 23:14:04 UTC+0000,c8472be1b5764dc3ba50093cb7d86fae,27635b0b3d00420e8cb8c10f8ad9507e,3,2,1,1,4
5452,1d9811f79c0944d587faec8dbddc783b,2016-08-17 17:47:37 UTC+0000,3e05956536f943de8bc768d3755082af,a262a084918e4d69b3fb891054753b5f,1,1,1,1,3
3780,1d9992ac33c74d10aafe24af23b19ba7,2012-02-07 15:52:55 UTC+0000,801b1aba1b5a4cb99e7f9b37b556da8d,83de8cd32aae45248eaca67fe2a27f2c,3,3,1,1,5
4721,1da7de8f19aa443181bc0668c12210ea,2016-07-06 23:25:30 UTC+0000,b3cbe201c90e4f02abbc135f25d0c75a,90275e799320405bbd2521b88a580ee9,0,1,1,0,2
4612,1db25e7bbdba427b85d089fd7e140826,2016-07-29 19:21:19 UTC+0000,72a6936da160409bb31f35e62e531dff,72b238385b3e4277b3c81784e56d07d9,0,1,1,0,2
1747,1dbb5073b85e471b8cc27e0126092d79,2016-01-05 18:23:38 UTC+0000,a7324088d21047b5801ccd52686dd336,a1006e6a58a0447592e2435caa230f78,0,1,1,0,2
6876,1dc5af36df5d42eb842640d2ea729be3,2015-10-22 15:16:38 UTC+0000,5c99582e280342bebbe06cb83f8657d9,e4e7cc05a0b64cd6b02168d404a45d4f,2,4,1,1,6
3824,1dc73e857d4d4d4c9c02a56338ae1021,2016-03-14 02:37:58 UTC+0000,d676ae7e95af4266839c83595e5d9a23,3843a956582a434eb0ebee396a71982c,2,1,1,1,3
283,1dc7481809bf46b5a0b2ddbffcd7a73c,2016-05-22 04:40:03 UTC+0000,61bf0ffcffbf4d95a659063cfdefae13,34df64a2783a4623b22b4f3afff97d28,3,1,1,1,3
2665,1dcee6015f4140a79572e4e474f16215,2017-01-26 19:09:00 UTC+0000,231db4a80cda4e9fb3a8fee16f8428c5,29655695acc24bc0b566959f47e8ada5,1,1,1,1,3
2686,1dd6a43ae823452a923c81c7d7151d88,2018-06-15 19:49:29 UTC+0000,54db445a98e3480ba125917fd05d11e1,a0704855ca1a413c8f3b70c84922b400,0,1,1,0,2
117,1dd7690a8a664013b57b332ba9968f4d,2016-04-21 18:07:45 UTC+0000,295fe910e98d4b24b57bee9499d68355,58fa5e95fe9e480a9349bbb1d7faaddb,1,3,1,1,5
5626,1ddb52a2aa24427aa8220828cb73e68e,2016-01-21 17:59:11 UTC+0000,434a349ba49544949d1533584dac290f,a1006e6a58a0447592e2435caa230f78,0,2,1,0,3
307,1de7e535f40243bc8dc7865cd29e85aa,2016-06-27 22:47:27 UTC+0000,0e7e39c596b54e238d24c3e24a68f5d0,c24c29c966e1431bbaa36bc900457cc2,0,2,1,0,3
6691,1de82c4514764ed0b87602331947a31e,2015-03-12 16:26:07 UTC+0000,cd173c158d054315b20bbf52e5c3c1d6,369f1c8646b649f6997eae7809696bd5,3,4,1,1,6
1334,1deedb9eaa0f4ecbb9a427b3e1e5b58c,2018-04-07 00:17:59 UTC+0000,56d6bbff42eb4407b2216eecb9d93061,e1d39b665987455fbcfbec3fc6df6056,0,1,1,0,2
5509,1df7da0396ff46b5b0b30557e4df4592,2016-10-23 20:35:28 UTC+0000,d46e21ceaea244fead0367b0b8aeb95b,5f95b0ac821e4e8e9b4fa9fc8eb9ff61,0,1,1,0,2
3443,1e2c9708f88c48d1a67439c10ec13389,2016-10-22 00:36:57 UTC+0000,8828d388b3df409fa59ed08f0690c7d5,c258f388f42b4f608dd6fd8e9b6c1dd6,1,1,1,1,3
2312,1e3e4cff78ae41c697d7a16feb303542,2018-09-30 11:25:24 UTC+0000,45c3abfa445a433a85aaac475229f4cf,36ff3b3666df400f956f8335cf53e09e,0,1,1,0,2
1308,1e42e42f35b049dfb3edb22c7a3af803,2016-12-27 00:00:38 UTC+0000,68074fa1b4e7413e9aff441e58eb1e65,7e721be7613246dd9f1aee1fb31271b2,0,2,1,0,3
718,1e5c3a83d93a477eb81c0ab45aaedcb2,2016-10-05 22:28:31 UTC+0000,b0a6e5f5ba0348e8b48fc72bbcd8a55d,a1006e6a58a0447592e2435caa230f78,0,1,1,0,2
3035,1e5ddf492c0f4fa5a6852c16390ac8de,2014-04-18 03:35:31 UTC+0000,9e41a3aee6c8488383e82888de20d86c,fe4543418c0846e5a65fa22b4ad9a304,0,1,1,0,2
7431,1e657ab210884a939325e4882996fdbc,2014-03-04 23:13:29 UTC+0000,8cdc70eb370142f7ba201f80973053d0,23b6df4d73fb4d9bab3eafb6dd8bfb86,2,1,1,1,3
3106,1e71b36c0d8740c782de78ad27c52ed2,2017-04-01 00:41:39 UTC+0000,4c22a147575f46d3ba5e053640e8617a,32c687e46f4247c7be7dca26082e6e92,0,1,1,0,2
5777,1e844e3c88dd4789b03a2fc40118c4fa,2016-05-13 23:20:14 UTC+0000,a560a6fd1edc466783f250ececf105a0,fafeba89ca764bd891862fb8440a2962,0,1,1,0,2
1473,1e8cd71c688049f6b14fcef267030d38,2016-05-02 20:51:15 UTC+0000,93e2185ee3224a1897f2f6150eba104f,a2ec54ab6e52447c81fead2e9fa2483d,1,1,1,1,3
4477,1e90b946984441fca325d0c16a412443,2018-03-22 20:23:33 UTC+0000,9e9e26d9860141148fba3ed3869312f5,cb7141606c7b4a00ab42547b55091978,2,1,1,1,3
3664,1ea75b383abe46bf9eb92c6e8f8a7143,2018-05-04 01:26:08 UTC+0000,4b6c86addc874b97bb94f84b27d2d8c6,97b502378c54444bbb0e0c1a6cfca62f,0,1,1,0,2
3804,1ec7f61058d1483ba6d38b08c93ba56f,2018-08-15 21:47:15 UTC+0000,eaf2041ba79f4911a19ba93a48c3b521,36ff3b3666df400f956f8335cf53e09e,0,1,1,0,2
1719,1ed04479d7794314bc4bb03d96132215,2015-01-16 15:54:55 UTC+0000,18aa9418911b4755989671cd792927c1,e0c316d82df548b499a954e0ed70300d,1,1,1,1,3
7317,1ed48d2fbf0941dd8d19eff03c8cf8d7,2016-12-30 17:14:55 UTC+0000,ff75a4dcb8df4d8e8cb7e1f82d9a13cd,484a89383511425d9de4d0435c50579a,0,1,1,0,2
4694,1edd51b783e84ad793d6d19adb19c68c,2017-09-06 17:21:30 UTC+0000,da3f246a0ec94a6a867dce9a7e6a789d,c3b4e11154f74a858779be7ba9b6f00c,1,1,1,1,3
5114,1edefbdd02844199be4875150de6a6c4,2017-01-30 00:47:13 UTC+0000,8f10f55bcca942c7931ceeb7f8d47a43,2ec53eda8116415784bb10d34d663215,0,3,0,0,3
2391,1eeb0b6538c74b0c8639668a8d22179f,2018-11-15 16:19:35 UTC+0000,452afa68751a488287bbdbdb6a321d7e,a7bf251a290b418e923e8f04a67b7ebb,1,2,1,1,4
1807,1eef7c197fc54878b0606c54b3fcd4d5,2012-01-13 17:42:16 UTC+0000,b607c0c90131480a9eb88696688f6a7f,392a273cb57b42389ec01a8fcdaff3af,3,1,1,1,3
709,1ef67f1838344aaeb3dfb5feb03563ff,2018-05-22 11:24:50 UTC+0000,1d1f4fac5ae146fc8b4446f18116f5e6,be5d23056fcb4f1287c823beec5291e1,0,1,1,0,2
4647,1f0087febbed4a17aed411d92897afd8,2017-02-07 20:26:04 UTC+0000,208fa4b6d3974f5a981d62909b0c80ff,fe992b40790c44268198effc2059d7b9,1,1,1,1,3
6406,1f0361494c2a4ac3bbb84a55280475af,2016-06-23 23:47:54 UTC+0000,47811e84119b4d8f8545fdd53f37e144,41149875d05f47a4905cc1466ed6ab34,2,5,1,1,7
826,1f0707fee7f8411fba740e9af79a97c8,2016-10-12 02:25:35 UTC+0000,b4c3bef7abb44250b2320174694a899a,9428eb3c67e540f3a1d3e5f2649656dd,2,1,1,1,3
5958,1f19cdd3abff4ea3879e7625e3153289,2018-03-20 21:07:05 UTC+0000,9dae212b3fc2480fa35ba526d2c3bcde,1944a9ee57154bc38f9efac7d2c00f58,0,2,1,0,3
6123,1f244a1ef3044886b7172928b2367ee5,2016-05-25 00:29:25 UTC+0000,4a57e78b4bb642d7b68bd462a076c987,b99f46f651d7481599f627517508854e,1,1,1,1,3
7631,1f2a4ed680814b21966c111a1359dbb2,2014-04-06 02:40:57 UTC+0000,eabf01d5b625456aa573b7e0cb98f2ec,fe4543418c0846e5a65fa22b4ad9a304,1,3,1,1,5
4131,1f2d55b0fa1f4a89bc50a718c3f62ec6,2016-05-19 15:12:55 UTC+0000,4efd80d37bc446e98aed358e21374e59,3503353fdfdc46afa5528bf6696a2317,0,1,1,0,2
3226,1f355eb7f08d4bcea801df8c5bd762ea,2018-06-20 09:25:20 UTC+0000,365b44b5dcc5492c84584808d6cb72b2,909eb5c8d66e4fc185656ea6772b127d,1,1,1,1,3
7196,1f3b062623ac4d90ad680aaab0bb1ffe,2016-07-28 18:53:19 UTC+0000,2dd019ef650e4aeab984ab12a5956075,a3f6d682096743b2b88e7d3540f3dcff,0,1,1,0,2
5900,1f4514ea3d054caf9c31738136b6564e,2016-10-20 18:51:55 UTC+0000,534519d145ce49609d7600a518327497,5f95b0ac821e4e8e9b4fa9fc8eb9ff61,3,1,1,1,3
5341,1f51c5c36baf4c4f928946fd7bd8785b,2012-03-08 08:26:47 UTC+0000,f12094ffa2fa4263b674fe43a81b7f84,9c5803ae43ca4cf6b27ea85871625116,6,4,0,1,5
1674,1f6b5232775e45c2ac132fc898ff8b4d,2016-06-28 19:19:50 UTC+0000,2403ad69bb0242feb4faeb15dc250b30,e3183b5ad8e84d2984d9fb22ca84fb83,0,1,1,0,2
6833,1f6dfc42f34f468185c921c8f804f568,2012-09-17 02:44:38 UTC+0000,a310dc0e090a4a618b629b25773f0f68,9c5803ae43ca4cf6b27ea85871625116,2,1,1,1,3
4434,1f6e2982a02749f6bff4d710c514d8a5,2012-09-08 15:03:07 UTC+0000,b107e49a0b61474b94ac0bcc91867a41,38bc1866f29744f9a003e2e826e3fcb1,10,4,1,1,6
6688,1f6f9363946143b5bdb737a2f61c089a,2017-03-10 10:30:49 UTC+0000,6a928fbe9a2642abaa90285ee7af806f,8478c6985d1e4ee88086754cf6200ed1,1,1,1,1,3
7217,1f778c29a8a3421082c3920c4a5f0e85,2016-07-19 20:28:44 UTC+0000,31ca246a29234fb1a8bab552acffc44b,36ff3b3666df400f956f8335cf53e09e,0,1,1,0,2
4625,1f92a0e2eea24665aa6d53a2724125d6,2013-10-04 17:41:52 UTC+0000,0bff5d09732c491795eb5c0aa3f7ee6e,43da54406c50437890635d06acfba548,6,3,1,1,5
6999,1f944c350c104893b7b814e6ac1edbd9,2015-05-15 19:57:20 UTC+0000,c7b544adff1248ec889a4deeed1b7dda,4bf1020c28714181b8d47bdf4246f134,2,2,1,1,4
7978,1f9a1837a82f4bdc878903792cfbd5c0,2017-11-27 13:10:55 UTC+0000,db777fbd52834b40b9d5405a165aeacb,a1006e6a58a0447592e2435caa230f78,0,1,1,0,2
5495,1f9a2a23fd1a492f956267d24da8af08,2015-10-19 20:09:03 UTC+0000,c39145bfb18d41d4a961dd83065a0794,c3c345b8e5044054a0544296ac29cb88,6,2,1,1,4
3482,1f9df9c384e04024a064b622fde15e23,2015-10-30 19:23:10 UTC+0000,c506f7ebaf67422cb727d40c4f2fc5bf,6341f3b3de94493187c71b7dee3274cf,4,3,1,1,5
7097,1fa5395fa5714534a5506960d6d11bc1,2016-06-21 11:13:52 UTC+0000,c4d240b6593c4c0c89bd2a62df474998,9c790846805047818338a69efbe7be0b,2,1,1,1,3
3935,1fafaa982f8e4b6cb76ea00648a9ea5d,2017-02-17 15:45:56 UTC+0000,68a6ab8a1687463bae9978b7d6317062,416321b48a634ac8a53602625f0a5d40,0,1,1,0,2
2032,1fb6cb9ebddb4894889dc021f0eb2fa0,2016-07-12 16:21:16 UTC+0000,18452fe3027d447296d9cf871136bcb0,12e8dea2f3534f6dbc31701cf64f9a4f,1,1,1,1,3
270,1fbb2ba426b04ca2b341055caaf9b415,2014-04-29 18:36:31 UTC+0000,213dc35787ee4c82815d3094e098e125,44b2484ecd3642c6a47514f3876cf14a,1,1,1,1,3
248,1fd92a25315047b78e0358091d88a99f,2016-05-21 14:14:49 UTC+0000,1a5a23cccede4c0f9bfedd55a16d5b7d,36ff3b3666df400f956f8335cf53e09e,1,3,1,1,5
941,201623160e9d4085b502c1422393aa8a,2018-02-27 00:43:28 UTC+0000,60efcfdfd1fb49a3980ad8da08677ae4,887c5a142b42466fb74740d72989fc74,0,1,1,0,2
6813,201e0b7881ec49e4bf74a3a1f76c20b5,2016-03-01 20:05:49 UTC+0000,e3ebbbaf586d47059fa207294bea82d8,a1006e6a58a0447592e2435caa230f78,0,1,1,0,2
1659,201ff61152604143927782af6ee00a91,2016-06-01 00:33:04 UTC+0000,bfd847bc19484b33a998e1c0ce353c30,58fa5e95fe9e480a9349bbb1d7faaddb,0,2,1,0,3
7493,202c8b943d9c47a1a56ad41406bcdb9a,2016-06-01 23:52:46 UTC+0000,b0d5b2da82414550b7218a43ff500508,ff7a84dfae5f412d9b3857784c3d273a,1,2,1,1,4
6970,203fa6a28c0645cba4dc8f6fb1143a22,2016-05-11 18:58:54 UTC+0000,006fc75e80b74dfcae28d7d353671109,e08c6ad14ba24315afc5985dedc71be5,1,2,1,1,4
464,204b6d092e804286864fd56a0471bfa5,2016-05-18 10:46:09 UTC+0000,1e18a2cdf0dd4f748bd49afd461dc74a,b342ccddf46547bb924181e958432391,1,1,1,1,3
4220,20557646f4fd4c3c9e10a53d2a9339e7,2012-01-10 16:30:01 UTC+0000,c6a37b7d02674cbdb287ba82faa24a98,0380464990eb44668ad558d5624aa895,6,2,1,1,4
5242,2055a305f4c94cbfa46a38d4faf4c9cf,2016-10-26 00:17:34 UTC+0000,fe7dfc4636a54b7bbb9e9f3aa2560428,cc834e591bbe41b49e426190a58643e9,0,1,1,0,2
5656,205b08a35f314066ae3faf062a5009f8,2015-10-23 20:07:09 UTC+0000,32f21cbaf91b49e1b2e955dfc9e13f02,a1006e6a58a0447592e2435caa230f78,0,1,1,0,2
7339,206af80b02e04d8e8dba1536f2c6c985,2016-05-13 18:49:55 UTC+0000,4052375077794ec2b8ca67c76a59bfeb,eb9fb27be0b84e4eb559b741e442c1fd,0,2,1,0,3
7413,207a8745e6324445b8c488bdc0fcc810,2016-12-29 20:13:31 UTC+0000,7cec5697d0774ddc90f5136efe030d0c,a1006e6a58a0447592e2435caa230f78,2,1,1,1,3
7361,208b0fa2001a41188cecd1f75b5f0b8a,2016-10-21 16:13:04 UTC+0000,c0e2d111f5154033ac03934bc8eb61c6,7ec67bb73ec44e6cbc77da3b8ac5a835,2,1,1,1,3
1292,20955736f75945f4b7c3e28e599b94b0,2018-01-27 14:25:04 UTC+0000,22d3952c2a8246b0945d428973b7db60,81a594b683d54e6dbb4b04ea00a5e25b,0,1,1,0,2
1496,20988ee2d51b4d63bb5a1d518bc57396,2017-03-15 00:38:05 UTC+0000,f8783cb27c334d6db1e48aad4b38eb13,41b3984603ec43bdba6404c675800889,1,1,1,1,3
7566,209d015d2bf742f8ac8a5fe14bef687c,2018-01-04 19:41:25 UTC+0000,f911e1b535ce4a2aadb64cd48c71b044,80a592db19574d279aace660033bc0e4,0,1,1,0,2
71,20b2c66778544dd09b64bc0bac624a9a,2018-03-20 21:51:22 UTC+0000,2b6fbb77520842dc8f20162b16f85711,42f2703d87d3455aa4d1b84f12025ebd,1,1,1,1,3
4381,20d3ef355288462cb0dc6fa176481187,2018-06-04 00:54:29 UTC+0000,fd4749aa70314d7b9adfb48d225d5743,36ff3b3666df400f956f8335cf53e09e,0,1,1,0,2
6208,20d599cd4d3846bcbc257066bf6b6ce7,2012-03-13 16:48:23 UTC+0000,a30e765d8e804b399879d9f7634045a9,2a8328f6ceb548699a64293f986f3d19,10,5,1,1,7
183,20d99f608602465bb1d1b8a1feb20b31,2017-10-03 19:18:23 UTC+0000,f6c8c4b5d3a84529a191b3418f28e2a7,cc108f1440844808afe5a249fe084490,0,1,1,0,2
1037,20de7e28ff414a7086133a4e8ec0f0b0,2017-03-09 17:17:52 UTC+0000,a1735841177a41f582be3a6bc83ba639,96bbbdd06a334805a0501034d9df1aa4,1,1,1,1,3
277,210e630f1139495790c69ae4beb759cd,2016-02-16 20:57:12 UTC+0000,11c3e2f902e5422f8943b83e63e14442,a1006e6a58a0447592e2435caa230f78,2,1,1,1,3
3673,2112c8dbabda4bfe873a8d9bb2395287,2018-04-16 21:46:41 UTC+0000,e99586d085a74dc4840af33ad1c46f6e,36ff3b3666df400f956f8335cf53e09e,1,1,1,1,3
900,21247acf3792476bb7091eeb9ac1e9aa,2014-08-06 19:04:38 UTC+0000,d35052a94dba42da97f360c46bf2630b,05444a2f42454327b2ac4b463c0adbe0,0,3,1,0,4
1045,2125061f59fa4d73826989f2bd85030f,2014-04-12 02:01:07 UTC+0000,5a3b5ce1fdd94fd693b09310020fa57b,fe4543418c0846e5a65fa22b4ad9a304,2,6,1,1,8
2119,2147e5ba1dae482e994f6e4c93502c4a,2018-04-15 14:32:34 UTC+0000,a33e8efe3a544f1bafae30cbcd6f6df8,a6d33c38902546849c36ea7e9e9f0870,1,2,1,1,4
7409,2158eee69c29456e9bdfa2a4bb23bcc8,2016-06-24 12:12:46 UTC+0000,84b8c60380d14a02b14e83cba649cb65,628ba982dfba43c0b6d692983cf5a3a8,6,7,1,1,9
3480,2169eeed29314ea5ad633aba68e990f4,2016-03-02 18:12:38 UTC+0000,3d0fbfc8cc8c416db75984bbe4b667cf,bc2cdcb91ff3452d9ae443460ed3241f,0,1,1,0,2
6812,217dc0abc6844b0d89eadd0c42ec24ed,2016-10-19 20:17:11 UTC+0000,cf26cd0145d24d759f51e3f7408410c3,36ff3b3666df400f956f8335cf53e09e,1,2,1,1,4
6533,217ece79164c4693bfd8745570c061a2,2017-07-05 00:45:14 UTC+0000,11aaf8238581467e86b33cff9b07a261,dcbb11b0627b4597904f7becf403664f,1,1,1,1,3
1035,218966ea050f4d6da783d8c81c8c5975,2016-05-09 21:21:26 UTC+0000,54179e77c309419d99d9346fdbbd3c1c,7bffa1792d474359b922e5de700d7a82,1,2,1,1,4
1703,2190e51dc54a4446a6de9cf2970634fe,2018-01-16 16:46:13 UTC+0000,cb568a14fcd149b68dca8360b9347f08,598351eefc5d436dab91070c7a0e6ba1,2,1,1,1,3
3927,219bcc3ded264801a7e1a39ceb488187,2016-07-01 23:24:22 UTC+0000,481a42a6783a417a80c66edaa1a5af04,ec97070fe75544e0bc5888f9f6120822,2,1,1,1,3
7659,21af038ef677481bb6128e0982cadac2,2017-03-09 15:55:39 UTC+0000,c9e073c17158416d944e96f7ca945184,37b504f5e71e46c6a7b793b13dedf5ec,0,1,1,0,2
5544,21bcf70c7364401db64400f719e81f90,2018-06-09 16:29:00 UTC+0000,0205a384884c49799d35ec0d9a3e8e49,148e2f047f4f48eda43cb1a65d91ad8c,1,1,1,1,3
954,21c888647d5040ab8e3478de34880748,2018-03-19 20:53:36 UTC+0000,bd0967c0f07c4e50952e7366424c4735,c258f388f42b4f608dd6fd8e9b6c1dd6,0,1,1,0,2
8021,21cc8fc51ba34ca282b9f2cb7a9421d5,2014-03-29 21:37:36 UTC+0000,9084fdd15a9d4f8c81b3cc3b6c4b37e9,861fca48f47c4fccae43a799f4442684,0,1,1,0,2
289,21d06cab0ce4400fb7e460232ea413bd,2016-08-09 23:33:09 UTC+0000,9b823091ca3045d18d32564457415ceb,df9d995ff70046a3a51884e9cd788510,2,2,1,1,4
7119,21d1764bd4724781af8e70a114ad0109,2017-01-27 23:07:32 UTC+0000,4855e1a1bad64ef2b6535e7055d502e4,28c9a5e6e99141a9b4fcb040469354b2,2,1,1,1,3
7650,21d8a63099f34b1395775e37bbfa9869,2017-02-01 23:44:02 UTC+0000,875f1cbd671449f9a2246df7139df1e1,0dbc01c20c5d4a1484a7ddf859b016ae,1,2,1,1,4
4342,21dfb9e643d74a58ae2a364af28d8599,2014-05-15 20:45:01 UTC+0000,2e2c2a605a6843a58a2e66ec3ac67c2b,05f3a4c6c4644d9a8b76bc7295058f59,6,3,1,1,5
893,21f94ef93da0458ba715a867dfa7ad55,2018-05-19 23:48:24 UTC+0000,9e5a2967fa614f9da49ed0c464a3ca74,5310dc904482493397df5f8abebb3776,0,1,1,0,2
85,21fcf528936d44ac8d740efa781b4b3a,2014-04-03 20:11:49 UTC+0000,087ee9760884455d82fbd4ba2b89b04f,13bb73a3399748e7b75d93e07b20f668,4,1,1,1,3
7791,21ff15d17b92455c9c99183fc7e5d0b8,2016-05-14 12:41:56 UTC+0000,598855bd4be04d6ebb2b60e23a62d8cb,bb4fa1294340458b876ba2c8a6101880,1,1,1,1,3
6340,223dface894e4b97a3b9c4ae806524d5,2012-05-29 20:27:31 UTC+0000,bc5b3c94f6854a6a9211f30ce1c052f8,c022c18dade74a7f8d6af25d23dd0685,3,1,1,1,3
4760,223f49bf1fa043c9b5c3564abf7863df,2017-09-03 01:53:55 UTC+0000,3f6ee960240943498ca3b79616b1f9fe,f62b1d3d9e6544a08442a634b7e033ad,1,1,1,1,3
6802,224111a5de0d4ea49b78d079f06f41ed,2016-05-25 02:05:24 UTC+0000,a9a5016858584120b9dda6d821dc9f00,aa27976302f04c74a36ac18825e490c5,1,2,1,1,4
5585,224f44601b6b4c49852230e591c598e3,2016-08-19 13:27:56 UTC+0000,816a8bd82d4647acb04a4eb3077f3976,a879ecdcf3634945ba691e1a8da87245,1,1,1,1,3
5546,2260401c64b343949e1a89bc48feb7a0,2018-04-13 01:28:06 UTC+0000,fc688a92a76d45fb911ef735da1f477a,53939a491acb42a4815463845a638186,0,1,1,0,2
6710,2274fed423f647aa9998fed7e9c595ca,2015-05-15 20:17:25 UTC+0000,3a90135453254dd4bbaac05f475ca1b6,4bf1020c28714181b8d47bdf4246f134,0,1,1,0,2
4643,22854159928a48c49017445b7fca3ab1,2016-06-21 19:04:12 UTC+0000,bc047508b7044dbb9d54b8f5ec4a830b,a72134ca2c9249d49e5d7606d9fbcef5,1,2,1,1,4
4201,22a66ab4b86141ffa9a136c0be539091,2018-10-07 19:40:14 UTC+0000,6e6289f22b6241c2860cf135c41feab1,d0908088841d4654b83bd8d800ff8965,0,1,1,0,2
2199,22ad9f3d96454ce389a374c8a3376d28,2014-04-08 16:38:20 UTC+0000,2c6fa76ad0a745f3b6591228f3135163,029433ab59c148f395d4804dc23cc4cc,2,8,1,1,10
530,22b6ab8f398c4ba49aa501887911b3cd,2016-05-25 21:30:43 UTC+0000,6a9cbc2d69f34052a366bd17ec19dd44,cff9a9679be1434f93afd0caadea94bd,1,1,1,1,3
2028,22bf5a403f4040fd95bbcf4ce8d9a973,2017-06-20 06:14:08 UTC+0000,45af61e96be5427e910d91a4ecbc93e3,c3b31d9a9e8547a5ae73916e95f26d29,3,1,1,1,3
7417,22d1d535628841dd84c5c0a81fe7f336,2017-03-02 15:24:15 UTC+0000,c340155c41b24dba9399eb21b8f41dbe,f64df9b489864952917cb631be1ddac7,3,1,1,1,3
298,22d70aecb08c496fb16481f4c726c49d,2016-05-21 17:02:07 UTC+0000,9cada366a2d04b698eed785c0bba31e2,58fa5e95fe9e480a9349bbb1d7faaddb,2,2,1,1,4
4514,22d8bb64b0b342cda98c1cd2da2e8cc5,2018-12-24 22:38:53 UTC+0000,c14d8592f06645baa2e73df0e1283b73,ed31e8091cb346408ff1439aecaf62ab,0,1,1,0,2
3943,22eab405fdbd4cb4aeefbd09036500f2,2018-02-16 05:04:09 UTC+0000,e67bdb725d674c9a808585ef1ef75d6a,1bfcd309eb354ee7b56ae36b60e86ef9,2,1,1,1,3
4141,22f3dbad464d455e81f27af184b6e1b5,2016-05-07 16:27:25 UTC+0000,180f4c7ef9ba4931a91ada976839160d,58fa5e95fe9e480a9349bbb1d7faaddb,0,2,1,0,3
7087,22f72fc2bb7841f3b1adcea4ca57dfb7,2016-05-18 02:52:13 UTC+0000,279be0f2596b4733b37937eb6ca215ad,bb62d86f4d104d1bae1dab379f837a0f,1,1,1,1,3
5060,23019f11cdbb4a0fa7fc71d526a1522b,2015-03-24 00:33:03 UTC+0000,49baa5f9ea904b7381f2eb66c7f34eff,6476f8ea22a5474581fff0a080c57342,2,1,1,1,3
6196,2317c328cc564aadbb709b8203fd2d41,2016-06-25 15:38:53 UTC+0000,ade5544be1674770b35959a68c5e73ea,4dc7d9040592416f98c0bef1ad2c31f5,0,1,1,0,2
6404,233305cd78fa46fc9b0e740cc6801ea7,2017-11-03 11:21:03 UTC+0000,60b9262fd8594246bc3ec48390c202ab,c1511a0db6084d87859239176865e171,0,1,1,0,2
6865,2333a6389ca94b05a8069ce6f540e80d,2016-05-09 19:49:26 UTC+0000,2b20c47688b845ccaaf29d43d4bb3680,372447c96d4448a2af1bcffddce77c65,1,2,1,1,4
7970,2344cb60808a4aae8d6b94e86738c052,2016-07-22 21:42:35 UTC+0000,b7b1d4379ea9439283ad80c0f7616a2a,8147e4d83ebc47b689901dc534981de8,1,1,1,1,3
2723,2354e696bf4647fdb25240247c7e70d5,2018-09-21 13:37:09 UTC+0000,d7a1fd7075ba457da02adf43363143c4,36ff3b3666df400f956f8335cf53e09e,0,1,1,0,2
863,2362635545d74fa5a3e1b7f0cda125cf,2013-09-30 21:27:14 UTC+0000,91fa52079133429fbc1b7ce6e00e350d,05f3a4c6c4644d9a8b76bc7295058f59,4,1,1,1,3
7519,23650f69044f40f48c04eb196718dcee,2014-02-21 21:07:59 UTC+0000,3ad9e939627d4207b1a01bdabb64aeeb,c3ef3cbfd76949d096c627ea5554799a,1,1,1,1,3
4072,236c92ae08bf400a845e63febc370bda,2018-02-16 02:09:20 UTC+0000,1512da930f264572a46f6423f2f03f54,a6d33c38902546849c36ea7e9e9f0870,1,1,1,1,3
7898,23923e32dc5b4f4bae7d739404355b52,2017-01-16 05:10:31 UTC+0000,35f08209aaa44651b31636f7b15c264d,e589ea1d909f4eee9c85b936512dc9b2,0,2,1,0,3
3060,23964ee9247c44c1b9be658402f4b5fc,2016-02-24 18:32:17 UTC+0000,6f1fec8eb31f47de9185e72d20caf082,a1006e6a58a0447592e2435caa230f78,0,1,1,0,2
7629,239774c8ab1c4d49a661c25a9ed7d4a1,2014-03-05 22:00:59 UTC+0000,2129421917ff4bec8e1d4d35bf059a0d,7d425e8d7cfb4fe7b0702fff4d6d84e7,1,1,1,1,3
7546,239cc5f7af434c4e9b8c7529a3ea03f2,2014-03-17 00:32:30 UTC+0000,5bc446e73819442d843565436822a8c7,2a8328f6ceb548699a64293f986f3d19,3,2,1,1,4
7984,239df8541a9d4a688dd8d30e4efafcaa,2015-12-10 05:27:20 UTC+0000,d77a161eb46b43a78d08ab3a5bd6ed7b,5c3b849ea7ac4c8880e83089d0dc785a,1,1,1,1,3
6172,23b52dd81ad7465a9472596c7dedc492,2017-02-25 14:34:55 UTC+0000,768d25e751d5449abb63afc5e33db0e3,a72bde6ac9e349d195a6d356444c9578,0,1,1,0,2
6288,23d71a339f434a24a97108c931565670,2018-08-29 00:51:40 UTC+0000,f19b9c2b24424a49bf07698f314f873d,36ff3b3666df400f956f8335cf53e09e,0,1,1,0,2
3575,23dec7198d1f47b7b30b58e86f2a55ae,2015-06-07 02:59:21 UTC+0000,21bb8c053c3542b68c12c10f121e3325,71f1a6e1b4e4499e86732fec2b445aaa,1,1,1,1,3
7147,23e0f09073e94e248059ef8419dbf2c7,2016-06-23 18:24:29 UTC+0000,1196d9e9249446e5a4589a71b577c5dd,139ba2489ea44eb7af5fdbc63e19dcca,2,3,1,1,5
858,2404ffdc3f474fdc81d8ebc3c779ae35,2017-01-12 21:55:10 UTC+0000,649cbd76bcc2453893a60ecd44e91f54,9496418c2b6a4c059442c81cd73d55e1,1,1,1,1,3
7533,240510f66ff8444f9997f180b7b9690f,2015-05-14 00:28:16 UTC+0000,5f0b774dfb424d7a891beed54fd4c202,f1ca9370286248aba5aae737f92a07dd,1,3,0,1,4
2113,2409ee96089e42a4b44d8ec4d50b2d1e,2017-09-07 14:29:41 UTC+0000,a3df0e3bac68461ca0968606f7503677,321e45d8cbf74a0d96c43e48448b6c2b,1,1,1,1,3
172,241d3dbacc7840d8993feff4cbe9ec49,2018-02-16 21:53:08 UTC+0000,ecd6348ff426432ab775325317baa678,95d2f1e7be1e4bbc98042d283e73bab8,1,1,1,1,3
4175,24269b66d1f243b8a8ca440ddc0c08db,2016-10-07 17:03:16 UTC+0000,2f5b81d7bf694301812ba896e1c53582,4cdadc52cfa646428fb3a8e616670fc3,0,1,1,0,2
3584,2429d3d35bce4c52809cda95f38ef26b,2017-02-25 00:48:39 UTC+0000,7f72bde1e22244ddbfee8c178deaa0e0,a72bde6ac9e349d195a6d356444c9578,0,3,1,0,4
3056,242b8a7526754608843c6ff20e089be8,2018-02-07 20:35:54 UTC+0000,0effb055e34b48f1bd1801de95f96f8d,705a07a9d62946648e9fcf4c86043124,0,1,1,0,2
3550,246d39f2e7a34f2a943c8029ec838e0a,2017-10-06 16:55:54 UTC+0000,8aab09aa579b4685aabd5216dede4355,202e5813e48f42bc8974354fffb0365f,1,1,1,1,3
734,248451e8b07447d68d93c11e37eeecae,2014-04-08 14:17:36 UTC+0000,5b557dde5af646e1ad588877bc0a8817,5f4c8c5868cd442e8e0bc218b9a10e03,3,4,1,1,6
5917,24871146ca6d4a39b71bf03e9c17a5bc,2015-04-14 12:39:08 UTC+0000,b4cdc2df933a4d459445f1d61dc8da77,1fe9990a8894457ba47dfb58277e2cc5,3,1,1,1,3
1819,2493f86a519442ecab042f651c4e0067,2017-12-02 18:27:34 UTC+0000,c3fe8c1e774e4a248d0a5bf1f57e299e,aab426db109b40de866f938eb82f41f7,0,1,1,0,2
7132,249c2e04bcb947f8ac31a0727906fd83,2016-07-22 20:24:07 UTC+0000,797fe27ecea142e09d2a033abf52d2e4,e589ea1d909f4eee9c85b936512dc9b2,2,6,1,1,8
4241,24b0e18fd5944d409f4066404c09f6eb,2018-03-21 23:12:39 UTC+0000,ad419f721c844d08a4a57d8e3738f6fc,49dba8c375214760bb7ab8e616a5f91b,1,1,1,1,3
1532,24b5919216424cee8c66ba5a98759030,2014-04-06 22:49:57 UTC+0000,07f968c4c701484e88fbcadd71311219,f549670482b7405bbb9f3bd6d25ce2cc,0,1,1,0,2
3095,24c2e79d5e8743bc809ba9601e6eee1c,2017-02-17 01:19:14 UTC+0000,0ae9c8acab4d4c9fa5c812a312778306,a1006e6a58a0447592e2435caa230f78,1,1,1,1,3
57,24c90ef5d22442238e038db8e7e6c6ac,2014-03-06 16:05:19 UTC+0000,747707d49a6e441182e4e0ea7e41e7b1,2a8328f6ceb548699a64293f986f3d19,1,1,1,1,3
5043,24edbb1750be4e8f9bb3c86f90492a0b,2014-12-04 16:28:47 UTC+0000,21e411074a5144eebc9ac1374201a4e4,02d74200af144e69b02e687430fa0102,1,1,1,1,3
3404,250f381c663a408b9258b8a1a96bec4f,2015-04-20 11:43:37 UTC+0000,c3fdb5827e64419f8473b9fc7cde5edc,46b35617e6d54525b2fe790fed234ab0,0,1,1,0,2
7684,252187d8e87e40388277fccf2b760577,2016-08-08 17:04:14 UTC+0000,8d1531a35861416ca42f1ba8d39901d9,a1006e6a58a0447592e2435caa230f78,2,1,1,1,3
7299,2529baa799894655ba5d75578a638922,2017-02-28 17:01:27 UTC+0000,b82dbff8b32f46f3ba10b19242bb7347,31b970c9dac24e0d95d451f9dc1e63b4,0,1,1,0,2
2148,252c9502478b4f6d85be6069a24f9655,2015-10-21 05:01:35 UTC+0000,fefa7a8a6dcf4974b5d7ba2b0bbec7ea,d779c3f86811457899c2580c3a043fa7,0,1,1,0,2
3947,253b5a05b1b14ac8829e026ec0b9993a,2014-03-26 21:16:41 UTC+0000,1cffa87874b049edb37fcaf055420a60,3d8847ddc8d04185976a9e78b190ebdb,2,1,1,1,3
4723,253e548067894aa0bd858af31572f3d9,2015-06-04 18:10:19 UTC+0000,d9e89cf8e4c04c94b121ce85f8fd4f0b,e3529e64e70643b6889353db79eeea3e,1,2,1,1,4
4487,2540ad88fd6a4c8a8b427927abec2846,2016-05-12 00:36:27 UTC+0000,7ae3ea3d8c9b48b498bc897a8b5737db,4211cd2388634fa9a5ef05a4725632c9,2,1,1,1,3
765,2541e0ca43d7497080725cc2b4493a25,2018-09-12 01:58:41 UTC+0000,9ceebb654da449bda8320bc39c5201fa,36ff3b3666df400f956f8335cf53e09e,1,2,1,1,4
374,25496adbe5e7400a9e16727bcfe1e910,2014-10-28 17:10:26 UTC+0000,de5685a8c5064d3b8d7c09737abe8548,f3f77cdaafed4729b0fe95decacea3df,1,1,1,1,3
4825,255a609c362a437ebe35ef4d08754c7e,2016-05-07 22:23:37 UTC+0000,1e241d392c434c31be4bb139768d4967,58fa5e95fe9e480a9349bbb1d7faaddb,0,3,1,0,4
7902,255deda2b4bf4c87a9216e55172a58e6,2016-06-03 00:16:19 UTC+0000,2e8f8687c586455aa64ae499a111bc85,752fa17397f44980ba059cc8bf67a13c,0,1,1,0,2
2264,255e2aa10e094b3887564cebfda6b1fe,2016-02-19 22:01:56 UTC+0000,d0b66122b54b43bba6fcc7d5a63a948e,0e0143225063492c8ac7a114b6a2140a,1,1,1,1,3
496,2562698ccb754ab3bc7f8a8a93cdf24a,2017-05-11 19:00:32 UTC+0000,23aa36b48df447f3bb77ba6af29daec1,be8b5083af6b47fa8a9705e8f127ef5e,4,3,0,1,4
6066,257b6e7ce811483890b242034efee58f,2016-05-09 22:36:39 UTC+0000,da316e8a442a4fbd8da150038edf3608,08f4c4808d8e4eb1b9b287cda01beecc,2,3,1,1,5
7793,2580ff60fc3e479999087c8518b1fb7e,2016-08-02 21:51:56 UTC+0000,6c0041fa8154405489fa76875cdfdcec,a1006e6a58a0447592e2435caa230f78,1,1,1,1,3
2286,258c156921494e468ad5c70f4c649127,2015-10-26 17:37:58 UTC+0000,7987ce426d1f4ae086997eb97eb69960,e4e7cc05a0b64cd6b02168d404a45d4f,0,2,1,0,3
3566,2593092424fa4b029d0d5d5f4c5efb86,2016-05-23 15:57:25 UTC+0000,4036439cbb8645c6b42a7b7c056feacd,da256714ec984a42a37a3549947461f5,0,1,1,0,2
1801,25969ec5ae454e0f99437d6b9a197e46,2014-11-05 01:53:21 UTC+0000,af18643f9eab4deeb83e771ecc592aa1,1d8d4ea9cd03402cb4b34aa41ad9f3a0,1,1,1,1,3
5496,25a64242e7cf4105acabd4f2f52033b1,2018-02-28 00:07:57 UTC+0000,fc0697c58c9e420895ce462a5cd9e07c,33490cf035f24ab4b909f50bc4513436,1,1,1,1,3
4856,25a798e7732644119d3b676ea53bbad7,2016-05-19 06:46:53 UTC+0000,26af3d583b6644ff98b8f03ba6143c0e,49f38e98c0424e339c71dbd90eeca351,3,1,1,1,3
2120,25a874289fbd49a09715475b5e1b17bf,2017-06-08 04:21:55 UTC+0000,640def0bcc0f4bcfb38f7e37d83369ed,a78fb4b320674f69be0e43c791b152d0,0,1,1,0,2
4245,25b2395c103a4ba1b261d6c6e02c7ae5,2016-06-23 11:41:12 UTC+0000,08f0cbc88e514994b385c46eb6aace19,58fa5e95fe9e480a9349bbb1d7faaddb,1,7,1,1,9
2715,25c00f25ad2b4eae8f2d30f4bda17dbd,2016-06-06 18:51:55 UTC+0000,8508d69cc67442f29fa8124a9cb3343b,369f1c8646b649f6997eae7809696bd5,1,1,1,1,3
778,25d4435f8240489b88370580467ec028,2018-02-01 02:20:35 UTC+0000,3dfb5fe1ac3f4cf0965575798894100c,8d63cf34213f45189a5a8eabd9d71529,1,1,1,1,3
4432,25ea809386c14ffdbd754d33ded800ce,2017-01-24 14:32:51 UTC+0000,aeb86467324546aa9ab7a8939d45a71d,30b1ef88592643dba57c33e4626684c8,0,2,1,0,3
783,261217d299af41908dad4fe33d1f05b5,2016-06-25 03:07:34 UTC+0000,dac09c692648470a92d13f22a9017263,58fa5e95fe9e480a9349bbb1d7faaddb,1,1,1,1,3
1022,2625dd2b462045b4ae02a2ff18c5bf3d,2018-01-30 10:51:12 UTC+0000,8fd55d3a90664a62b1dc23b533001f2d,a92449e77a1c4f129df86a930b5f4f24,1,1,1,1,3
7754,2633718995cd4fb0b9cc29a69395f5bb,2015-11-06 16:24:42 UTC+0000,dad9be0507b0487aa2d0e376e16cfeac,a1006e6a58a0447592e2435caa230f78,0,1,1,0,2
6023,2634acc68ea14d1b8cbdd343d3d21d0f,2016-11-20 22:42:20 UTC+0000,4467bd25a68c4a25a5ed6db229c42738,d2307e2205da4759a5a1c27ac988808a,0,1,1,0,2
1166,263f8a02daf5447bb88af14a6f7d14ce,2015-11-13 21:22:14 UTC+0000,6534008c2c4441209af45402264013e5,36ff3b3666df400f956f8335cf53e09e,0,1,1,0,2
7887,264a6e4d19ae4d8ebb5406779f59e8ca,2013-03-27 18:30:36 UTC+0000,2c3f24b7d38f42f1a5aeea607878d196,05444a2f42454327b2ac4b463c0adbe0,4,4,1,1,6
6416,26536ced5c404316afcbe389560bb9b2,2016-06-23 19:59:11 UTC+0000,334d410b56db434ea0f987656fca7bcb,9c790846805047818338a69efbe7be0b,12,9,1,1,11
4627,26a117d29ee345cea2e623dbb7ef6a3c,2012-02-15 20:02:58 UTC+0000,c426d099145a46f79b4990f3bf2d5ab2,f05b33a454c048f3bbc73f5f3f7f5127,3,1,1,1,3
5992,26a55d7bec1b46e19ae43b4be54a7aa7,2016-03-15 02:10:14 UTC+0000,c0068f7aebce41b5b4938238c858a757,240a8cb03a934114b4d7b2ac27d307c1,4,1,1,1,3
3271,26a9c8637c974ca4b3bff1ccb55ed8ae,2012-10-07 03:32:27 UTC+0000,e3697170e1b1425f9d149cce1415fffe,f05b33a454c048f3bbc73f5f3f7f5127,2,2,1,1,4
5100,26d774dfb44a469495ecf4d9b3a474da,2016-05-18 13:59:59 UTC+0000,9db514cf3f05417499b97dc4204f4208,f123a7e8ad2345b49378d51b2238c50b,1,1,1,1,3
5289,26dbcf1c838341caa575a76d2e6564e0,2015-04-23 15:27:37 UTC+0000,0c3b2d46f46347db8d8b2e56aa04fb14,d36b6354d01f431ab2edd4ccc50b2499,1,1,1,1,3
6105,26edf8d976934d678295f0a741261712,2015-05-24 16:07:58 UTC+0000,09f01358cdf448b587accfec6ea6be98,01c06b44972c4ed1a12386abb31d5e9a,0,1,1,0,2
1855,26f9b43b1c444825b741ebf89a0478af,2018-04-25 21:12:44 UTC+0000,2a8055f43c784c7b82d947c0a531d5fb,fafeba89ca764bd891862fb8440a2962,0,1,1,0,2
4168,26fb9ab54253489d9e068f2738bc1d56,2014-05-06 17:44:31 UTC+0000,9cfd03a39e03402a90742531d6bfb063,18237fb03c8d4d368085a5dd67c5307e,0,1,1,0,2
6884,27008c01a4754955bb082cb6359af11c,2016-08-23 18:48:29 UTC+0000,375974d115a24181a25f1d5988d2c387,a998ddb7f7a6449f9addc4897cc6ec23,2,1,1,1,3
6462,27066f23a3f9422686d8fa511b142f42,2017-04-01 03:08:12 UTC+0000,8d9485b528b74d3cac2d05068329115e,7f524576ebde42f3a2afafa76f9a0ff9,0,2,1,0,3
5693,271e0616e28f41759ae9b0dd615002cc,2016-11-03 20:37:32 UTC+0000,e6271671a51c4f6b95e6405bbfb02e30,36ff3b3666df400f956f8335cf53e09e,0,2,1,0,3
394,27216aa864d043b2af34ea1184d7fcc6,2014-04-07 18:57:54 UTC+0000,e0916deea195448189e06d62579726f3,fb55b95b86da4e7184c6abff35f432ca,2,1,1,1,3
6417,2724f756f50e428d8ad927525ccdc0f7,2016-05-16 17:28:58 UTC+0000,28f81d9ebee044ef923e180a10f3ec86,6d054692482246e5a3e4ccccfb5cd6be,0,1,1,0,2
1437,27458bc1cb4343fbaaf741a52c3fa006,2018-03-21 19:45:24 UTC+0000,445708bbb47a47479f0a31efbdefb5f7,e250f84df134459faab2187e01c1b39e,1,1,1,1,3
3808,274a183e113e4f1886e7ad65d42a9977,2015-04-14 18:58:53 UTC+0000,ec737e8e4aa3459a83568bdb9c5d7f4f,0355aaad83704ad98e6d71b79db85849,3,2,1,1,4
6701,274bac77d2ef42df8b548d4f344da67b,2015-10-29 20:34:30 UTC+0000,7fbdd73e27b74da2ab056ac97db8ac1e,a1006e6a58a0447592e2435caa230f78,1,2,1,1,4
4111,274f9e9574234c4592be7624440cc10f,2017-10-17 22:02:27 UTC+0000,c7f6f40ccef54a37a7dc35176e9e233b,c1bdc3d063b14ad89b4fed049bd92e06,0,1,1,0,2
7381,275bbb85e5d84ec096caed4c60320add,2016-05-23 13:35:32 UTC+0000,8ce2445b11e340a781934c66db0c6de7,13b55ed4834e4814bb33a4c87001063d,4,3,1,1,5
3741,27686ca1463347b9994f9c1aaef7639f,2015-02-25 23:39:27 UTC+0000,036b8fd41caa4179a26072f1669b94e3,b9b4dd3e497548d0b5c2aba2b069430e,1,2,1,1,4
565,276c2f0a3be04d11a57d4d37dda7d6d8,2014-03-20 02:30:20 UTC+0000,ccc557f9fdd44535b47b7ab45ed6e879,e784bbc3890c4cb1940fac97d6c9f666,1,1,1,1,3
6401,278a4deda4414b6baf59a31a4caec434,2018-02-28 01:37:57 UTC+0000,0ae97fc9f1b048d690ab6b7a02691b03,c0ea695aaff54edca0ad38b3477cb065,1,1,1,1,3
5193,279c0e0967e34bf2a8c4454f52b4923e,2017-09-12 01:51:10 UTC+0000,ccdefcc7ad6440bfa2571922e0f20011,93acc65fba694fb5a4a9e590dcd81c68,0,2,1,0,3
7908,27a405c33f194535a33e01fe689384a2,2017-01-26 23:57:11 UTC+0000,883c9ab52df24134934c5c4d25d831ef,b04a3a517bb74353a48c07cd363ef3db,1,1,1,1,3
4378,27a545391ed44a088dff9c942b5906b8,2016-06-07 14:40:25 UTC+0000,3033dc2f1dcd4a0d83f4ec659442c1cd,89ffc7c3266344b68c2dbce832d102f6,8,7,1,1,9
4718,27a8246b35ef4c9dad5b969d59acb2fa,2016-05-19 14:04:02 UTC+0000,9ae39dd96fa048ed87a812f97f8813d6,3e03883293e94a8782beb98e18f37d2d,0,1,1,0,2
6503,27afabe316354a11afa28f77ad0c5c83,2017-09-26 01:12:24 UTC+0000,e645f4067bc0402f8bde25df6d1fe424,416321b48a634ac8a53602625f0a5d40,0,1,1,0,2
6389,27c3e5cc321c484ea68e88b30708ff5e,2016-05-08 18:24:10 UTC+0000,ba41aeec02214884b990452b03534b0a,58fa5e95fe9e480a9349bbb1d7faaddb,4,9,1,1,11
3854,27c6b0682e954f94890415be49ad988c,2018-05-01 23:52:53 UTC+0000,1097af29865c43efbf44e0a41fb427ec,125838d9f4fb4045b73842bb5856064e,0,3,1,0,4
7502,27c9bcf4cdb045ef865497f2800033a3,2016-03-04 02:12:11 UTC+0000,ef5ac482ff224e378505a4320961f5bc,542df64cb09748f8bbb480f63ada12ca,0,2,1,0,3
3346,27d6d38e12b340caad020a7b53399b23,2017-05-18 05:41:35 UTC+0000,50c33c2874714901bdecb97b97bb1bfa,5efb343863764f78ba447f538c8b6045,3,1,1,1,3
161,27ed18522a6341c88db755d90d1f4784,2016-05-10 20:51:58 UTC+0000,f03bfbe4834948c295dc88734a3d5a49,58a4bfd0d3444c7e8053294f3be96dbe,1,1,1,1,3
2421,27ef6db256fd41ffab6ad90d1c27ebac,2018-02-16 15:22:25 UTC+0000,c4554218e11f45f08c4d22e980cbc2e4,9e0cb2a2914c4d05be76c85e7ca356a7,4,1,1,1,3
7523,27f348a575f6444e9a3d8beb81a19cd4,2017-05-10 19:50:02 UTC+0000,dd962b08307a40c699a5bb9c7f27fd17,eec32fd8a08f434493da066591a52c78,1,1,1,1,3
4261,27f80fb3e374477cbe25d3ffd89edcd0,2015-03-23 20:52:23 UTC+0000,e19ac5aa7c3c479f9b2b6e6999962afe,23b6df4d73fb4d9bab3eafb6dd8bfb86,6,5,1,1,7
2738,27f84d7f29a34c829dba83cfe1a8cf83,2017-05-10 17:34:27 UTC+0000,50b485e854e846b88fd68aa92410f14b,4b347a587cc447c69b03451b8c4a121e,0,1,1,0,2
1270,280ef77e033842238847372f0db81bd7,2014-11-19 23:14:27 UTC+0000,91a3e68db7a94e9f8e855c356df53c3d,4139520ca7204e5882ef3dcd9822477d,1,1,1,1,3
816,28103280f7b64e1aa7844380a24b1861,2016-05-24 13:42:50 UTC+0000,59b7220f40b34541ba9677818629cf46,1f8d7bfab2b84da092c9d2b22f1f7c4b,1,1,1,1,3
5176,2825e9dcbb8a41bd926dc794844e6b5f,2016-05-21 20:45:48 UTC+0000,a99e4867247343849ace3ebf83bab9ed,8d0985f515fb4c3482fce4cc9cc9783d,2,2,1,1,4
2372,28386c3d30ef450083b17d4c43940e3e,2018-09-02 15:06:26 UTC+0000,d8313e30f73f4eacb68c98edb7fa548c,36ff3b3666df400f956f8335cf53e09e,1,1,1,1,3
7175,2844bb3920d547acb7eeaa25b5faee9e,2018-02-28 03:42:10 UTC+0000,389d0dbc12334375a19097e4372858bf,e945827b30bc40e09a33b946f00e8296,2,1,1,1,3
6959,2847b68e4a2c4da68b050c3a9336981b,2017-05-02 00:39:58 UTC+0000,bf26f7c9249b4a958db98859aebbb810,82ff5bea8ab5459b8f36663d9e7e6828,0,1,1,0,2
697,28483e8227684807ab671cb54cdcec2a,2015-11-02 02:49:45 UTC+0000,c486e5952df14e41a3f6a1f13d9c7255,27366b3f0c56473498fc4780d880c6df,0,1,1,0,2
116,284c39abe07f40bca5b496d9534a30d3,2014-03-28 22:31:17 UTC+0000,62f48844b37b452f85d0a7c02b02aa3e,04b72521eb474b8bb79f7bd95e8b637a,2,2,1,1,4
899,285421afa2e440779943650091cb3e88,2012-12-02 23:46:54 UTC+0000,a8d22a58fe2b49b1b1fb3cf69c964216,05444a2f42454327b2ac4b463c0adbe0,1,1,1,1,3
4197,285e79c89a5b4b07b448ac50f737ab25,2016-08-29 23:29:39 UTC+0000,a1a40eba290f4c8e8acff54315bcc88e,36ff3b3666df400f956f8335cf53e09e,1,2,1,1,4
5873,28625136c8f1474197d72ce2eb9d1d8e,2017-09-13 15:41:49 UTC+0000,257224ef1d9249ae8e4b81a7e4a147fc,13b55ed4834e4814bb33a4c87001063d,2,1,1,1,3
2696,2863f3971c564487a34eb8d618fd7ebd,2014-03-05 21:53:29 UTC+0000,9a45b24922d3460d9eaa754dff35b39a,dfffd276cafe415e9ab18a0ad5564a9c,1,1,1,1,3
6055,286bd38975e54584bb9ec31319689419,2016-03-26 23:12:50 UTC+0000,c06f35da141947fe93bc8654553d1be4,58fa5e95fe9e480a9349bbb1d7faaddb,0,2,1,0,3
5401,286f96d3a2364cd58faf47ce7fb166ef,2016-10-19 00:17:41 UTC+0000,d514db42c85c4f43bc73f57cfd84e018,7eb73efbfb974d92b24408d514f7c213,1,1,1,1,3
267,2884fe8571dd476cad422028b8de7bfa,2017-10-19 17:27:15 UTC+0000,84e4ab56b1c54ff1bdb418dd4226572f,c6aea47cfd914ca78583c5cc21889ee8,1,1,1,1,3
3312,2886046683744d1c9ec719dccccfd0b5,2016-10-30 20:54:58 UTC+0000,8809aac542224eb29b33be0acef1b869,a1006e6a58a0447592e2435caa230f78,0,1,1,0,2
7921,2886227d4e0046c0b79b00e1548a16e4,2016-08-20 01:25:40 UTC+0000,cd2d82c354434f4f9b794d34f3f26c8f,dc28056163a8447686e5691f4c1475b0,0,1,1,0,2
2540,2886dedbd3af442bb64496af42fd3b01,2017-02-16 14:09:59 UTC+0000,6d08bbda8dfb4f8288041fbf9bc8e5ce,cc49ef2285724342a4a6a9595e66243d,1,1,1,1,3
4395,28878d3a4dca49db8c2d76acd8cf9675,2014-11-06 23:23:16 UTC+0000,1bb3e515ca9042dd8358d9b14ad7e9b7,ccf7cb552f7e4ebf88d27369d8e0fc3c,2,1,1,1,3
2644,289d2551e81042478f76f39e8b7912e8,2016-05-03 13:59:53 UTC+0000,39375937c6b24a45a789328bcd0ea404,6fe279bb21fc48988528078214b0a8c7,0,1,1,0,2
521,289e85a127d545bf9b3d64d220d7c727,2017-01-04 21:20:53 UTC+0000,9b787d55b7d74c0dbf28a885682c3bc3,36ff3b3666df400f956f8335cf53e09e,1,2,1,1,4
5537,28aa01b0e565451b99561ddea057c814,2016-12-07 20:24:53 UTC+0000,3c33720ba0d34e34ae350abb2f25aa12,36ff3b3666df400f956f8335cf53e09e,2,2,1,1,4
545,28ab6c3ba1a742adb4650f771d36d0ac,2017-05-10 20:21:05 UTC+0000,3bc6845b4fec4ba7bc5a292d35a9f335,cdceddf41de84bbe9677c2530662e921,1,1,1,1,3
4460,28b3e6f188d04b63bf06587780587e2f,2017-05-16 03:23:54 UTC+0000,c79f95af527c4eeb92a4bcd2daf9f865,986c93d173824e368c73348c5568df48,0,2,1,0,3
6476,28b96bf027d84eba9f39a1c6969fc773,2016-05-05 15:51:28 UTC+0000,149679c75b644651be89f35d89cae369,042c48ae0afb461ab2a26e2800038122,4,1,1,1,3
651,28c0afb92a0a46c29d564848cec6c23a,2015-06-06 04:16:56 UTC+0000,89cb80e5dedd4277b6442e0d3c948c2e,c8ffe6358764451982263916bd7fac79,0,3,1,0,4
173,28f7c04b168f4c1e804b17c8bdaa495d,2016-05-24 17:14:11 UTC+0000,4f9a8ecce87e466dae8e7630db82f36f,d4e1e83e9c6344849aa45584b0ba0d25,1,1,1,1,3
3650,28fbbb5cd4db4b05beadd77a95ddc78b,2016-06-26 18:27:56 UTC+0000,ebe3f841ffb343d594318cfe418df643,58fa5e95fe9e480a9349bbb1d7faaddb,0,2,1,0,3
4829,29021db46f9849a2a0c72e596543e33d,2017-09-29 15:17:44 UTC+0000,d1c4a0cb227f48179b664954752d1386,b1cf39f37ba44f4486a2f36498f7803f,0,1,1,0,2
4798,291031c5e722492ebcd6927c72f30f3c,2016-05-03 02:55:44 UTC+0000,0e161d3cd7544d7a8d2fd7e22b4ec36a,9733c59ca28e4aa8b9eb6fe39eeaa7f7,1,1,1,1,3
2170,291126644c1d40f69b021f3a54757f52,2018-05-26 16:28:02 UTC+0000,4974bdc371904fabbff065f38ba7fa88,be5d23056fcb4f1287c823beec5291e1,0,1,1,0,2
1996,291313af21ba4dd9893e59814bb603a2,2016-02-15 22:27:11 UTC+0000,6a3fa6773db74cf098b88290c4cc3fef,c6c20011ea42416481279087a847750b,1,4,0,1,5
7953,2929bf329b074f68a2db43f9f47fb00c,2017-02-23 15:05:31 UTC+0000,8c9669b59eed454b85fd80d2a391b235,a624d3aeb35c4ec3b335c66b450e5433,1,3,0,1,4
1749,292b34a2121142709689e908c9eabb71,2017-12-01 04:54:19 UTC+0000,fe91cdef45c742daa3fba65c0d2c01c6,c47b6884406e47858e87ed90153ff6b1,1,1,1,1,3
7179,2931aa095d9e43c5887a49358d6240f2,2016-03-27 18:47:09 UTC+0000,b267cf058fc84914989e2eee5f7ff7f2,a1006e6a58a0447592e2435caa230f78,1,1,1,1,3
839,294404d77a0941e78d75ac66e7409b81,2015-05-01 21:58:03 UTC+0000,03d5299f40d54bdaa40f31b6c5736338,4e41a0f8aeeb4fd8bbf19379ffaa16cb,3,3,1,1,5
4200,2944372ba1fe4f898f101c08564d607e,2017-01-31 02:12:49 UTC+0000,d41aaf1bda4a428089b1955f38dbc48a,502b34058b0945629688f665a11ff821,0,2,1,0,3
991,295f48b7c63546b1a55241a1ea5f3afb,2016-05-16 17:22:59 UTC+0000,491f14531a604286a941da85d9115cb7,9637a0f19f8f4d8e900443f4ca040ca4,1,1,1,1,3
5636,29658385f6c441eca375b7d35bc90a4e,2016-07-14 21:24:13 UTC+0000,289d61e956f04424ba15c78a8f57afc8,7fe2d60a2a5a4914b228af891170f653,0,1,1,0,2
6117,2969cd4512ff4c97810912c4165ea02d,2017-06-19 19:15:27 UTC+0000,934c04c9ca064baaa9034951179bbb3e,d6f7723a73be40049560340f26cf5c3c,0,1,1,0,2
799,296f7d552ff3403ea6b6111aa89f79ca,2015-09-03 15:23:03 UTC+0000,a6707f49c31b42a380f74bc9c5f02ef3,369f1c8646b649f6997eae7809696bd5,0,1,1,0,2
6346,297ca6b46c5a4cb8bf275795726d69dd,2017-06-25 15:35:51 UTC+0000,94530e1132ef4a9ea0af1a1fa16d8e87,ec4f7854316f4422b4d54ed60c5bcd92,1,1,1,1,3
1336,2982f754f1574b0386d865d81011853a,2016-03-01 18:16:55 UTC+0000,961b36c5772e412cbfd85ac2605031a8,19fbcefe202643a69cc741fec72629de,1,3,1,1,5
227,2984024edb7f4661bc23b11897dd1a0e,2016-05-24 23:47:09 UTC+0000,18fd2075c50b4edebc6bad4becd30d32,030fcbbba31647938b176a90c04e38df,1,1,1,1,3
3671,29880cef8b9741e18da07ad1fff4ef73,2016-04-09 14:04:37 UTC+0000,2c3c81d6930f4439b21087a272c7a62a,eaf304f916f14dbba04d7e6d54f436ed,1,1,1,1,3
857,29b75640bbe147719d29f3fdc261b230,2016-08-15 19:32:03 UTC+0000,7f74e9640947453ea27aee47dc4543af,b6a728e2e4b9481f98611e6077f67ecd,2,1,1,1,3
7713,29c3ad3bb3504723bc83d49e1cd84ea3,2016-05-05 16:09:17 UTC+0000,1af92ba4868e4fab87d8ae9c38ba7c15,7bffa1792d474359b922e5de700d7a82,0,1,1,0,2
6907,29e044ac24f94430978b7f9c9b490090,2017-02-27 17:27:58 UTC+0000,d4c3c1a9b9ab4d4fa01043514167b04e,729ab1c23fce471ca1bc3741bbbbdeb2,1,1,1,1,3
3841,29feae9311a64094a5299474cee42481,2015-05-22 14:30:14 UTC+0000,4e66639ec571440c972a7d4c81ef848b,83cfc4f44b9d4fef8cb95530319d8b53,1,1,1,1,3
2424,2a03b51426e74326b5864fe20a174c38,2017-11-01 20:41:00 UTC+0000,29752d7c53694a65a3e7c7e674357d61,4eb0c8a55a774472b14e19d46ae3045c,0,1,1,0,2
6300,2a11e38d37d24b0b8dc0c208ab660116,2017-10-27 19:27:09 UTC+0000,0d6fb6d45e21405d908c59d0eac2c976,8dcbb0f6ffee48748c3768a77d68b6e5,1,1,1,1,3
7107,2a1445e254664f359700b263122618ad,2016-05-06 01:15:14 UTC+0000,814c8566baca41fab3ae2c6c1c2d8766,7b86ca42543646b2bc1641f8aad4399f,1,2,1,1,4
6258,2a23f4251c894abaa1af1582aa26c9b3,2016-05-11 18:41:58 UTC+0000,bc04ac0072ec4b23b5c1ce4ddc265930,5f907f3b8bc24515be5e3416f390c4d5,0,1,1,0,2
3201,2a27603abbd04ef89bc6553b3750e276,2018-05-25 17:36:27 UTC+0000,f1818923ef3c430baa190cb55016ee91,4dc61581ec7b409bbd037e483f53ba0a,1,1,1,1,3
1546,2a40def73b5a4b25bbd6e5cb72d85129,2017-01-24 17:30:35 UTC+0000,1c52c7a9273f49c3a704bd710d0131d4,36ff3b3666df400f956f8335cf53e09e,0,2,1,0,3
3191,2a496b66b0ab40aaa14e4c1467948718,2018-01-08 15:11:13 UTC+0000,347d801ea54c4ca1826a3dff59f88267,dc932931b101425d8b8018c0f838750d,0,1,1,0,2
7641,2a54057cbf5e495788dad96ddbfe2e7d,2018-01-25 00:51:19 UTC+0000,7ea4c71d064b4badb4d7ace8d966f15f,f6b1efc0ed1a4889891b1287913db5b6,0,1,1,0,2
3554,2a587e60b176491aa5e00fcda8ec14d0,2018-02-06 02:31:20 UTC+0000,4efa3d946e934c49b16e3b69a249762f,9421dd803d164e5da26436a01a92ce13,3,1,1,1,3
353,2a6126e0e72d4834829187fd8190df0b,2018-03-13 16:51:16 UTC+0000,ba8a96f822f741d5aefccfc63d33079d,887c5a142b42466fb74740d72989fc74,1,1,1,1,3
6454,2a62a37f0e754c37813d9baa2dd1f851,2016-05-12 15:29:05 UTC+0000,e3146b4389fe4b5fb1b9f43210fda518,e2941a700e1a47cba5b984fe17894aa6,0,1,1,0,2
1820,2a6cdcdb64eb466fae67e5a687e26538,2016-06-20 21:24:16 UTC+0000,a172a28f5dad4f44a867150e48238679,dbfc21fbff414832beed41c7a5966096,2,1,1,1,3
1061,2a789a97125942edab555cc6ab793501,2018-11-14 17:36:41 UTC+0000,d99d506ccc16458a930e21cf25e2dfb9,ac52536a28db43a2b04ebfff7d7270a0,0,1,1,0,2
7871,2a794c62f5ff4c16bfc96dc54158c48d,2016-10-09 14:11:44 UTC+0000,76c95d0c3e784da5b5fbd5e3abd95a39,4862d9b69b2c4f7f99da8fd235cfa3fc,1,2,1,1,4
2130,2a90e3162b854760ab9d57abfe01afc1,2019-01-10 00:59:18 UTC+0000,75c6c116f1e6429291d70d79aed794f5,2be67b772d294aeabee603c5eaa98669,1,1,1,1,3
2152,2aa0e94c07704b5f827c96021bf19283,2018-04-11 15:07:50 UTC+0000,07dbb6e57803476bb4e1a7e0aae89f43,209fcd55fefa4fe29ccedcdc26bd5d89,0,1,1,0,2
1806,2ab48138bf0e4541b49f94dedb024fae,2016-08-16 17:31:31 UTC+0000,efecda5d43d84323bab27777bcda8c7c,369f1c8646b649f6997eae7809696bd5,0,1,1,0,2
7916,2ac8f200f94d45ee9a18e3e679fbd912,2017-01-23 16:09:11 UTC+0000,7569b2d6fdae4a9dbd2fdc95346f4fad,3483a87fa53141339e10720095a20318,0,1,1,0,2
5691,2ad488c46f8d417a94d52bf3b158d99d,2014-04-23 13:44:21 UTC+0000,e090aab033d942eebb9284e242ade070,b688e766eed04a37b7abc9218aca1ce4,3,1,1,1,3
6148,2ada7da58ce34671869e551f7c6f018e,2012-09-08 15:23:59 UTC+0000,bff528ff5a4843d1ad0f62c6312ec28e,38bc1866f29744f9a003e2e826e3fcb1,1,2,1,1,4
1372,2ae264a1ebdd4fde86be3015930f9a3d,2017-02-08 14:03:30 UTC+0000,47256038f81d467392f5858620bfec71,b77ea4c4663d49dc85d5bed87076540f,0,1,1,0,2
2373,2af8ce4d5c9746729f19e146e5393ebe,2016-10-19 14:08:04 UTC+0000,9b61301571f44c0eb2034f73e74224d6,015c0c06f56f4c95b09546c44084f315,1,1,1,1,3
480,2afae3f3360f4232a0538e471520317a,2012-09-08 17:22:22 UTC+0000,eb6961ba876240c1b92f732fdbae913d,2a8328f6ceb548699a64293f986f3d19,4,2,1,1,4
5285,2afdffcd065b486b8998f5bb8d39945a,2014-03-05 03:15:36 UTC+0000,e86975fb3ae24ce9868befc97ad0c6bc,c1bda2764ee642b3859b1ca6839fa16c,2,1,1,1,3
7394,2b0ed12953724aca92ebfb3c9158de81,2016-06-26 17:12:18 UTC+0000,4e4acc22ad9a463a93308b619833fffe,58fa5e95fe9e480a9349bbb1d7faaddb,1,2,1,1,4
3796,2b149dc908174c329f3151b99cbcbfe6,2015-10-02 13:46:52 UTC+0000,fb0126be50d94503adb9dfda89e08803,369f1c8646b649f6997eae7809696bd5,0,1,1,0,2
7400,2b19f56a487b42d581a2c9467b12fb65,2014-04-04 21:21:22 UTC+0000,e0fc081bbe8c4095bf13ed738ea779a5,6774ee9e8f9247728dbbe896726e911a,5,4,1,1,6
1658,2b1e6b9642df4c57880db23beee42557,2015-02-26 14:29:58 UTC+0000,0bad423fb3764b58be05be66b3d425ce,369f1c8646b649f6997eae7809696bd5,0,3,1,0,4
4364,2b2707c375674ca5b9ed4faaf7b6a43e,2018-03-02 05:59:13 UTC+0000,59218eab00d643fe93b9507ec7a695ee,3ab86281ac254f53b12fbe039856c5dd,1,1,1,1,3
7305,2b544d73f1504a87a4989a9beacd06cf,2017-05-17 19:45:47 UTC+0000,69f728f2e384478abae3a300fbe3f644,a8075e66d81847ea837a3ef3651eafbc,1,1,1,1,3
2012,2b8899d61fd148b3a1b7b4fff9fd6a7b,2015-04-30 16:24:38 UTC+0000,c3c17d7147294ee7b75ef7aba8e77320,e644b51be2364df3aad4521bffef791f,3,2,1,1,4
2788,2b9121a82499426b83bf060b26a2f5d8,2017-03-23 13:44:53 UTC+0000,674759e706ed43878827a479e2a9cc4a,54539d99e4304cf0a18357bab287dcf1,1,1,1,1,3
2668,2bb1212b9df545fc8dcfe039c7cd806a,2014-04-30 22:34:00 UTC+0000,a5252948519240968846e2c9fe6addbf,3b7e352267da403695a5c0f50f28da8b,3,2,1,1,4
2423,2bbe8b74aa30453dbd8bc9bf5ccbc0bd,2015-03-19 19:04:40 UTC+0000,78a12c784c33428db98328ed84b0a1e1,500ff11c73c445acacce38b5ae6dd223,0,1,1,0,2
1119,2bc34f13bcd84f6bb7ab433ba2cac24e,2017-09-05 04:08:13 UTC+0000,695aa01796544d769d0deb5304a29519,93acc65fba694fb5a4a9e590dcd81c68,0,1,1,0,2
6507,2bcd0e4604394d6681074debd74c3d7b,2017-01-23 22:24:21 UTC+0000,53a15ac636444502b2c183122baab618,c423b56f85034f50a12b0a8600ac6e19,1,1,1,1,3
222,2bcea3782b1247628b05e38544edaca6,2014-03-05 14:50:11 UTC+0000,4d985a0d105b480ea91e766e6776b7e8,c1bda2764ee642b3859b1ca6839fa16c,5,4,1,1,6
2466,2bf59c2dbd0440418528b5a16a447887,2017-03-04 14:19:54 UTC+0000,968fd7dae41d43fd97987071b8df989e,be5d23056fcb4f1287c823beec5291e1,1,3,1,1,5
6794,2bf682cc44c8470a9545cdfbe3ae7dbf,2016-05-09 13:39:03 UTC+0000,2d0f04465de742b78403044a87fcb9a1,f3625d8f4cf242eba824f905a15568a4,1,2,1,1,4
3639,2c0782ff92e0451f901e4dba8ea5881b,2018-02-12 16:08:43 UTC+0000,6e83ac28a62d4c37a11b40ebfe146e5a,4e9fe7ffb54c42eba0987c6119da9975,0,1,1,0,2
5423,2c0970d06c9f48cc98be04e77d49cb0a,2016-05-05 04:54:08 UTC+0000,1a8336173f6645479465b5fb099fbc01,2749add250814499b1d2a3e7ddcfe33e,1,1,1,1,3
5804,2c1cdc1cbba44174a10ed2aa9f8b028d,2018-02-20 00:00:03 UTC+0000,fbed302177c64aeb9f790ac2c0b940d8,887c5a142b42466fb74740d72989fc74,1,1,1,1,3
6722,2c1ff021556745df8011f3ef79d47d92,2015-05-28 23:01:01 UTC+0000,9937365ff05e4dbc9eed8224a1240ae6,05444a2f42454327b2ac4b463c0adbe0,1,1,1,1,3
2138,2c36fe0cba754a878ea8839ded215bf6,2016-04-11 02:47:23 UTC+0000,a7b0369653ae4f58ae47aab31dee138e,a1006e6a58a0447592e2435caa230f78,0,1,1,0,2
4184,2c4ee03686724fc29a4f9e48877355d2,2017-10-25 18:36:21 UTC+0000,8d51e80da59b4bddb2f7d956632b9fee,cbc63924688e4181a7defa92f8cae0f8,0,1,1,0,2
5780,2c504a31b0fc4b168002540c83d1d45d,2016-05-18 01:09:53 UTC+0000,af718bf36bd94330a0db8e175f9881ea,a012826fa7334445a232ce054c76d0e5,1,1,1,1,3
5863,2c572ade193941f1a49ce0b37b6b8f54,2016-05-21 17:23:57 UTC+0000,4adcde12d56d49b08698c863429ade7e,58fa5e95fe9e480a9349bbb1d7faaddb,1,2,1,1,4
3252,2c5bd5eb628245acb868c81fefcfe5e0,2012-02-13 00:49:26 UTC+0000,281c2557f0154dde984707e40100b8b4,0c673e046d824ec0ad0ebe012a0673e4,19,3,1,1,5
6316,2c62ad08cb5b453c959d3289e95a5bee,2015-03-09 19:21:20 UTC+0000,5d1f416060de4d6db0081b320e2ebe31,369f1c8646b649f6997eae7809696bd5,1,1,1,1,3
7368,2c7ae5baa905445c9d4a60f34712b715,2016-04-28 17:20:15 UTC+0000,6da85ea288fc4e7c8e648c646102f081,677f47d4daf5467f9ce9b5a0611d3ffc,3,1,1,1,3
3647,2c81ed8943034eee936e2250b04d5025,2018-03-22 22:05:12 UTC+0000,ff2715e22f354ca2b8310aecf7b5b8f0,ef5c591a66434a9da58429d9e43de8c6,2,1,1,1,3
5759,2c97abb797054c05ad79f9807ebda4ba,2016-05-25 09:39:03 UTC+0000,43f5eca66c714ec4a240ecdb79986649,683097dc03c4440aa163593a628e0f3a,1,1,1,1,3
3946,2c98dfb59f0d408d9e2ed9ccdb007bed,2016-06-24 06:54:40 UTC+0000,99628be8f3634d40be0b7d05730e8fe8,614ba4c0aa534b759b73e8473fd5ec88,2,1,1,1,3
2707,2cbecb39d3174018b4695f4517b6e319,2017-05-04 13:08:31 UTC+0000,b1df546deeec4aa18554f4abb1e5c315,90b56bd527b247c19b0ee820b0c6c00b,0,1,1,0,2
3228,2cbfc3674e734b01b81a7651e2de8ece,2016-06-25 04:31:20 UTC+0000,d5528fa511b246cc968a124856a2b76f,58fa5e95fe9e480a9349bbb1d7faaddb,1,2,1,1,4
699,2cc89b5c7b8844a7a0bf8f5e315d1d1d,2018-03-02 23:05:36 UTC+0000,7010e5e6d6104212856869ef922d6767,84a12542c2624c269b10113ba6622536,1,1,1,1,3
4254,2cd843eecbf1404a9242b223efc0aaf1,2015-11-21 21:02:10 UTC+0000,e1f97219360e4e9da05d9803378dddc1,a1006e6a58a0447592e2435caa230f78,1,1,1,1,3
2410,2cdae79d11624ef5af8acceac70f0132,2016-12-02 16:05:51 UTC+0000,b852f73533b44577a4afd8dde7ad9966,f64df9b489864952917cb631be1ddac7,1,1,1,1,3
2140,2ce176c9b7db4415a7c13c8f697eea38,2015-05-11 12:20:44 UTC+0000,35111babf76a498c8a71acfe2d890704,7aab6fb9a4ae4d0197fd2bc05960ba56,1,3,1,1,5
3865,2cee625fe14246288b02ae1ccc8b33c3,2016-05-11 18:57:13 UTC+0000,fd6d0229805b4ab7bb45cda4f768cccb,655cb4965f34469897b44a86f516f3cf,1,1,1,1,3
4402,2d01248bd5db47ae8a5989d03779d21b,2015-10-23 17:22:51 UTC+0000,cf67a7298ebf4cf0b8c62d7a4479384f,a1006e6a58a0447592e2435caa230f78,0,2,1,0,3
2398,2d2ebc337ee343b5af3f1b7f2e7fda71,2016-05-10 17:29:46 UTC+0000,7af8eefb39d64120bfb087dc937b34e3,8f44237ddad84f2184cfe4182fbf1105,1,1,1,1,3
3878,2d34a516c4284404988353539557454d,2016-02-13 21:24:57 UTC+0000,ee08f00be0b84286848bca0bf744dfa9,96bbbdd06a334805a0501034d9df1aa4,1,1,1,1,3
5096,2d40fa6dd539466185ec797757e3fe61,2014-11-19 22:48:37 UTC+0000,a2bb80a13bb34bada70232ff6587335b,b937649594b7485c8e667de2011e3b76,4,1,1,1,3
8015,2d4a8ffc13834f13a2fac748385ae06d,2016-07-22 23:53:38 UTC+0000,10040b1fb3c14d5ca86733f93f102724,bb2cd1cea205452c94a3f64187bd0173,0,1,1,0,2
6811,2d693c39deda4c588d39b355ad672b56,2017-08-25 16:05:10 UTC+0000,6788b9d91dcb403eb2d86b4b015fcb00,69f58de8657d4cd4abd8f13724eec865,0,2,1,0,3
6602,2d7213d784a742ab83af1e18a60886a2,2016-12-31 00:08:18 UTC+0000,255a73ed80ef4804b8cbe5ec77226c1a,416321b48a634ac8a53602625f0a5d40,1,1,1,1,3
1328,2d7f650c62204fc4a7ce463d585bc0c3,2018-02-15 17:22:58 UTC+0000,331964d8f4ee45069bca18795f4c386a,0cf7a9f076ad44309f90ed1f4f517616,1,1,1,1,3
1461,2d946865b09a4ee1b1a25b9c962de1cd,2017-01-06 16:20:08 UTC+0000,f5e84f10554d4ab0b548c3384218e64e,a1006e6a58a0447592e2435caa230f78,1,1,1,1,3
7928,2db032c49daf41ac9276f74114179830,2015-06-24 01:45:32 UTC+0000,017a24165f904f86a890a08e45547373,c1bda2764ee642b3859b1ca6839fa16c,2,1,1,1,3
2945,2dbd6247e13840a7b86792825d02bb87,2017-05-14 00:23:20 UTC+0000,8b0eb470d04847b28beebbb0ecf963f7,8c5ea269b4dc4b60832832a3755ecfff,0,1,1,0,2
6313,2dc13868cd8a4ba781805fefcb4d49bc,2014-05-03 13:53:44 UTC+0000,9f45fab9e7824eab80accd86f44af88c,3d8847ddc8d04185976a9e78b190ebdb,2,1,1,1,3
3987,2dcd56aa95de46cba3d5f391a0d7ec5d,2012-09-09 03:29:48 UTC+0000,72855a119f074bccb6562c9971afffb9,4cf8fd05248647a088f3e2c4118f052f,3,1,1,1,3
2041,2dd2e3b95c7d4aa5a03e206ce4039c3b,2016-05-12 00:50:12 UTC+0000,ab9093a4225347619a4c3b1c67e95f47,4211cd2388634fa9a5ef05a4725632c9,0,1,1,0,2
5080,2dd7797a8fe849bca005ba740f9c0bb1,2016-05-19 18:14:32 UTC+0000,a9a2b17d9aa74bf3bfb5208e59adb2ac,92ac3085661849568e57d745a95e2010,0,1,1,0,2
5241,2ddbd63e66614203b3fb5fbb6700647f,2013-04-04 05:54:07 UTC+0000,a4936263b19243268d71fd99f98a7fcc,3a1f6a19b70847d7b4f278f2a2496509,0,1,1,0,2
640,2de65704cdf34f9093e8911e59f212fa,2014-04-29 18:59:11 UTC+0000,7c342f3eda684de0a33102ee8b297e74,0355aaad83704ad98e6d71b79db85849,5,9,1,1,11
5073,2dea7d42476c467a8aa2558ceadcc0d4,2016-06-22 06:42:02 UTC+0000,bb27a264a9ea4e52bb709aac8d00995e,138779f07a504971bfc1072949b002e9,2,1,1,1,3
3866,2dffc4d95c14497e9018790a41edc62d,2016-04-17 13:35:18 UTC+0000,e682b17b029e4a2c844fd5263be18d2d,58fa5e95fe9e480a9349bbb1d7faaddb,0,1,1,0,2
6302,2e0a9119af12480bbffbd37465a2dbda,2016-06-02 19:02:36 UTC+0000,269424965b52477daf1bb34e09ca796f,12e8dea2f3534f6dbc31701cf64f9a4f,0,1,1,0,2
6162,2e0ed2db803e4aa6b8c13d86018d5577,2016-06-11 19:37:30 UTC+0000,ef7a17cb517a43c2913e7b21b65d546b,58fa5e95fe9e480a9349bbb1d7faaddb,0,2,1,0,3
5521,2e25ea09c6d842b0adfafe13ebb4b47c,2017-10-14 15:07:04 UTC+0000,5fba4bb064ea46eba12fea30ee46419b,3ab86281ac254f53b12fbe039856c5dd,2,2,1,1,4
6603,2e28a56e22cc4835a3037ec1a4cd9135,2013-07-01 19:13:58 UTC+0000,cbc912e669ed45a1a486c136d85ee36b,577476bad15d4e3885f71451fb9150c9,5,1,1,1,3
2720,2e5833f6e19e417ca6124e88a07b103d,2016-07-04 23:18:40 UTC+0000,07d6b508c024480689da399897f01128,7d425e8d7cfb4fe7b0702fff4d6d84e7,3,1,1,1,3
7277,2e84c5fa3bf14b1b962043aeab959335,2017-02-10 23:47:07 UTC+0000,90eab65783de48c99a3a965908cce050,1e972f8a3d16474f86fcc887e717c1dd,1,1,1,1,3
872,2e8f629a36de4a80b5349f7fb600096e,2018-02-06 16:37:44 UTC+0000,3807106a38da490887cc36ee37325e0d,fd5401129437429794d223f7008d04ea,0,2,1,0,3
4836,2e9159562ea345cfbe1b407ae1098c2f,2016-04-25 22:10:07 UTC+0000,b6fba62f4e784fbbb807790c0f502a12,a2ec54ab6e52447c81fead2e9fa2483d,2,2,1,1,4
168,2ea130631ba34b4181c5fd85816504cf,2018-02-03 04:04:20 UTC+0000,a42b7d2710ad423699f7c2200b92a809,ac83901fad384461ad33630aa2d823d7,1,1,1,1,3
5434,2eb0a9459f2a4dc8b0ad3926f2b5f64e,2018-01-24 22:29:22 UTC+0000,af9db1bc8952438da314149543c392a3,13b55ed4834e4814bb33a4c87001063d,2,2,1,1,4
980,2ec53a5b632f41319001e91cb450d784,2016-04-13 14:56:26 UTC+0000,b1a1bec32e8b4d65ade11ae115e7755a,4bf1020c28714181b8d47bdf4246f134,1,4,1,1,6
2160,2edcf988a7944c558ebc49567fff73da,2016-06-23 13:39:08 UTC+0000,9b09f80f706d423ea9568e11e65bd730,33dad4c5547d4569b9235017b411a01e,1,1,1,1,3
5112,2efa6c218c784a74aaf6651c36400ab2,2016-01-26 00:19:04 UTC+0000,885e2fdf2bf24de098d02204e31a1da8,e4e4b3a62bbe4fb68078e193a25e5f40,0,1,1,0,2
3169,2efac729c6a143d09c2100075dddf9fc,2018-06-20 03:49:14 UTC+0000,19374707f93c485b969017658aeaafea,749c5484ca8242f0b27d16e85d9c30e4,0,1,1,0,2
4881,2efc3ca531694cad843015b8e79eb712,2015-11-28 21:41:36 UTC+0000,d1a047d03881487ca55d003d85dbd373,8435fd16c86e492885acc2cf5b6e372a,1,1,1,1,3
4037,2efdfe2cb0fb46b788b525fdbd942828,2016-06-24 06:00:28 UTC+0000,40617cba5b1840da9c95c3b889f61bd5,c85420d41be7444d9588f806457025b4,7,5,1,1,7
4198,2f21662026474e389a68f524fc4b3abf,2016-11-18 20:10:17 UTC+0000,bb92457ecb1b4c7480cc51c4be91f789,bb4fe08bb5424f08972927d90bad9642,1,2,1,1,4
895,2f2378acab3f444199ee2b69d2d3626f,2012-09-09 13:36:44 UTC+0000,63b7a06323ee4d578a37cf780debfa58,0c673e046d824ec0ad0ebe012a0673e4,3,1,1,1,3
7315,2f49238bfe144d7f97feb97b76a5d9db,2014-12-15 17:56:46 UTC+0000,40c820ddc08d433fac26e9e85fd6a6f2,0ae9dca976bc49978e7aeb0f8f448732,2,1,1,1,3
3087,2f4db82d79064df8bd854fa347b031b5,2015-02-08 20:33:48 UTC+0000,e31e8a70d17640809304993851d0dde7,de6aab0719fb41dcabba94d5cca74b54,2,6,1,1,8
2721,2f634edcef9f448a8bdf28a01452ff27,2018-02-19 21:17:25 UTC+0000,7d8daaaa392844408a10456ead9c9b95,ce9d21f7eefc42ec88f27e2cac7ff833,0,1,1,0,2
1346,2f651e9635404c509a8a97d8ddaab7fc,2014-07-25 17:35:47 UTC+0000,f2dff377ce68465bb8c0e3a9d008022f,e3529e64e70643b6889353db79eeea3e,5,3,1,1,5
7895,2f66eabfb38e4c179a2098c45c54dc12,2016-05-15 14:21:56 UTC+0000,51e10f791537484a9627191e838861e2,36ff3b3666df400f956f8335cf53e09e,1,2,1,1,4
2231,2f73f388536642e3bd1bc982c03f1d68,2014-03-27 22:35:32 UTC+0000,8671fbba829b45c9b64d90ccba9aaff5,031c50365c1145c3a435627a74732fe1,1,2,1,1,4
6435,2f77a25e864c401abfb49ed2499465f3,2014-04-07 18:42:18 UTC+0000,07270bce566c4e0699460dd29b64f0d9,6063180d02234876b3f935131dd12d1d,2,3,1,1,5
216,2f875f2d64424807ae325323959e323b,2016-08-07 12:14:43 UTC+0000,f9bd1d5b2dcb4c3f8f5d84566c8dc935,6d7f0bb79e354b7cba05730fc4eb535a,1,1,1,1,3
7482,2f87d99fc7fa4483930dfa6c8e69879b,2016-10-11 22:05:15 UTC+0000,383a43f311f04e9b93f11d219823299f,d67ce930870945109a7ad86d29ba2035,5,1,1,1,3
1493,2f930e05621f484a992104804c6f9f07,2016-05-16 19:32:34 UTC+0000,b143b5d054ab4472bb5217704c919eb1,7667c23d26ab409ca3e49758f5367925,1,1,1,1,3
7714,2fa83a891a13495ca50eed2bb3d7e94f,2015-06-29 15:59:12 UTC+0000,7c679da961b5457db7c89114ec169278,e644b51be2364df3aad4521bffef791f,0,1,1,0,2
4833,2fc58c8d04f64eb0897f8b19d214ffbd,2016-05-13 21:13:30 UTC+0000,d989f2906b624714b6adf02cbf6d59ea,d3ba15fee0584d72971b06fb5cff6fae,0,1,1,0,2
2689,2fc99334515f4cc891ac0e79c0da0167,2018-05-17 00:15:45 UTC+0000,00e7db9332b94640b30685ed1927c8b2,d3e947787da44f49889d252b9a80ad66,0,1,1,0,2
6543,2fe6203fd7a34961aea7c990a76abe64,2015-09-30 19:35:33 UTC+0000,1accf01dbe7341e697820c0d0825d91c,369f1c8646b649f6997eae7809696bd5,1,1,1,1,3
1915,2fe6b1691df94d3d9baedddc0557782d,2016-05-13 16:08:17 UTC+0000,7638ad9dda13432d8975563b168b8d8d,9996e8176fa240469a8230e6df57cce3,1,2,1,1,4
4960,30353474217e483aa084552565cdd569,2014-10-20 14:27:36 UTC+0000,97ca29cd3dcc4890a6e464b6fa1445b7,8ccdfb0e32274f9897e1b89b8c48201f,1,2,1,1,4
1354,304ab7bfec4346db8be6b10018ebb935,2014-03-18 02:41:16 UTC+0000,a0a7b3b77fd8454d97e08b0886dce45a,05444a2f42454327b2ac4b463c0adbe0,1,8,1,1,10
7943,304c3b7170ac4d52aa43616bbd61dd36,2017-02-10 23:47:44 UTC+0000,c9d6d5adce5b41e0913338044fee5834,c1b8b863d87948618d28aba533fc2774,0,1,1,0,2
6232,305cd8050a944f549d9b93126a7889a7,2016-10-25 18:05:58 UTC+0000,8adf9c7903e54856ae32cb6ecbb1ce2a,e963b61ee35c47c49551d0b3eee97782,0,1,1,0,2
2878,30667407054a4735b94916a7fe4f6059,2016-05-10 03:25:15 UTC+0000,f076822ef1e1471daaf70f095dd5e9cb,58fa5e95fe9e480a9349bbb1d7faaddb,1,2,1,1,4
6690,3085c89344424d6bb9864eb924c77831,2015-01-13 19:35:43 UTC+0000,7661f591c59d4b60ad53b55ff146f604,53939a491acb42a4815463845a638186,3,2,1,1,4
6607,308685f8a09941719ede5da2be192a9d,2015-10-22 02:44:13 UTC+0000,62f5b64c51064ca1aa77f9d0a9ada59e,338cff27ccce4cf68439317f83015777,0,2,1,0,3
1434,308a5610108a4697857c761df644cd21,2016-05-04 01:27:47 UTC+0000,7ff7d61fd679469984733e99712d6a2b,7bffa1792d474359b922e5de700d7a82,3,6,1,1,8
3615,30909f34909a44e3a0b6e925cde1d3e7,2018-03-03 18:10:39 UTC+0000,ea5037d7b4e04ad2aca9aaee64b446a3,05ab77d4c6a141b999044ebbf5415b0d,0,1,1,0,2
5597,30ab4f1c39de4d6d902fd8358aec0225,2017-01-30 22:31:02 UTC+0000,6b0114efd8f84f45bf035874068f3d2a,036358eed7044c66a6058d1006fedbad,0,2,1,0,3
724,30bcfd6cc73947fb9adb3799f3000605,2018-03-20 22:44:11 UTC+0000,3fbee2e67b364b14a758c832f2bea297,778d5df99d9c4bf2b84b1a1537753128,1,1,1,1,3
5836,30c308cc4cea4b59be4a9ce0312669f3,2016-05-28 00:00:26 UTC+0000,fa34881c82e54bc1bdd06bf14880d1a9,5a5cb60ab4e44309a2f514d4c41f7df0,0,1,1,0,2
5188,30cc72e26fdf440992253ca0c2a7d460,2018-10-05 21:36:14 UTC+0000,1d2bfb9cebb74e06a740d2b005ff1a98,36ff3b3666df400f956f8335cf53e09e,0,1,1,0,2
6848,30d2fea882024eedb9e21e4334ae9a76,2016-01-04 22:26:29 UTC+0000,9805929ce0f24552b40e392c37bcf783,9b1c83cf58f6497f8c0a2a141b86b034,2,2,1,1,4
1452,30d3b2bafb03499fa497958789196300,2017-01-28 19:32:40 UTC+0000,cf98daba134e4dba9649729dcbf500c8,d97aaa6b7f7e4b1e9a6d65d5a0958183,1,1,1,1,3
2503,30d4cd68ccbc499fac98bed00d46a6f5,2018-01-16 19:03:36 UTC+0000,35d495ca7e5a49d3b91dc7546ea756c6,f46b9949552c49fcaea5c9aa624e2ddd,1,3,1,1,5
6958,30e13d3966004b94a2545d33857d639d,2014-03-15 01:38:38 UTC+0000,9ea42444f9e04f9abfcda10790d4177f,23b6df4d73fb4d9bab3eafb6dd8bfb86,1,1,1,1,3
1808,30ff56ad4dda455486d45e539f158f81,2017-06-14 18:56:32 UTC+0000,03166d1a76704f63a2621bb71783c86c,e1f680fc6bdc472dbe3024f7bf1aa290,0,1,1,0,2
2507,31001792853744d997e4436883009148,2014-12-19 21:57:42 UTC+0000,625e7db42a664773a5f3815c900b3d94,b82bf33d61f242409123d2fc58776ed4,2,1,1,1,3
7492,3100bd3b3bc645f8acf96c26b9be766b,2014-05-04 21:49:02 UTC+0000,41917c26114e4ed689dc679144ac15f4,3d8847ddc8d04185976a9e78b190ebdb,2,2,1,1,4
5848,31019980a6c44ef2a668dcc9288eb6b7,2016-05-18 01:46:00 UTC+0000,8578302440c04c9f8e00696975941ceb,e3183b5ad8e84d2984d9fb22ca84fb83,1,3,1,1,5
5996,310493b4a1384a61ab9f1802a3ec43d5,2016-06-21 20:22:04 UTC+0000,af40f6793c5949e594d8848d4b66be68,eb067e405dde49d3b8d3975212dff022,0,1,1,0,2
732,3118a48d2a8f445bbac23cbd19f8714f,2016-08-16 02:25:29 UTC+0000,ba32f0a7a9bc43558ad14b90f1195d22,5b85a1dee8b74d79a87d53e758d897c4,0,1,1,0,2
1635,3119dab498cc44ecae85033488932586,2016-10-11 20:05:41 UTC+0000,f8be349d327844cb9c3d2d38c41d0e04,8b7157fd6a4f4c728017269d6471ce1a,0,1,1,0,2
7240,311cbe18bfdb41faa9a1da1c56bacbc3,2015-03-30 16:52:45 UTC+0000,c4056b5461284f38b47ea158ebf6b9b0,369f1c8646b649f6997eae7809696bd5,3,1,1,1,3
319,312b74e11db6410194309898a484c44a,2017-02-28 02:38:11 UTC+0000,f69e98f40191468f9e089a4041b8ed61,4b69a5256cec4d179c3e7419cd64137d,0,1,1,0,2
7644,312ff41f04144856be590242def87881,2015-11-12 10:23:47 UTC+0000,6c67f6af1f974de99e02d05c98f92930,a1006e6a58a0447592e2435caa230f78,1,4,1,1,6
320,3140d6f460fd4b318ca79820a101502b,2013-04-04 04:42:40 UTC+0000,dcb7a6fc2c584c72b433e9b15486a5f9,889d3b11eac84609a578991f88568d8a,2,1,1,1,3
6131,3141dfb287d8460597eb7553153627c2,2017-01-11 23:43:06 UTC+0000,c337cbe94cd443a183719b1344b3ad88,2b87c8cbff624ac2af73a819a21e7848,0,1,1,0,2
4539,3155da10b7d44f9bb4cb1f8219580cfd,2016-05-14 00:11:39 UTC+0000,ab5253c69b77401387c85ebe748efa5f,655cb4965f34469897b44a86f516f3cf,2,2,1,1,4
1830,316764bc788f43669fcbf0eadc85cc50,2017-01-12 22:20:44 UTC+0000,063bca1b0f8a40918bd6e75cbe995e97,9496418c2b6a4c059442c81cd73d55e1,1,1,1,1,3
7194,316b4e53b70d400ebea013bb7de3d187,2016-05-24 19:09:24 UTC+0000,aa9a9614a66b4c849e2c562598dd820b,7385c14f6f1d42678c3b4be9df5642fb,1,3,0,1,4
1873,316f6f3387754703865fdde7974776b1,2017-02-22 16:31:47 UTC+0000,649bf441065a4de09515afa4b58075b6,1d09800aa6804f3c92a89decf1bd7fa5,0,2,1,0,3
5817,31829504b6c24fff89d5f93adbd1fc7a,2016-09-12 10:05:51 UTC+0000,63ecac19f4f5422698d4aa2ece2acc6d,dc76158aa87a4d6fb6bda6d2752216e0,1,1,1,1,3
6043,31840103293e4b5a9a5c624700b886a0,2015-10-27 18:58:04 UTC+0000,aa2fcc1c213444a9b5db64fc0591b927,a1006e6a58a0447592e2435caa230f78,0,1,1,0,2
4105,3184cd01a2a040c697cc0288d41450fa,2016-03-01 23:47:01 UTC+0000,c93387712f4d4c9e851fde4c06fc5e0a,a1006e6a58a0447592e2435caa230f78,2,1,1,1,3
2006,319a53b3a6fb4131acbe0ec93a281142,2016-05-21 16:12:19 UTC+0000,ee4e12fb642e4afa899f766c619d4cf1,08f4c4808d8e4eb1b9b287cda01beecc,1,1,1,1,3
4952,31a7546a95eb4bd69ccb5176478ff5c9,2017-01-23 22:54:34 UTC+0000,2c49e888419c4096bd9805315c687037,c423b56f85034f50a12b0a8600ac6e19,1,1,1,1,3
5748,31adc6347be6481e9d4560b791fbec67,2015-12-24 02:34:35 UTC+0000,43364beb206745dfb5d6a61b39795bcc,bb4fa1294340458b876ba2c8a6101880,1,1,1,1,3
3413,31b9050d54b14b2fb752691b2ba2538d,2017-11-05 01:41:30 UTC+0000,50ac89e0ebd7470a8a7d90f41e9064d3,37956bbed986415e8259d1292365b972,0,1,1,0,2
5354,31cd8e083cb642bf9f30ca9dc9c6dfe4,2017-10-26 06:31:02 UTC+0000,7fe29d98228b402480e35d163531335c,6b2c622a1cd3475ca5e3dfd64bfcdd09,0,1,1,0,2
4688,31d383dfa22e4a21b54a5b26260d3430,2014-10-02 19:14:31 UTC+0000,fe26bcfbdd7c41c9acc31fc332ebbd54,547122349484428c885dd9d18051b71e,0,1,1,0,2
1157,31d442c17d8b42189cdbb700bb60c367,2015-12-01 18:01:34 UTC+0000,8c4a9c2018054dd8a2b0a49e1f0957f1,d9e43dd5e0ef4df19814ab3b370fc368,1,1,1,1,3
6181,31f40eed43cc4ff4a7dacd551b583ccc,2014-03-18 02:15:13 UTC+0000,95fe7fa75e964cbf876ebc6a52bba580,77a65aed859f4b11983cd07399f1e3b1,1,1,1,1,3
6073,323005523a274953bb5c5c565844613a,2013-06-07 12:39:37 UTC+0000,d9a97af29a1646f7961f0fa3900ef859,05444a2f42454327b2ac4b463c0adbe0,1,1,1,1,3
3235,3241b4183bc64c4992b9081c6966e398,2017-02-23 21:32:36 UTC+0000,8213983d5c384773bb9e95111c7fd921,9e0cb2a2914c4d05be76c85e7ca356a7,1,1,1,1,3
7249,324dfded1bb14f28b62be009102ebddd,2018-02-09 19:06:11 UTC+0000,4ec7e33e3c3e4ccc91829dcb7fb89baa,7873744371da478f8d24242468aa1b3a,6,3,0,1,4
2731,324fa1d469844279bc16a0035d81f5ae,2016-05-14 03:44:22 UTC+0000,a0239f48b4d24c43a6aa902dde5dca4d,58fa5e95fe9e480a9349bbb1d7faaddb,2,3,1,1,5
4981,32594f44a8704bd29734162a0e9a011e,2014-04-28 01:03:28 UTC+0000,9599c58b7f814d4683ce28d65b32aa6e,fe4543418c0846e5a65fa22b4ad9a304,7,4,1,1,6
1657,325acd7590154b3ab6f3abf81d85462a,2018-03-06 00:08:09 UTC+0000,6f18e91a390249449da5fe214f65dddd,4100bf850f824cfea386cb3f51bed263,3,1,1,1,3
4343,3263a5f39dba4a86b993c33b65449b7f,2016-03-07 19:56:47 UTC+0000,e2e8af10d94849b8be2d2a963d82179b,a214262be8684318b78ffc54ec4292e2,2,1,1,1,3
1081,327d57618ff4446684d49a4d7a67b05d,2016-05-19 12:36:18 UTC+0000,4f1c0439ce854a14afe06f1349196b0b,41373150e4cc4505acf8c3aca6f46e29,2,1,1,1,3
2456,32825a6df9f6444ab7f12208442c2cdd,2018-08-30 00:28:27 UTC+0000,4d80d04f652a4feda9056021c02677fb,4b5a77c7132442398e4efde80670cb58,0,1,1,0,2
2699,328c6be57d314ef78d4841d0d050d260,2014-05-16 21:27:11 UTC+0000,3e573e107e0c4611ba0ade081e00710a,3d8847ddc8d04185976a9e78b190ebdb,0,1,1,0,2
616,32b7382428894bd08d14fe3c01f3cec7,2016-05-16 17:19:18 UTC+0000,3d910ae56a1d48d69fe6ca8a4d721af9,5f907f3b8bc24515be5e3416f390c4d5,2,1,1,1,3
5189,32b7d18ebb4b466dbd4e6f96f0e67765,2016-05-18 20:57:45 UTC+0000,5f420dc527a5498aab166d6e2ed516bc,36ff3b3666df400f956f8335cf53e09e,0,2,1,0,3
5104,32bbbcf21af54e278e5768d176cd80eb,2016-05-11 10:36:46 UTC+0000,8571f41b47e64575a776cde25553be78,d2d81872d01944588c04cb8943db09fd,1,1,1,1,3
2479,32d313dc08e44533b091daf3b15ebef6,2015-06-24 20:01:33 UTC+0000,db493c13398642f78d242bb53865a71c,976b9fe0968a4032ad42f2bb2a94d9a4,0,3,1,0,4
519,32d515aae6e2407baaf694946d9977f1,2017-01-30 18:07:38 UTC+0000,db34a28170624750b126e7bc3153f966,a1006e6a58a0447592e2435caa230f78,1,1,1,1,3
5185,32d9b287214e475a86804e538e73e5c9,2016-05-04 12:39:07 UTC+0000,9d7878ed311147f88035fcd817235ce2,f3571af1de254f48a9404db769bf84bd,2,1,1,1,3
4188,32e46f8f5eee4032a344358269d1513b,2016-11-14 21:41:54 UTC+0000,0e7f3b350ef94aefbf248bf442a91085,d2307e2205da4759a5a1c27ac988808a,1,1,1,1,3
2107,32e56522721d4af5b35bf03f62dc74fe,2018-06-19 21:10:16 UTC+0000,605e4fd76d194a68ae4a2b589e46d677,ee251275d6c644f8baec8353d59c3866,1,2,1,1,4
5047,32fb0498fa12465bb4848561ff8d678d,2016-04-20 12:42:31 UTC+0000,744752466d6c4f27a926317e2f8efd37,41b3984603ec43bdba6404c675800889,5,6,1,1,8
2180,32fd2d435dca4be0b079df58e8c4cd96,2015-11-19 10:16:56 UTC+0000,0f0a3a2fbc54439eb3e3cfd6ab41017e,a1006e6a58a0447592e2435caa230f78,1,1,1,1,3
583,330ea22e999c478ca2acf33d37b914fc,2017-12-06 07:32:40 UTC+0000,2dee1a31d9d64493b693e73c6ecc1249,0fd0407d22834d3bac2ecadbf9d1f2bf,0,1,1,0,2
1707,331f7832b73b4a8e8306be4abd562502,2014-07-18 15:33:39 UTC+0000,ca7da0dbe5814dffb90621d3e34aa1c8,5bc0c3af77b548c0a7f60f11ed2fe4ed,0,1,1,0,2
0,332a511f1569444485cf7a7a556a5e54,2016-04-29 19:40:14 UTC+0000,4e5f01128cae4f6d8fd697cec5dca60c,36ff3b3666df400f956f8335cf53e09e,0,1,0,0,1
2038,332ed3747a774bba8b3cefa630db1404,2016-08-21 13:32:25 UTC+0000,4c6ae4bd2136472899c15b798eb9d3df,36ff3b3666df400f956f8335cf53e09e,2,30,0,1,31
7116,333464d7484b43e3866e86096bc4ddb9,2011-10-18 19:14:15 UTC+0000,683b200ad5014e84a441db677f990d75,0c673e046d824ec0ad0ebe012a0673e4,3,1,1,1,3
1293,333b3bb9f26a4d25bbb3a50180894ea1,2018-02-16 18:21:08 UTC+0000,f6a84cae42ca4c9bb842e2193a1966c7,e1f680fc6bdc472dbe3024f7bf1aa290,2,1,1,1,3
1730,3346e221550b4c9b87e6fa6269befb0a,2016-06-27 01:33:57 UTC+0000,e34e8fa34939415bb68f6706e0bf6f17,36ff3b3666df400f956f8335cf53e09e,0,2,1,0,3
3800,33507de75ab14ccca8d43770f510ebe6,2017-01-24 23:21:17 UTC+0000,d84b4cc871114875b284f6c6ed2e8504,3358d3d8c0c242259b1616a079ce9526,0,1,1,0,2
5146,3359b5a733464520934c95d81f33047d,2015-03-17 16:43:36 UTC+0000,83da9e574bcd4b7e9b04694062072931,7d425e8d7cfb4fe7b0702fff4d6d84e7,3,2,1,1,4
4519,3360b36e32434a88b99b385c5d25c659,2014-03-26 19:08:09 UTC+0000,697dbb0a59934529bfa24f13f3526e21,b9389146aa5043dcbf5d7b4ce903be9d,3,7,1,1,9
2238,3363b57467df4fceaee17792836f5fcd,2018-02-15 23:13:11 UTC+0000,7531cb66a2d2477b9c5efb38c69e7593,a6d33c38902546849c36ea7e9e9f0870,2,1,1,1,3
7295,3378c45422704f7abae83ba8d92d0c03,2016-05-20 19:00:23 UTC+0000,dc09eeb441994dacbb41c49e34609202,f96f59f78b4c4c4dafff870b194d8794,1,7,1,1,9
6668,338daf00cd594c1fa1409c2c6175aa85,2018-03-01 13:29:10 UTC+0000,bea5a725eaba4af694f5b39e94d17a03,5a14109840c24b21b81eec989db259f6,1,1,1,1,3
4804,339968fa3604440081398f0ccc05ba93,2016-05-04 16:59:45 UTC+0000,6a5e747929dd463b8d386b1d0b00b118,44ecf414c6914a82b2b7bdd03db2f59c,1,2,1,1,4
2809,339bc9ba285242e3aa53909bd7dbf2cc,2018-01-14 04:59:13 UTC+0000,c364a5c1e09242b9affb26a79ee594ef,be5d23056fcb4f1287c823beec5291e1,1,2,1,1,4
1760,339bd64a5c954b7b9f06f4c1fddbb56d,2016-05-10 22:27:47 UTC+0000,1fe8a7c549ed4b738f644bebfd0415fe,57cc7082c3ff4ffe83ee880e51314c70,1,1,1,1,3
1393,33a173bbb7cf46b2bf9d0ff99829411d,2017-01-12 23:40:23 UTC+0000,261ff19f1f924ac5af80a9a480400462,9496418c2b6a4c059442c81cd73d55e1,1,1,1,1,3
6944,33a27be5d0144d45a9f37a9adf31b620,2017-10-02 17:03:11 UTC+0000,5b556cbc64814b2fb3d922ff69e0edfc,d1a16aea651c428dbb292c4ad37d7cd6,2,1,1,1,3
3579,33a5d1052d804ca1a6257d59b6825abb,2015-10-28 18:41:58 UTC+0000,e2e87350555e45c18f8c1b537ec19a3d,a1006e6a58a0447592e2435caa230f78,2,3,1,1,5
1955,33b682ee4c64449baf17773faf2b376a,2014-08-10 11:32:43 UTC+0000,9d2e5c34b3ce4750816dc3e3a2d1ad62,7cce25cc8c1042b1b4f135bcacfdad82,0,1,1,0,2
5339,33bb06101a364c7aaae467c8b568a37b,2015-02-24 15:46:45 UTC+0000,e9b650789b874b72b635295b94e548bc,bdd28bb878494d4bb10e7ae0afc3ec0d,4,1,1,1,3
987,33d510d344304591a4a286a38ae8980d,2018-12-10 21:18:06 UTC+0000,b5e9faa6af8643868cea8ba72bb66f42,6ee9c20eddbe41e890dbde50fbd63f44,1,2,1,1,4
1568,33da5b42af304513af00f210be56ea68,2016-07-06 11:53:30 UTC+0000,884baf953d904cfe900cceae3846484c,be5d23056fcb4f1287c823beec5291e1,2,1,1,1,3
7859,33e8acdfff9b490e88ccafbec109a33e,2018-03-02 23:18:54 UTC+0000,739c481321524e8bbadff8f7df00fc0d,42f4f62453e24efc8bebc6ff88832cc0,4,1,1,1,3
3767,33f448d533eb4ec2a9195dd686c5f048,2018-04-03 13:14:06 UTC+0000,eaf11dd0e6c34f5dbe6b800cd4d94014,ab6ee37ffbd24c568f8b297ed3679095,0,2,1,0,3
4531,3411c7f6d88c4b0caf23ab35d5b599e9,2018-07-31 22:56:27 UTC+0000,96aa6a3e663442ae80fd7546333e6b58,36ff3b3666df400f956f8335cf53e09e,0,1,1,0,2
1456,3420fbdcf1c54077a98bd88a43c35ae8,2016-01-21 19:33:08 UTC+0000,36ba0132e4a64d4fa2b608e13a8633de,369f1c8646b649f6997eae7809696bd5,0,1,1,0,2
7172,3431c49ed7944ac69a641df6ebd6d885,2016-06-18 20:00:38 UTC+0000,8a019de8deb44b5c8ae611bb38d0c11f,505fb5d32c1e41c5affe896328644832,5,4,1,1,6
7298,3439767bfa2f4dfa93a4dcf1d367beb0,2014-02-24 23:46:54 UTC+0000,31a0cb179a184ccb955549c4148c9a0f,38bc1866f29744f9a003e2e826e3fcb1,1,1,1,1,3
1116,344cf4ae55624db1b23e0fe6141ad3c6,2015-10-16 19:40:01 UTC+0000,f3f98ed96ee34529be416bb505d747c5,a1006e6a58a0447592e2435caa230f78,0,1,1,0,2
7406,34536597161f418d8b921031e93aea92,2016-06-24 09:01:35 UTC+0000,5e7b5cbfcf754b71be020c8938fc87a0,c85420d41be7444d9588f806457025b4,9,1,1,1,3
5907,346f9a9ba25a455faccc96b6f849bc5f,2017-09-07 14:49:59 UTC+0000,9311df01f5724db380d6170ba26ed689,96665262f1a841bc86f5a4fe7e24814a,0,2,1,0,3
3720,34770d6b9e0643498edbf17b474bf1ed,2016-04-13 17:14:12 UTC+0000,8b18f0a8e8c4463a8fd9d7f6c9bf1524,89ffc7c3266344b68c2dbce832d102f6,1,1,1,1,3
212,3482d0ab361044fdb94137a4b1bbd021,2016-10-22 15:23:11 UTC+0000,2c193802d0f74058a019914097e65443,b037355697ed40e687368bb233060e50,1,1,1,1,3
7051,349e0206b28d44268b2b33fa2bb09236,2015-03-17 18:59:25 UTC+0000,5bf3f020302c49fd8d548613981fd031,9d2599d9131d46889d164a61924ffb2b,1,1,1,1,3
3255,34a65bbdeca04713984b92e314246d74,2018-10-20 18:17:26 UTC+0000,6059434260af4322b248fc8a392ff059,a9d82ebbd59f4f239d92d960c86d96b3,0,1,1,0,2
772,34a6f16a80254413b2c33fc67c9aeac4,2016-12-20 19:51:15 UTC+0000,dd73b2d06039425e93bac7ad2b8c626d,98f1818a32c947a6a8abbf8c112b4d33,0,1,1,0,2
7633,34c37dc0885e40c6bc78996b199d6f56,2017-06-05 16:01:56 UTC+0000,e2394e3291f24285980b4fe8e8d61f6f,65e4642bc86b4e20a7c134a93b95fdfd,0,1,1,0,2
2214,34ca4228a2b14a25af9ac96dea1b16f9,2015-11-02 15:41:37 UTC+0000,4c8ab7bb35994d2980e1d77c8b14d4d3,cebf38f307044ca59850b1f503f4a268,1,1,1,1,3
1027,34ce9ba2e3d84819b8e90f63a4dd294d,2017-02-16 23:34:13 UTC+0000,f653a6e2ab704d43a45f06c24340c1dc,70dffb2581084875b85cf10f498bdab1,0,1,1,0,2
4142,34d2d110b7b74fae9df84d62f6046bf1,2016-04-07 01:42:05 UTC+0000,cf30f97e414d448d8e5eefc2929f0510,a807e6bd9421454a9de875c744035c7e,2,7,1,1,9
2188,34d4bda0c7c04e7d9c5aba44af64bbff,2016-08-29 14:27:22 UTC+0000,fc9a2d4711dc4a669e5ae0f50120060d,8ce1dca4e94240239e4385ed22ef43ce,1,1,1,1,3
3330,34dbfe493d284c58865bdd17620a9276,2012-09-10 02:55:54 UTC+0000,acb52b598a5044a0a48b0e73f9b891d9,6528a2e859cf4409be758ad4ee913067,2,2,1,1,4
1835,34e16b333c114f86a920214bcfab8344,2016-05-07 22:48:34 UTC+0000,14ed831d8aec4b5e9424e202e09775aa,36ff3b3666df400f956f8335cf53e09e,1,3,1,1,5
1520,34ee5fedab444ecba53fa7a81f932a76,2016-06-22 11:01:26 UTC+0000,fac72a947922401f94c200149b5b370d,9c790846805047818338a69efbe7be0b,2,1,1,1,3
7658,34f033dc571c40fbab5ce4fed0b057e0,2012-09-09 06:58:50 UTC+0000,a9037a6f0bd546ccba8d0b1e7c4a5574,624194ea296c49a6a8ef1180787476dc,0,2,1,0,3
4319,34f6ffad5dc1417190e38705261e91cb,2016-06-11 19:43:40 UTC+0000,c9e4b1b8aee549ccbc5b056be7023ba8,4dc7d9040592416f98c0bef1ad2c31f5,1,1,1,1,3
963,350410a8c897409d915f6239899acbc8,2017-10-26 21:59:27 UTC+0000,9cf1ff7b3d6148dd90eb6d613d4d94cc,c24a11dfdf324ed3b2d036de32ee2658,1,2,1,1,4
2990,35094850eee44c1780636c1833fb1dd7,2017-02-13 12:30:30 UTC+0000,5ec694af2fb6460e954c651ca44fc1e8,be5d23056fcb4f1287c823beec5291e1,2,1,1,1,3
922,351144c9979d4359b9d384a45b219934,2016-08-08 09:15:48 UTC+0000,95c28484151943e0a326df888be3ee98,fb7e8b1ae3d347888724164350616476,2,1,1,1,3
3890,35169df7055c44f3bb59202f2c2da90b,2016-03-01 17:23:54 UTC+0000,e55a939cfa4e456692594447360283e8,45dc9c3d02ba4d03b7ae75ace7db7761,1,1,1,1,3
7808,3529a5f1969948d6ae4354ddffc168ff,2016-05-04 21:21:13 UTC+0000,9035317aedde424baa53dcd59676a9e4,89ffc7c3266344b68c2dbce832d102f6,2,2,1,1,4
2549,352ef23e00b14674907c1754ff8aa670,2016-02-10 14:34:10 UTC+0000,afb5cfb9ce3f42e2917caf3f26842ca0,96bbbdd06a334805a0501034d9df1aa4,1,2,1,1,4
3794,3534fc7763ed4b52aeb78ae12c222b3b,2016-10-25 22:26:29 UTC+0000,cd44b25fd52a47059e379d52ad2f5972,d7ba3e9d430143d0906c13580410c37a,0,1,1,0,2
450,35443d33618b4ca48ea2ba045b8d2232,2015-03-18 14:03:29 UTC+0000,f797958670f740c19fe6db6ba112b638,2ad6164ce1e14cc4b76048e0652fb1ce,1,2,1,1,4
6915,3544dff661684a13aeefac733636bef8,2016-06-03 19:49:26 UTC+0000,54dc31ee2b754d228575d72c139629ed,13c203d5311c425f9454eb723d61f2d6,1,1,1,1,3
5987,354f65987c60416d8f2741159bcc37c9,2016-09-21 00:22:07 UTC+0000,153c79cb7e5f42a2b3a058d194b25fe4,b28ef87a55e14e64b10ff8f673620dd4,0,1,1,0,2
2916,355216e3f94046c1882e5bcedb510ace,2016-11-05 13:31:34 UTC+0000,f711ed5596034997a32293177ea99c23,36ff3b3666df400f956f8335cf53e09e,1,3,1,1,5
3103,3566a5188f8643ee86f7881808e8e244,2015-03-17 18:03:01 UTC+0000,144fb096898948cdb1e58c78675b1560,e1bf7e669a13469fb7bbd0ccedb66fdf,1,1,1,1,3
4327,356dae9c2a3741b5baf245f0a76558c8,2018-05-06 03:09:27 UTC+0000,4dfc947ed0634321913dffa0c45c82af,be5d23056fcb4f1287c823beec5291e1,2,1,1,1,3
3113,3579c576e3c64c268d2062355652f507,2015-12-08 21:14:26 UTC+0000,6be2fddae87748ceba5767250e6f0d6e,a1006e6a58a0447592e2435caa230f78,0,1,1,0,2
7521,357c05e801d2401ab27233438ad17253,2016-09-28 13:56:10 UTC+0000,920fd910f2f2477dafd0489fabded96e,6aaf70fd593b4f8f9299dc9c18c5f085,2,2,1,1,4
3241,35888c19de9d4b9eb0aafa30077c08de,2015-02-09 14:14:44 UTC+0000,53eba3adfe744533b2538b52be4e33b6,369f1c8646b649f6997eae7809696bd5,1,2,1,1,4
1851,359923baa3074dccbbae60375798a661,2016-07-06 14:56:40 UTC+0000,2fcd550041334c4a84549403ce28dc26,35dd5ef6c7fd43188a001e9acabdf948,1,1,1,1,3
3274,35a69fd73386403a98955bdb557b1647,2017-01-31 00:15:44 UTC+0000,76ca37da6f9f4c268540bbf5dac5b6c6,e51e05583b994cb39a2b8c78c07260b0,3,1,1,1,3
7927,35a89d7e299a4919819bbe10894fcaf8,2016-05-10 20:42:46 UTC+0000,f317bcc6e27a483cb9753b78f3826a3b,58a4bfd0d3444c7e8053294f3be96dbe,1,1,1,1,3
4083,35c24ef4fd644596b6751088f39fc14e,2012-09-27 01:35:30 UTC+0000,d81499f78d60420a9e4d6ca99af2b6d5,38bc1866f29744f9a003e2e826e3fcb1,3,3,0,1,4
5206,35c53b318dc44506ad053d0c0358be8b,2017-03-18 23:41:01 UTC+0000,9d0ef90465394876b762529401852d32,4d9079c15bd94726b57d4ebdb63cc0f0,1,1,1,1,3
3193,35c5f9f4e649449b87af83fdefc2c46c,2018-05-06 23:54:40 UTC+0000,7e144c3f6bae43858a1fc03f93ea1d22,4dc61581ec7b409bbd037e483f53ba0a,0,1,1,0,2
888,35c85a5b36fb4889991ed55bf115e5bc,2016-05-17 14:29:20 UTC+0000,f612168c3dd149f58f796f3aef565f11,369f1c8646b649f6997eae7809696bd5,1,2,1,1,4
1920,35cfb10fed724333a036608497d0b426,2014-12-03 15:34:18 UTC+0000,89c99346efa447bdbe72702f1c50c626,564ef581bed64addb3cf0ff0ab652ffd,2,2,1,1,4
4269,35d1899f9e0c428e85881aa95a92c9fa,2016-08-16 23:51:15 UTC+0000,659888cb54554d5e9c90e6590892542a,36ff3b3666df400f956f8335cf53e09e,1,3,0,1,4
152,35e1892757d84c4e98bcc4a6d382f9ef,2016-07-22 21:54:38 UTC+0000,11bd4d96480c45a8986a10ff254898c5,8147e4d83ebc47b689901dc534981de8,0,1,1,0,2
3529,35ecda4853bc40199cd8abbb9ba76055,2016-06-22 04:50:15 UTC+0000,7c9420fd4554466db3ecbd8c750c73f7,4dc7d9040592416f98c0bef1ad2c31f5,1,1,1,1,3
1799,35ef966643dc4faab3ed2f2a4366e0e0,2015-10-15 22:26:32 UTC+0000,ab80a9456e4e46c3af8f02243adb40b4,28ab9f0e7aec4a1c882798f267c4d85a,2,6,1,1,8
1186,36130076943b4c10815698910b64eee2,2017-01-04 20:44:54 UTC+0000,d865b82456954dddb3d71afdb481a7f6,36ff3b3666df400f956f8335cf53e09e,0,2,1,0,3
3844,36175b21ed3a4256a6ff371ce1b5a202,2016-04-26 20:25:25 UTC+0000,3347d787ab01478a8558f9b50ddb1338,d1f04208de3643c088f4a25e57f1cb2d,0,1,1,0,2
7184,362bb17039884c8aac0d5d80b3d53a68,2016-09-07 22:38:58 UTC+0000,98a885a433c14270be9366b5b3e76b8d,a1006e6a58a0447592e2435caa230f78,0,1,1,0,2
1204,36390f09fdf9497dbd57fd3ac9ad3fde,2017-04-18 19:44:27 UTC+0000,a8a8db2ab7de435f83b1ae02dc83c717,fe3450faac98487e8ae51ba671157d81,0,1,1,0,2
4026,3640134431d0472386f779e1c100de92,2016-06-24 16:02:03 UTC+0000,9c898ed56f6a4603899ab6363c377ac1,89ffc7c3266344b68c2dbce832d102f6,6,6,1,1,8
5374,364b48ca28ae470dae5403324f7fb759,2017-02-09 18:45:47 UTC+0000,b6122e79d8044ed2941e27f1d8b9f582,fa3cf8b5156342938bce8b873ea45031,1,1,1,1,3
1628,365bf526f4f443a68fb2c3592b452938,2016-10-14 02:26:13 UTC+0000,91ea514feb374c05990c2acf53da05ce,cdf6e0ba46ca4f3c80d39943b210e3b7,1,1,1,1,3
2697,3683aa8bdc3741e4841f6fdd115338ea,2015-10-10 01:05:19 UTC+0000,749d0129127649e4b682a68644782668,3affd7f76d64492ba6a46338ae996a98,2,2,1,1,4
3837,36876c32e4d44d56a6f56e3577e369ea,2018-05-16 17:45:41 UTC+0000,98d7fd14c2fa46d8bf15fcaeb91cdb21,13b55ed4834e4814bb33a4c87001063d,1,1,1,1,3
2324,368a552a7cc7405fb5fa09ec388d1958,2016-07-22 21:13:04 UTC+0000,e59e0a1fc42049ec8986e26174f32ec1,8c8fa1821cf242a7a609cae0780e6c74,1,1,1,1,3
6266,36972b170ddc4c9598f8812484b435bd,2016-10-27 20:40:25 UTC+0000,279630798713461d8625bc578bdcac88,72b238385b3e4277b3c81784e56d07d9,0,1,1,0,2
5348,369af46149894944a258d736cbb0b2d7,2017-02-17 16:39:25 UTC+0000,104624dde05f4bdea33c85d6f5b33f45,416321b48a634ac8a53602625f0a5d40,1,1,1,1,3
7764,369bdc7147674fb7ab3a8685b3671cde,2016-09-13 22:29:50 UTC+0000,74f1e6890b43435ebc0955980f45d6a2,375133d6c3f44ecd96f25dc34121022d,0,1,1,0,2
1247,36a5b4a77822427d90f0cce2b38a08e9,2016-06-29 10:44:46 UTC+0000,5024134148144852954d7d6788e08665,36ff3b3666df400f956f8335cf53e09e,3,4,1,1,6
5020,36abe1271fbd4963afeec2585f36d578,2014-04-25 19:25:58 UTC+0000,fa7ca4b9594a4f6da04b8240adcdfe64,fe4543418c0846e5a65fa22b4ad9a304,1,7,0,1,8
1847,36ba3b407ffe4176ac7752a85d98fd2f,2016-08-16 12:10:43 UTC+0000,5d1adeebb4024dc0b5af7d40ce52fc32,ff08a0e21fcb40a591a53cf73258051b,1,1,1,1,3
3089,36c34172a2ce4a669bd2a24c8092091b,2016-05-03 00:33:05 UTC+0000,a00917f45b9249d696d7ade5c8f48047,741f2aba21b84d87a5031328e9deaa20,0,1,1,0,2
2229,36d0a59ddcd44db6a811a38b8cb68489,2015-05-19 15:15:32 UTC+0000,05b9a22d44ed4dba9a9d752c5f31a4c6,369f1c8646b649f6997eae7809696bd5,0,3,1,0,4
154,36d8f1b6270e4fbda47585f1c5380cd0,2018-09-06 13:39:14 UTC+0000,2876a82302d54b9992f1f444055db912,36ff3b3666df400f956f8335cf53e09e,0,1,1,0,2
3535,36eb161e055b460983570b70edb467e4,2016-04-28 19:17:19 UTC+0000,e9f81cfe83294e2e8d582454f9d7c7ab,dab1ccb54ed44b9dada34f70ae039814,1,3,1,1,5
7878,36f9daf91cf24626a7ca002b512c23f6,2016-05-16 15:35:37 UTC+0000,f039e0cf95224609badca9e7a1ae6881,e1d39b665987455fbcfbec3fc6df6056,1,2,1,1,4
1582,36fbe9c1132348908d70bdd3a681c31a,2018-03-20 01:25:43 UTC+0000,f94a57f9ed1a4539bac584202cbc8937,bc46e3699d92477ba8c7aa723e54a151,0,1,1,0,2
1592,37177d61af07478c90481a453a82b22a,2017-02-14 01:21:17 UTC+0000,c9c46eac30694a93bb2d8ea6632109e4,7919ea19db274c1fb862f3456cd25ac5,2,1,1,1,3
5063,372efc2ad36d422ea0a0e62f45b200ea,2012-09-29 20:21:21 UTC+0000,aa090ce3d99944e6900959d914c0a7c0,8442ddfd38bc422fb4677785db0630e6,1,1,1,1,3
1137,373c132c0bce4f849263936ece3ce60c,2017-03-25 14:48:27 UTC+0000,194ff3bf063f4519853d041712a11d6b,65cd85193d2d43c385ca5a5abce62e63,2,1,1,1,3
5415,3745d691d1c14116a0c9cdc670c7ec43,2016-05-17 15:45:15 UTC+0000,61b97b459f2144ad84ca238b0fa09dd5,22a46eb93d3d4223a854668375ca131a,0,1,1,0,2
4824,3745f76a544d49c3ba5b0ac969564e97,2017-03-09 15:35:50 UTC+0000,1c38e123c4ef40bdb51280004a463b43,bb4fe08bb5424f08972927d90bad9642,0,6,1,0,7
925,374694af189149f884c555f9b9d07c7e,2018-09-28 01:04:40 UTC+0000,806d8b31619f4f5285d22012babb0596,14694875d43d453ea5645db2693fa576,0,2,1,0,3
189,3747990d088b4f6c988789d080c0829e,2016-06-24 23:39:01 UTC+0000,ff23fe063e50461a834d7a75c137e418,6ea2a8a29d904015959ae16913092ac0,4,2,1,1,4
8014,3756bccb02b84bed88a80fba3c95cfea,2018-01-25 01:20:07 UTC+0000,ae80acf5b63942ffa8ab119958dc890f,f6b1efc0ed1a4889891b1287913db5b6,0,1,1,0,2
3070,375a8a4c3b7341b08377ca8a4fd8fd54,2012-03-30 21:34:12 UTC+0000,324b934ed7204799b320c63273e6f30f,2e80f4e84caa4dbc94e7e5311d3bbcd2,4,2,1,1,4
2042,375b70c666af409189d6e907a6862476,2016-04-18 03:52:31 UTC+0000,2ebb4d87d54548bb9e1a12db454bd692,58fa5e95fe9e480a9349bbb1d7faaddb,0,1,1,0,2
2451,37798ab892544d0c9c483ab2d9bf9a0c,2014-10-08 15:55:35 UTC+0000,df46ecbecfe6474da527cca37fae642f,13b55ed4834e4814bb33a4c87001063d,0,1,1,0,2
7977,3798eb1f0a7544319ba88162a996001c,2016-11-01 18:50:19 UTC+0000,0cd23992a13348a3a7b474de6979431f,428b3e58119c4f86b2cd628ceee8fbeb,1,1,1,1,3
7685,379ea1c1bd904b3e9a9640a7b079c665,2017-03-09 09:45:57 UTC+0000,4af10e6d7c75464282247cf46daf2b1a,751d8ab497b04dd5b71b94e20c072b0d,0,1,1,0,2
6596,37a50d8b932a48ceb49e9b88f5541f5a,2016-09-24 02:13:29 UTC+0000,34b3dfbaf9bb41bfb92212ba98c3ec7f,4dc7d9040592416f98c0bef1ad2c31f5,1,1,1,1,3
5156,37b5db42bd7b431ea1286eea1a523601,2016-04-28 19:14:30 UTC+0000,3136353ecf8841f2943bd7548056cb04,90275e799320405bbd2521b88a580ee9,1,3,1,1,5
2621,37c6bf8a792749db822a81a0a78d0d2a,2015-11-13 04:45:30 UTC+0000,d6b421e91cd04014b8a53ec2df048ba4,059210ca80d44bc9a63b854fd2111d09,2,1,1,1,3
4001,37d00004b2d748838c0f23326886a008,2014-03-17 15:03:11 UTC+0000,5ffd7351551b42a691e20890e376cc4c,fec9c7d2c98641979665c0e8a0a0848a,1,1,1,1,3
338,37dd9eecd2374084bf9558f77fa8742d,2018-02-16 16:03:29 UTC+0000,16faa411dab34fefae0e800d867c985a,47065177d366448ebf27c034baa9652a,1,1,1,1,3
7697,37f2cd19483e4c718dfe30a7f45fbeb4,2017-11-30 12:30:12 UTC+0000,45351e1950c84de1aa242f40a0a5292d,a1006e6a58a0447592e2435caa230f78,0,2,1,0,3
7996,380108d45b474aeaaf0b72f31e1c9d17,2015-10-22 21:34:24 UTC+0000,d6c63a8eaddd4a11b0f6b0ac58f983b7,36ff3b3666df400f956f8335cf53e09e,0,2,1,0,3
5729,38017f1fbf7b4ccaadb23c92c2d0fd02,2015-04-02 13:36:40 UTC+0000,a9c7aa188eb144e6a285d7bc8fe81160,369f1c8646b649f6997eae7809696bd5,0,1,1,0,2
4805,38168fe71b7245628b16e8e79a0d439c,2018-04-25 17:01:48 UTC+0000,cc79e3c4eb7d4f6790cc509201e87203,fafeba89ca764bd891862fb8440a2962,1,1,1,1,3
849,382c5579c0f542b481fdffe00f78d2a1,2018-10-28 00:35:37 UTC+0000,9fa9d86644a84a4aba4781f040cae0a4,e2b4c84bf1ca4aea9b108869692d8017,0,1,1,0,2
6661,383401950fa349199faa21e12af59144,2016-05-10 01:52:41 UTC+0000,6bb52b013c2140e3ad9be8ae0507bffa,96bbbdd06a334805a0501034d9df1aa4,1,1,1,1,3
7723,3837c7f1c7cd4ff5b3b1151f65273ba6,2017-04-24 04:18:35 UTC+0000,a23ce1b9ff8641f6aef875f5639074df,be5d23056fcb4f1287c823beec5291e1,4,1,1,1,3
4273,3838d0fd35824cdb88c4393510cfc241,2017-04-25 18:50:10 UTC+0000,c2a4018ee21f4373893619f617aee40d,590790f023b94759a262173129bd6084,0,1,1,0,2
2331,3841aa4c89634b3f81b676d584e59608,2018-09-09 17:43:00 UTC+0000,4f223ddd3c5f4a66a551f09e8a3172d3,36ff3b3666df400f956f8335cf53e09e,0,1,1,0,2
2095,38436aadef3d4b608ad089cf53ab0fe7,2011-12-30 03:59:37 UTC+0000,a3316047dbf54368b7da0ae07ada7484,05444a2f42454327b2ac4b463c0adbe0,2,1,1,1,3
7267,3847228c187946a6b6247023fee84c2d,2017-02-03 22:49:49 UTC+0000,97aa8bd4dcae4f9ba240ae495cc605ee,d9bae0de3da04c7ebbe0879d410a8179,2,1,1,1,3
6303,385071180dfd4392b53b33fd7bee1139,2016-05-28 14:01:24 UTC+0000,67334336a6ac487c8bb046eb2d84bdc7,d1f04208de3643c088f4a25e57f1cb2d,1,1,1,1,3
5214,38550801d04c4fd0ae6e8df1194fb2f6,2016-05-30 22:34:26 UTC+0000,c0c3342fa70a443da3d739d325ee7c69,36ff3b3666df400f956f8335cf53e09e,1,2,1,1,4
4092,385f5fa3adc943c69e386529608c1845,2014-12-16 15:07:56 UTC+0000,f5817f292d254e9c81dc07474cfc12f3,94477b1600174ba8a6caf491dbe3bc5b,5,2,1,1,4
2576,3860ba28441946218d62f0f462dd7e33,2018-02-07 14:03:53 UTC+0000,397460682b5040888c7f49f1daccac10,b1759ef11fcc4fa2ad9a58f4d9d9b52f,3,1,1,1,3
3622,3864d33b8fc84cd180ae6bdfd236b215,2017-11-13 05:04:37 UTC+0000,e29af1b547c44ab9abfc9c830a61c48f,dbcb145b0afb404cbe496ae915373711,0,1,1,0,2
1768,3881c8c0a1ed48ab840ee7ab57ba5dd2,2015-04-24 18:08:31 UTC+0000,5f550b0d9cde4524b319fd0ad3897039,ad7fd347a59a4e6384a18c26b022d50f,1,6,1,1,8
5145,388cf27cc3ff41f0a684bdedfdc661c4,2018-08-29 17:44:07 UTC+0000,41cbb0ccfbac469b82a1335e7532256b,714dbdc19d5643d78730fb057922472e,1,2,1,1,4
2530,388e6507c6404d558f7194e58e79cdba,2016-10-31 00:03:49 UTC+0000,58e4c326a2a14bd3a9b28d5ff93f94d2,36ff3b3666df400f956f8335cf53e09e,1,2,1,1,4
2210,3894b2779e744343bd8cac135078f9d3,2018-03-02 04:12:26 UTC+0000,afc90c8534a648bf9dadd8eec031fbfe,f63d4c4f510e41bdb78cb160d104261e,1,1,1,1,3
2871,38a6deed1b0941fe9c357bb3212d3dba,2015-03-23 12:46:56 UTC+0000,10f650935b4e45ae9e3303886cf44751,369f1c8646b649f6997eae7809696bd5,0,1,1,0,2
2564,38b6548e4e8446dba428acc1e6a050fc,2017-03-21 16:02:44 UTC+0000,626042de8e944679a88ad9c7e213121c,8c33363e3cb9495ea5220c40ba1de77e,1,1,1,1,3
3005,38b7af146ad1454f955d421669f51806,2018-03-13 21:32:07 UTC+0000,e208593dc9b146f89fb468109bc6ce20,a6d33c38902546849c36ea7e9e9f0870,2,2,1,1,4
5200,38b8dfd14ad7435685c905f8e6a2b1cc,2012-02-15 22:06:04 UTC+0000,00fcf5db59a54f65b32ce6e0181e2e53,560a4bb63dad4df7b9a81efa29c11231,3,1,1,1,3
5667,38bd1d8444874a77b2922ea66fcfefd6,2016-05-15 14:20:40 UTC+0000,593e452beda3438bb8c07b3382d32daf,58fa5e95fe9e480a9349bbb1d7faaddb,0,1,1,0,2
1439,38da0943d31649e5915d123f453e58a5,2018-02-19 08:59:06 UTC+0000,7d2f06bd63db40aab6ad12f32f3cfd51,09289e37380e4c87a45339a59670633a,4,1,1,1,3
3485,38e95d8796a64a4aa6fae140b1281b2a,2016-05-24 23:47:24 UTC+0000,04cb1ff9485e44d8a26b4e23ad043df8,cbd07479428345098156e554cc5a4202,1,1,1,1,3
5584,38ef42d4cde74d8a9d52553e6b3d7455,2016-10-23 13:11:56 UTC+0000,0f8932b506c44cb1abefb52fc52a0eb9,e79dfb861eef4538a7c38bdbebb4293c,2,2,1,1,4
703,38f4d70f01a64903b6d2fb7a8e55fa30,2017-05-08 16:20:24 UTC+0000,b9d8dcdd722f4271812fa03cacdef320,ac206d639586427b9b1d73c26876160d,1,1,1,1,3
3768,38f6b1a67866487b8707e389231ab4b7,2016-05-29 15:08:27 UTC+0000,742b6528ad304f29a1203516055c7626,8afdf873f15e4d228476c29f9c2b1b5c,1,1,1,1,3
4581,390023cfa3e64f9d933b2293f6a4e01e,2018-03-21 20:36:15 UTC+0000,3308bfc7900a409f8512227d5b4f2242,b1488415466948b5bee3896efbc31fdd,0,1,1,0,2
7627,39102a07c7994a208b77adea1ba9c3f6,2017-12-04 01:53:38 UTC+0000,15ea3b24ac63457ca3b8d2c708244f09,14d467ed629242bcac02ebbc4f8908a1,0,1,1,0,2
6425,391d86e5071b4969ab43156b4351b128,2017-01-25 23:58:27 UTC+0000,dec4ce23decf4ec4bea15b5b9fe32f37,20569e00becc48fc82be8f9db9bd9035,0,1,1,0,2
1519,39206bd1c91b43588ae1a362e9405409,2017-01-07 05:01:04 UTC+0000,8269c235293e42b4911c3568199aa429,a4b92ad459d24dd69a7279da9b01851d,1,1,1,1,3
4048,3933bd9088c743269b1410364fceaa06,2017-12-21 05:09:49 UTC+0000,4d1f0a6e993d45a0ad85cfcbc2e06ce4,f4ff7957655548d4a04f822cf5c41dea,0,1,1,0,2
6742,393454d6d1104a44b6aba776e316c51d,2018-01-14 05:05:39 UTC+0000,af36f12eca21476980e31e22a2e8007c,be5d23056fcb4f1287c823beec5291e1,1,5,1,1,7
4066,394398d2f24e461b92450a90f0cf902b,2015-10-21 18:41:24 UTC+0000,7a72b5ba793543ceab366292b4cdde46,a1006e6a58a0447592e2435caa230f78,1,2,1,1,4
4708,3944b1daf9864287b8ab9d49c88eb866,2016-06-19 22:26:18 UTC+0000,25b62e52e3c24ac6b877ebe4f7097eea,58fa5e95fe9e480a9349bbb1d7faaddb,1,2,1,1,4
3218,3947743c8dea45fc8cc9897c2a8ff3f4,2012-10-01 04:12:22 UTC+0000,79e632e2223e42818b668a66d11903e4,f05b33a454c048f3bbc73f5f3f7f5127,4,4,1,1,6
2225,394953d74cb144f6a7016c66467d55ff,2018-03-23 23:01:36 UTC+0000,4fb5e95389e244b1b8eb4d889d55ac75,887c5a142b42466fb74740d72989fc74,1,1,1,1,3
2527,395993836bea4541ba7bbc3cde6fc5e3,2016-06-07 18:18:59 UTC+0000,efb8c378e4994b149008e339016bfaf7,b7ad4a96122b47fea182dea5cc86da3f,1,1,1,1,3
2823,395c6b0ba91f41118bdf6fd03e7da0fd,2016-07-11 00:51:04 UTC+0000,3377f213f92543d698512d61f23b0b0b,fbfffdeaa5b24cacb0a93a00f93dd54e,1,2,1,1,4
6789,39782d6020ef405cb2a6b58873d35a13,2013-12-28 16:01:55 UTC+0000,3bcc50eb0b7f45f9bc541976f5d387c6,522c6251a46e491a98d4ff989316cf08,2,1,1,1,3
1429,3979a8e04459413da782f6ebaa7e5647,2017-08-31 00:38:10 UTC+0000,8fe4cd29489648fea3e13b906f5c11ab,6d15a722012441489d7ddf6c8ad9dbc1,0,1,1,0,2
4221,3979ed26b2584532b29a48ba3828a7d5,2016-07-22 21:45:59 UTC+0000,c7ddb47c01884640b6ff807db8394cda,8147e4d83ebc47b689901dc534981de8,1,2,1,1,4
898,397b3a8f110e4c5f9dd8d58956449c8c,2016-05-19 13:56:48 UTC+0000,653daa9755d340288aea792aa777d058,2b37ae0a2587481482f0be9d7b8a9f26,1,1,1,1,3
4719,397c1d96323d49baad2f345b6d898af5,2016-06-03 07:51:27 UTC+0000,5526d18a04894d8aa4275c1d2cd48133,77e432d5e2334e318e16110a6d2986e0,4,7,1,1,9
992,3999175dce8f49b89d733822222595d3,2018-02-21 04:51:31 UTC+0000,f7a0c50dc2914bbfa7bab3977d9b5949,e40827e3bfb54a0aa4a6c538cd1ebb55,1,1,1,1,3
1196,39abadd24a8c4f72a5577c1df2f90d90,2016-08-29 16:24:53 UTC+0000,fa4a1a67fd4c459b82782059a85f9534,a1006e6a58a0447592e2435caa230f78,0,1,1,0,2
383,39b1bd8bcf1745feb818e07123003cc1,2016-05-21 05:25:54 UTC+0000,68b0f0292a704435828e9220d0c188f7,6febf841fdbb461284ed1d30223a1366,1,1,1,1,3
5426,39bbdc3be4c4413ea6799c5789d91a5f,2016-05-16 00:07:27 UTC+0000,4c62432167394398b3c8cc00b64e0a93,37d4b429b980468e9e63b133c2c77fa2,1,1,1,1,3
324,39f5347e973b486d89ed65113d0c047a,2018-05-31 22:03:28 UTC+0000,61166a31380642548d26d1f14bc15329,05ab77d4c6a141b999044ebbf5415b0d,0,1,1,0,2
5702,3a006f5f758c4487a26ca33ede0535ea,2016-05-06 21:25:13 UTC+0000,e5b4e6fabe4c4918bb7c3bc63d0b69b0,b45e7851aded479a92282ea3c66300ab,1,1,1,1,3
1960,3a39656869654067a9612993de5f557d,2015-03-25 14:37:58 UTC+0000,485da85fb3c840c5890128707ab8d9d9,851529c3f8664de4a5028e8312fe3488,1,1,1,1,3
6029,3a3b0a426b1e45689a18205894957298,2018-03-30 07:37:21 UTC+0000,4ec3458b7ec545a8a2042dac1841f770,d79db633f7884a9c9588dad5ed184d87,0,1,1,0,2
1871,3a3ebe4f34fe4441b7efae63aae14c8d,2014-04-09 04:11:01 UTC+0000,ad01fb3cb05441e3902f9c916ef29bb8,4b7737cb8c46400795bdba3a4f333997,3,4,1,1,6
2626,3a4dc6e136e84280a3e48e37d8ed6550,2018-03-21 02:37:36 UTC+0000,9108269159a44c04a2a40cf60f0ba91d,a65587cbd400485b9c9643698f764ff5,0,1,1,0,2
6683,3a81573a339b44af80e88a049ad37dbb,2018-03-01 16:57:49 UTC+0000,41ff5f4bfc96474ab48e744364268d1d,598351eefc5d436dab91070c7a0e6ba1,1,1,1,1,3
5486,3a87be6f34234d3abd044f363435df9b,2017-09-29 15:47:07 UTC+0000,f0fe9a04560d42f697b60534d857d578,f4d7b4c320ba41989ea614635ffe6f06,0,2,1,0,3
3597,3a8bbb03608940a2bf3f971f9239ba2b,2017-09-12 22:59:20 UTC+0000,764d743f35e04ba29299dc50fd4a475d,c285b983f2bd4893ab9c5b25930a82c9,0,1,1,0,2
2921,3a8d42c5c2cd40ae84a5c7a574e8bcde,2017-03-30 18:24:44 UTC+0000,9bdf87bf7bd24daf94c5385f58297144,369f1c8646b649f6997eae7809696bd5,2,1,1,1,3
2283,3a9aca9b64d74c598b12ef1886671a5f,2018-04-04 23:25:15 UTC+0000,c114be9101f04ce187e943e5ab029c90,4dc61581ec7b409bbd037e483f53ba0a,0,1,1,0,2
6256,3a9de0cee1e44c40bdd8737627517851,2017-07-09 17:41:08 UTC+0000,923036f57d22412a96c4e5b16c70bc7a,c1bdc3d063b14ad89b4fed049bd92e06,1,1,1,1,3
219,3aa78004b3ea418b85b12c5389781158,2016-03-09 23:52:03 UTC+0000,681c304fb08f4db488e4ee9921d62cbc,eb7c9e19fb4c4e6ab4a0bbdcc80487e6,0,1,1,0,2
7690,3aaa80fcbf7b4d6a9590675b603ce9b1,2017-02-08 07:48:50 UTC+0000,a03fa7fb55a84a25b3e4f36599937611,b91618eebcdf4832b71482034d6ffd8a,0,1,1,0,2
293,3ab0dc2b747747079f189172e34acf51,2018-01-12 03:57:30 UTC+0000,a4e2969a2b9b46f680de8eb341f0b957,598351eefc5d436dab91070c7a0e6ba1,1,1,1,1,3
5235,3ac1052387a045d2abe625c7c8fdf9c7,2014-12-01 19:36:14 UTC+0000,51af80bc3fe244af9830c6b66758fa43,ec97070fe75544e0bc5888f9f6120822,2,1,1,1,3
7026,3ac1a26fdaa0474fb41a5f8d3ea4b991,2015-06-25 13:29:37 UTC+0000,9e4bd2275e9c45fa955b3777b269e203,a1006e6a58a0447592e2435caa230f78,2,1,1,1,3
2742,3acc49b947ea4d32b49f86d3f7ad6a5c,2017-03-10 00:56:12 UTC+0000,25f7136a56dd459d90a29b2e784ba341,88f5cd5a4c34423e9e69fd6445577d17,3,2,1,1,4
4712,3af403c7fe964d22a3e8e489f9338b4d,2016-05-18 19:49:19 UTC+0000,ed081daf40cd4dedb633bdf42e378ae0,7667c23d26ab409ca3e49758f5367925,1,1,1,1,3
2156,3b01ce20b7cc428c9356740091e3b3dd,2018-04-16 07:59:10 UTC+0000,b0db5770cc1d4403bca138853ec88890,e44c2855fd6649ae869fe145d167cbe4,2,2,1,1,4
536,3b0446f249e442b6ac48311025e0a6cc,2016-06-26 02:24:46 UTC+0000,8ab5f9ccb9f34eaf954662274f75e262,8aa7ba4c38aa4a2e88872c1fdad7d068,4,4,1,1,6
3577,3b21562e73b04e7d80fbfcea5e5dc7c3,2018-03-31 01:59:29 UTC+0000,2dec8eebf5ab4ed3b82817e58d359504,39ffead2fea8458c97794a4f97aca75f,1,1,1,1,3
5730,3b2a403dae444fbca91bc17d9c3ed28b,2016-05-29 05:24:33 UTC+0000,04eee3be8e074a4bad9dbd83741e83ed,0d4cd29c55c64547b0488a9cdcb218ce,2,2,1,1,4
2281,3b3934ae73dc4fdb8a76493a7e56fa15,2016-04-29 14:43:20 UTC+0000,be9cd93f24af466399a31ff50ab1f0cc,369f1c8646b649f6997eae7809696bd5,2,3,1,1,5
1700,3b48d16b864b470b897afda13039f4d8,2018-03-22 18:48:08 UTC+0000,5d05046114494dd6bdcd72c44731399e,96ed93bcfb6d4a2aade68c91520b9994,0,2,1,0,3
4645,3b4fdd5a8b4a47128c763849ba8ba5b0,2017-01-30 19:45:42 UTC+0000,40edf704021f4e6d984f612a049b01e6,2d7ae1af0e3c408d85789cac65998bd4,1,1,1,1,3
4279,3b51bcff79f04e67b507ca9254553220,2018-06-18 21:04:08 UTC+0000,160c2abcb9f74df7b8288fadd483b043,e04a638db2b8433bba8e95e3acf75734,0,1,1,0,2
4686,3b5b701b2d6b4bae8f8e80a741cbb029,2016-05-24 13:31:07 UTC+0000,82f15ba145f0455ba702c255f3146c79,1f8d7bfab2b84da092c9d2b22f1f7c4b,2,1,1,1,3
3369,3b672d422db242a7a380e16379c80158,2014-04-07 17:47:21 UTC+0000,4eb31a730ef14d0fb68f075f5226a63d,fb55b95b86da4e7184c6abff35f432ca,1,1,1,1,3
4390,3b6cd6e875dd4cf485070c4c5894b686,2015-11-17 22:08:52 UTC+0000,080c24f35c9c41f7a4e65335a528dea7,a1006e6a58a0447592e2435caa230f78,0,1,1,0,2
5565,3b6ce330efc4427f8fbc5bc38180a11d,2016-04-17 00:39:24 UTC+0000,7211b1dfb96b4ac587dcfc624927814d,58fa5e95fe9e480a9349bbb1d7faaddb,0,5,1,0,6
5298,3b6e596da4464f6b88b78df936f6a42f,2014-10-21 17:53:36 UTC+0000,644f152797804dca93c8cec013033a12,05444a2f42454327b2ac4b463c0adbe0,0,2,1,0,3
5505,3b80c90607b94bcebc0795ec7f5a8f5c,2015-03-19 21:21:21 UTC+0000,840d98b7a9b24111b455c448873c8cd7,c1341204dce1463dad3964c3f3f462c3,0,1,1,0,2
3569,3b9836f0d6e44d438165cb76cfdbbb11,2016-04-28 13:03:52 UTC+0000,197df3aca6dd4efc82685f39b78e2204,54976f119d3a42d3ae3d85956c1b6338,1,2,1,1,4
4496,3ba4554440d74103b9a715567f4dfdc5,2018-01-10 18:00:27 UTC+0000,c4420b41d54e4a17bdab6a06d6b17d40,14391021b0bc441f9ca82f1600fc6fb7,0,1,1,0,2
1940,3bb6e149f4bc42c1868fec85da302343,2018-01-02 00:20:43 UTC+0000,669cda253239470d836be31f2f8f26c7,be5d23056fcb4f1287c823beec5291e1,1,1,1,1,3
3816,3bb8c90cc5af470c95d7d11925babcad,2015-05-13 15:27:06 UTC+0000,9930a6d7477f476eba4e751710614230,da912aee2ab0444f91c1391a2a274fa5,2,3,1,1,5
7695,3bc6f8ee03e9408db41defb92f03e91e,2012-09-07 19:12:43 UTC+0000,eb00049a353341ddb604e9db07e3cc1d,7d425e8d7cfb4fe7b0702fff4d6d84e7,3,3,1,1,5
4624,3bd1c583a58d4980bccd0bbc16859dfc,2014-04-09 14:51:51 UTC+0000,bd907434cc074bc2acb14f33e36b2e04,0dc4c381bda94701a967703ccec5c676,1,1,1,1,3
4185,3bd3f45588ce4c84bfb4e7f9db41f856,2016-07-11 15:52:45 UTC+0000,c2913f5203d3485884f0d8c8f0589ba9,369f1c8646b649f6997eae7809696bd5,1,1,1,1,3
7404,3bff6d7b2a2b481aa5bab34ecefc7f54,2017-05-26 12:59:28 UTC+0000,9e888281b3ce4e338b51ae066b23130a,416321b48a634ac8a53602625f0a5d40,1,2,1,1,4
4834,3c04fe4cb9bd4148a83e5c656984d443,2016-06-26 21:10:48 UTC+0000,33f12df61ec04b53bb4394ca7d9c1ec3,58fa5e95fe9e480a9349bbb1d7faaddb,1,1,1,1,3
6002,3c0e0ea7b3e74343adc63d65a8004df6,2014-03-27 23:06:53 UTC+0000,7651a9f4b1464fa4b374ae07e6efeb5c,031c50365c1145c3a435627a74732fe1,3,1,1,1,3
6334,3c1489f733b74977877b6274c21f2124,2016-05-09 18:56:57 UTC+0000,0a94206cae0f4e0ba54a60481b1c0639,369f1c8646b649f6997eae7809696bd5,5,1,1,1,3
4243,3c2a4d7fa38b48e6849f4e424d1302ba,2014-07-18 22:08:21 UTC+0000,277f690615924000988f67920b52d297,096950ededde4936b7f6bb8c68eb404b,1,1,1,1,3
2759,3c2f944610264f57bd9674472728c039,2018-11-18 02:02:42 UTC+0000,6ed268c752de46e4ae08a31e7ff8ff8c,9a5aead62c344207b2624dba90985dc5,1,1,1,1,3
7536,3c67fe4c6ae7436da526c19b77465d5f,2012-02-22 05:08:38 UTC+0000,755645a449a849f3834d4ee1cc456f26,7e3c5699bd2944ccb93679c6327ce02b,4,1,1,1,3
6817,3c68d55cf32e4a719331a81e5a36970d,2016-05-22 02:27:05 UTC+0000,8dc6c4cafbe548028405fac59003ccce,58fa5e95fe9e480a9349bbb1d7faaddb,0,2,1,0,3
999,3c77d59189854105a7570d58bd7fdc99,2016-05-04 18:42:45 UTC+0000,25a22aea7a2a4956b9ea2f56923231fb,2f152a99afa744e08f24a389ee3f9566,1,2,1,1,4
3849,3c7fc6f4cdec4048b235f1e6666d3f9d,2017-02-11 22:12:56 UTC+0000,ca105863a7ea4f25abc4ef6c2846abeb,588f357fb2f74666b4fefbc9c6564b24,1,1,1,1,3
7920,3c8a3cae67c049d1b4a68bfdb5cb10fe,2016-05-17 01:52:42 UTC+0000,987fb30ac6744b73b2dc12d0bfa7cd8d,615df443c1894cb8896f3b991dc9e695,2,1,1,1,3
1457,3c8ce38f0379436ca5d813d6f76eff1a,2015-06-18 18:09:56 UTC+0000,14906fedfe64458a9687ae0157dcb861,369f1c8646b649f6997eae7809696bd5,1,1,1,1,3
2325,3c989d9e8a1b4a8ebb6f76619e0864eb,2016-03-09 23:29:01 UTC+0000,f7f472a2f896404086df7c9afd7dbc9e,e1f680fc6bdc472dbe3024f7bf1aa290,1,1,1,1,3
1115,3c9f336064d44328b52975a03ebf41eb,2016-06-18 03:13:14 UTC+0000,06b4f5021ebb43cdbb427fcf6613ab29,eb5d30642c3b4099a74c14728fd2ddf6,1,1,1,1,3
4232,3cb083bcafea49c8babe6ac329720ef8,2013-09-30 18:21:27 UTC+0000,58435169bb7c4a068677a567a730e05e,207c8c62bcaa4033885a24a8a5a10d51,4,2,1,1,4
4208,3cbbf8196bd843ceb76d7d899abb4a71,2016-04-11 22:13:44 UTC+0000,a9a8d1feb53d450f8e9b4938521dfdac,fba595034c5a4f3aa27c3607b19eea39,1,1,1,1,3
3955,3cdf0e781f454065bc5dd40a1dca4cb0,2018-02-16 02:03:54 UTC+0000,1869cf34e688425e92a8756c2f68bca1,cf4d747b013247c08775128477da5502,2,1,1,1,3
10,3ce0219e016841b8a4d9445d81363d38,2016-09-13 02:55:56 UTC+0000,864fbfa16c104edaab617f34e30a5f63,58fa5e95fe9e480a9349bbb1d7faaddb,1,2,1,1,4
2291,3cfa9354f717443f8b45269bd56948d7,2018-10-11 00:47:32 UTC+0000,1018c23b6f4f439c85fd1d8b2ee84738,be5d23056fcb4f1287c823beec5291e1,0,2,1,0,3
1942,3d09c6aa0e494a7bb35d91ac0767f98f,2017-01-31 03:27:00 UTC+0000,7dfcc362e4064acda356612c0c6751d5,e9f934aa9e374beba90126789f696862,1,1,1,1,3
2007,3d0bb8f8cac74188a9756d6305818d63,2016-05-07 19:16:24 UTC+0000,c223373460cd4a8685c4a92870c90c9c,e1d39b665987455fbcfbec3fc6df6056,1,2,1,1,4
1604,3d0d596093af49b1a0a188e56b97cdbd,2016-05-04 13:49:17 UTC+0000,e0236b62ef044c9db72eb7bfe6232e8c,db92e0b1c9ac42a6a83c9f39f0f0e831,0,1,1,0,2
1262,3d1d8d43b4e84d339913b7ba7a904164,2016-04-28 16:06:19 UTC+0000,9830821a3ff1429caa05da803a6c094c,629b2326269b44f2b691d3c8be7011d7,0,2,1,0,3
6895,3d22742052df4989b311b4195cbb0f1a,2016-12-07 13:55:23 UTC+0000,4df3831b87e24029bbab9dd6591a8625,0b17f4e9d93c40eb9a5d087865084ce6,1,1,1,1,3
4298,3d3bd6ffe26946e3920496cfbd361cc4,2016-05-20 19:06:57 UTC+0000,0a6c3008b5f34c308ed29a71e010720d,f96f59f78b4c4c4dafff870b194d8794,1,1,1,1,3
755,3d4474c8e7414d5aaa960b8ab98ee878,2018-05-15 20:15:16 UTC+0000,1dd1e0fc041c4db7b7fdb73999a423b9,7af4f0860bcf41cf87c94145815c8abf,1,1,1,1,3
5236,3d48c357569546b89448e3cedd7f8096,2017-04-17 22:25:00 UTC+0000,84f112511f4b4e62862dad6061e28bde,c5c2ca95fcd3463a8852b8bc9d636313,0,1,1,0,2
6803,3d71d8c3b7244013ac307416d00c0ada,2016-10-25 23:36:55 UTC+0000,0273c7535c1b40d3b8d29211ba329c72,a41eeb74c7ad4310be0a166d3dac3d12,3,1,1,1,3
7553,3d758bbc1e874d1ba8e98952b76cf030,2016-08-10 12:54:59 UTC+0000,06f47b77bdd64872a34c4630f7ebccfb,a1006e6a58a0447592e2435caa230f78,0,1,1,0,2
2754,3da6ee22b82643458f0c9d97a88c524d,2014-03-26 21:19:59 UTC+0000,1567899256a5479796fae3f903640f84,3d8847ddc8d04185976a9e78b190ebdb,0,6,1,0,7
1900,3dc167be15be4390a07dc1828f4017ca,2014-04-22 23:36:20 UTC+0000,08b1c712d79f4e4f8605693d1c94df89,e4e7cc05a0b64cd6b02168d404a45d4f,1,1,1,1,3
6257,3dccd3df1e6e4d0bb9a2de8c7e211c41,2016-05-13 21:24:17 UTC+0000,b7361ee57fbd42aca4d8893df286a268,d3ba15fee0584d72971b06fb5cff6fae,0,1,1,0,2
3543,3dd22832a3cc4960a675d2d2cc6ba369,2014-03-20 16:03:06 UTC+0000,3645856aecdf4aeb9a5d10f22733d158,95f1104e8b604c98ae237020a98921c4,0,3,1,0,4
2082,3dd3ece061e94aaca316adddc3319f0f,2015-06-16 04:00:12 UTC+0000,52d0138341294cfbaf38cb746d8bc6ca,e6a4eef948994bd7830b836db188d982,1,1,1,1,3
4890,3dd9a7e4b02f4f1a87859b1a052c7e1d,2015-01-20 13:27:01 UTC+0000,99d1efcb4efd48d3be7b2cb81a47edbb,95f1104e8b604c98ae237020a98921c4,1,1,1,1,3
3696,3de5505c143c472b8679341e8fe87fbe,2014-04-08 20:35:25 UTC+0000,beb5a0f005f2462cbb40f953da848484,c84b7719b1e14c80a5ad3ab52dddad3b,1,2,1,1,4
1018,3e1d69f77f2c41a580ee5336dc497a4b,2018-05-30 16:40:56 UTC+0000,177f69ac8a5e420abb4f7d1a7b09727e,e250f84df134459faab2187e01c1b39e,1,2,1,1,4
3555,3e44a095e84442bea318fa047e9d4b33,2014-04-07 21:50:26 UTC+0000,c57ef07bdff34b8cb4f7421a0fc4437f,fe4543418c0846e5a65fa22b4ad9a304,1,1,1,1,3
5708,3e49353c1b9d4884809b04a8ffa6ebfb,2017-05-30 23:35:07 UTC+0000,91143fb544ec4fe8a84f0a832c935fc6,ce331ab2f21e4b1b99cbbb6383566612,0,1,1,0,2
2984,3e5bd2d7ea224be68a30b3caf1ad1bc7,2016-05-18 00:19:45 UTC+0000,bdf0f476a02e458c9d9e2e5da4ae4f85,0d4cd29c55c64547b0488a9cdcb218ce,1,1,1,1,3
7940,3e63b0dd6c824fbaa778c75ed68a312c,2016-05-25 02:39:41 UTC+0000,5f5d9d39a09a4a9caadb03b24a981586,e00ca8adf6514ababc3d1d4548fa36ca,0,1,1,0,2
4973,3e6c397c333d46069faf6ae72fc88c4c,2016-01-14 00:40:23 UTC+0000,d49c9cae008e434289b140fa4ca47ef1,7ce1f48d64cf4a42981fa4fc68b92bf6,1,3,0,1,4
5167,3e6f5818bc704175ba791ddb3a552598,2018-03-02 00:26:28 UTC+0000,024de27c3ca141de8d1c89e48cf0e971,49e2beb688b648fcb3373bcee71882d5,3,1,1,1,3
4062,3e7352bddd5449c2b289a0f497e9b019,2017-10-04 13:37:22 UTC+0000,0ec4b7b70e8e49ea8591f5d090a5993b,8dcef0937fe345d3bbf4cdfaada8ca5f,0,1,1,0,2
7183,3e7fd559e87f463ebfa83479275fbde5,2015-10-27 04:47:12 UTC+0000,34ce091ffde64d34ba2ae56d24143a33,1731d1ea92604b7ebc5fbf15a221cabb,0,1,1,0,2
634,3e9dc99917284b169e65b92cd033c062,2017-02-26 00:35:33 UTC+0000,2a4aa697317c4b3d99de860a7904e9d6,88fba04fb7bc42e6ab416599067f6440,1,1,1,1,3
6140,3ea756e7fe39401abac249083e2f4204,2015-05-18 16:33:14 UTC+0000,f45045bf93b4442d968c76afe0e617fc,a43da325b2b94c99a5f8996693970578,1,1,1,1,3
3777,3eaac77e744e46faa3ce2c966fb58d69,2016-06-23 09:33:30 UTC+0000,c8bc0bf7118246c8920dbf38dca62f35,c85420d41be7444d9588f806457025b4,5,1,1,1,3
5850,3ec43c33c40f43b3b6d5db74f02e4318,2015-06-24 01:23:55 UTC+0000,6d31b919604d40fe879c4c104486666d,c1bda2764ee642b3859b1ca6839fa16c,1,1,1,1,3
3677,3ec500dbebbb4fa9a745b552e31312e4,2016-05-10 19:43:25 UTC+0000,2c462e174da04f78a35ee057972122fe,4ec0d3e50a904c70a323dbf097e2c9c2,0,1,1,0,2
2486,3ec713f8dc0149febfb7e2d9da194df8,2014-10-08 16:20:31 UTC+0000,982b92ad67224636bf04bae2247e1069,0522523631e7499186c2a4ced87e8d98,2,2,1,1,4
1623,3ecb4bed1c34488c9220590ab9091096,2016-10-31 20:44:03 UTC+0000,62ea3377dccb4e0f986f773042fa8bf7,d08e3c1adffc41e0a1ab2e7212cbb20c,1,1,1,1,3
1721,3ed427a8627c484b850054ed73ef9e46,2016-05-20 02:42:19 UTC+0000,15c4bcef750847cba391554932fb3e8d,08f4c4808d8e4eb1b9b287cda01beecc,2,1,1,1,3
5082,3edb4f649f7c4bf6b7b779f2d3b39fc2,2014-04-08 13:45:26 UTC+0000,89059d20700a4d3580b2ebbaf4f5b6c9,5f4c8c5868cd442e8e0bc218b9a10e03,1,2,1,1,4
1272,3efdae282acb46c6aa28abf7b6baa07d,2016-04-24 22:48:27 UTC+0000,1b23808d42ee4d50a490a6126ce864ee,e2c160ebc83b4f93af07af4850f0ae4c,1,10,0,1,11
1767,3efffd7adfea423988d411b2915f9ea7,2018-04-06 23:49:12 UTC+0000,68a44164518d491f8d6a930180c5c5cc,fb58aa2d8fbd40d1bc7602f7b81437fb,0,1,1,0,2
6643,3f05163eae6a4c979d722b9e6bbd7fc8,2017-03-04 21:55:18 UTC+0000,af63fff9fafb4946831811cdc7be8fc3,36ff3b3666df400f956f8335cf53e09e,1,4,0,1,5
5088,3f2036d6fe8f438d8ea3ef6b00edfe84,2015-09-28 00:09:24 UTC+0000,730fb208ffbf48b99b651019908043f5,f8c639fbd3dc4ecd8c95bf2265943ce8,1,6,1,1,8
7530,3f34ecef9f5a4627bc505ba59b67f870,2018-02-24 02:26:16 UTC+0000,7a25d50d9fd84d848b22da5eef5e374f,cbd8f30613a849bf918aed5c010340be,1,2,1,1,4
6982,3f361d488e7e45d194c00b46aeb4b27f,2018-03-01 00:48:57 UTC+0000,b195a16b5bc94cb78cffde4de29a5dac,a312530651914fbebea9289e3c0ce82e,1,1,1,1,3
2135,3f3c53facd64467c9d2eb5ee4307e18c,2014-04-16 08:10:13 UTC+0000,573b02b214bc445db3004dfb0c842283,fe4543418c0846e5a65fa22b4ad9a304,2,1,1,1,3
5489,3f3d600cfda94997bc24262ae5ece635,2017-03-13 23:26:04 UTC+0000,de58a9b68a55465fb5c824b8a4fce44a,a1006e6a58a0447592e2435caa230f78,0,2,1,0,3
5725,3f488da33a0a49fb8d7004846e1a1a7b,2016-12-25 02:51:03 UTC+0000,431d975c7ca04f8ca10e4233f344874f,be5d23056fcb4f1287c823beec5291e1,0,1,1,0,2
6501,3f675eea7a8443148fdd1630bd02af68,2016-05-21 19:22:17 UTC+0000,1bc7703b182a4ede805b8a44fb6e7aaa,58fa5e95fe9e480a9349bbb1d7faaddb,1,2,1,1,4
1706,3f78336def9447e89a140916ee452582,2014-04-23 00:37:38 UTC+0000,7ac50b2cde9e44e9976a33ba1124d9b9,0dc4c381bda94701a967703ccec5c676,4,3,1,1,5
339,3f80d90aff3e4939899017bb6adcd1d1,2016-06-10 14:13:06 UTC+0000,9ac9d252fa0646ec8daedcf0bbf90998,ff506465780c44b8a1a662517ca7b04f,1,3,1,1,5
5986,3f823ef5c369446ea9d1b9799272b82e,2016-09-13 02:52:18 UTC+0000,0af4e6880d4c40699c241fc1670ec50c,58fa5e95fe9e480a9349bbb1d7faaddb,0,1,1,0,2
7772,3f98e8f5d08e4fe28a119b99fb46bcde,2016-06-13 03:51:58 UTC+0000,36802287157f4188879056607d456619,58fa5e95fe9e480a9349bbb1d7faaddb,1,1,1,1,3
6241,3fa39c3659124c21995fce049c075e4f,2016-05-16 17:28:56 UTC+0000,4f0c9745c21d4927b8ca992ecf8fa69a,a14d2d2cc61d4275a722eeb7204cda90,3,1,1,1,3
6261,3fb16466c4ba4785922903f2bf2e64ac,2014-10-17 21:47:22 UTC+0000,f57c912e371b4576a61e54fe86ad2e2e,95f2d2db12624c538deba2afe8875fe2,1,3,1,1,5
3017,3fbc98b919c349dd91041a1d69644860,2016-11-23 14:59:48 UTC+0000,935cdd74ffcc413caa8d85497023000a,ab0b1c1190a64715b0433885d5c88df1,2,1,1,1,3
3606,3fd6033e306b4075ac1eabf1e40e7d17,2014-04-22 03:17:04 UTC+0000,955f2d32c6974812a855ffa25a636a93,fe4543418c0846e5a65fa22b4ad9a304,1,2,1,1,4
4769,3fd95eb856a249e9a74006fdea6e986f,2017-01-06 16:39:13 UTC+0000,3ded78bcdf49417988e773ef979f1f4f,a1006e6a58a0447592e2435caa230f78,1,1,1,1,3
2675,3fe0b50f06444a2489e1ae707afb74c1,2012-01-15 19:21:09 UTC+0000,4570cb0d84d6478bad46e9b1741e4ec9,1ec14aee9311480681dfa81b0f193de8,22,3,0,1,4
4943,3feb4cc937194b92b0af017db4ef2935,2017-02-15 20:46:48 UTC+0000,451cca37a3e94c3aaca354a5e4086a66,36ff3b3666df400f956f8335cf53e09e,1,2,1,1,4
7115,40618d8475a0473486a40c9dae6178d2,2017-02-14 17:46:42 UTC+0000,641eede148ac4a3083fe99f96109157f,31b970c9dac24e0d95d451f9dc1e63b4,1,2,1,1,4
572,40808174cf26471e9b37fc79b41ed7b1,2014-04-30 23:43:29 UTC+0000,ea60f7ab83ec4807ac9a4318ee53816d,05444a2f42454327b2ac4b463c0adbe0,1,1,1,1,3
7473,4091d04d97d9419baf68577a0db60425,2017-01-23 22:16:23 UTC+0000,177f05a6132f4d5eb7d84c5f624d491c,c423b56f85034f50a12b0a8600ac6e19,0,1,1,0,2
3392,409e5d1ee411419d9842bf0f40117f2a,2014-04-28 16:06:07 UTC+0000,e68325469d6a4f09bfa133e972469e11,18237fb03c8d4d368085a5dd67c5307e,1,3,1,1,5
4007,40aa246c6d6e43e098a7374b8faef10a,2016-05-24 00:34:13 UTC+0000,5bb5c146614548de92595f9943713093,eb15c50494664ea18365288a779271d8,1,1,1,1,3
7855,40aabba5e4ca4a4ca082290f66c6481c,2017-10-11 15:39:52 UTC+0000,cd45edf9e6f94f799058723a852666d6,819f3ed1c1da40488a9d0c794d4daf61,0,1,1,0,2
5711,40aee9205a1d47339ef516e9d3086725,2015-11-01 15:41:54 UTC+0000,684bc5fd719b465f9c4e20163c38c681,5eed660695c44c538500311f4a46add8,0,1,1,0,2
2749,40b5dee4b2fb44fa8875bb02fb15dece,2016-07-12 00:16:25 UTC+0000,5e6217dd98f343a583b8f8d8bd0e3b0a,4bbd6d03e36b445198780896632a01f1,1,1,1,1,3
1527,40d2105138e44e8892a19cecee4ada7d,2018-03-23 17:44:48 UTC+0000,11389ab9a5ef41c9afb91251819ecf90,a4de076b955d410896bdbf7a986ccc38,2,1,1,1,3
5293,40dacf367ff04f578be7ac80ff846064,2015-05-28 12:18:35 UTC+0000,61aebbd87f41468b8729c842073feccf,949bc8e496c140d9b9f4000c979c5195,2,4,1,1,6
4666,4113a50bc0654251a850de4fa12079b0,2016-04-21 08:16:24 UTC+0000,7c6486d0979f45c583ab5fa4f2a7b1e3,30504395c3ad418bad5de2954ab8d0fa,6,7,1,1,9
5113,411915b6a6934d0798c2f00fcad3b6db,2017-03-29 05:52:27 UTC+0000,df43cd16810d4f748b3909b68866b8fa,7c70cf276b444d7ea40d37aea39289b6,0,1,1,0,2
187,413abf119f9a4b769ff900b326296e6c,2018-05-11 21:31:55 UTC+0000,b7fef80b4023468d8bc3cedd6415c09a,527bc8c35c8541f898bac819b29beea5,0,1,1,0,2
1508,414bac75bc5443069ec43216f5240505,2018-10-23 00:25:05 UTC+0000,e40b3398b40c4c9695d924fa785db83b,9221f63656ca4e8d9fbbac486a4e4292,0,1,1,0,2
1755,414db31a9e3b434f81fa690bb30bd4c6,2015-05-19 20:11:13 UTC+0000,7d713089cb7a4b5abdf6fa10a291d096,88a5a403a1184b23be37d56f0f042fd3,0,1,1,0,2
476,414df469eba04796800df2f56dc1f142,2015-03-17 15:36:24 UTC+0000,a7f7e8fb7cb74b71bcfe467fa63234cc,908851a577b14d88a65dbc87e8c74123,2,1,1,1,3
6190,41572998506341079c40bf527147a881,2014-03-24 02:51:59 UTC+0000,a2684cb248984897b401be6431754c6a,cd33fd35feeb42c8a8683c74dbe0894b,2,1,1,1,3
1007,41616e3b507740d2a11942a7508abd21,2017-03-16 20:27:01 UTC+0000,2613944d159d4d20853a01cca2a7fa25,5f95b0ac821e4e8e9b4fa9fc8eb9ff61,2,1,1,1,3
1605,417cba3ba6a54a3d94b3135fd70f257c,2016-04-17 05:20:49 UTC+0000,a41e095075b44b46a5ad92ccfc9f70e1,58fa5e95fe9e480a9349bbb1d7faaddb,1,2,1,1,4
5213,417fdf9f339748bf8e8d063f0fdfd2a7,2018-03-01 04:44:19 UTC+0000,0c9b3dc5c4814ed887f9d1709cb8fc2c,a5e970f1fb4349c1b1e583c39cbe9266,1,1,1,1,3
4705,4185e257adb2480499d346c75cc97245,2018-02-15 17:54:36 UTC+0000,90d976d9a04e479a936922ed5283e438,b82bf33d61f242409123d2fc58776ed4,5,1,1,1,3
1889,41a8355044da4fa69d46178367ad9374,2019-01-06 15:46:03 UTC+0000,8090e331cabe4ac8b56c10708318edcd,8d1b8036728c4067a04086fb63cef4f7,2,1,1,1,3
4953,41ac0a2ebe3149d8a5cccc3d33549132,2014-03-23 15:16:52 UTC+0000,21e1279bfe564dc6b861e83200284e3f,0eebb6c7f960452fa457747129577f85,0,1,1,0,2
2255,41be0b72ce004e8f856dcf63a71b8d56,2017-02-18 23:50:02 UTC+0000,c2e14e1a8c634195bb574361854cf015,5a07ab57f9ff4bf68de55b4f7a48b4f5,1,1,1,1,3
7429,41c8727205be491eb5ed08d0ffa7d56d,2018-01-28 23:04:44 UTC+0000,f8fedbcab90a44f2aa4c484e55f5bf4a,ab92f9faf7f64001ab6971eeeb6d200e,1,1,1,1,3
1424,41cd5860a4524436b52c6cc635d651ee,2016-07-10 14:33:51 UTC+0000,6f8c5e754fd6415d9bd88952bfc065e9,58fa5e95fe9e480a9349bbb1d7faaddb,1,1,1,1,3
5308,41d05d202db64eda90bcb5fd302bbf0b,2015-04-27 16:13:01 UTC+0000,b05a99898c9541d9a27dd896ee213ce9,f39d71637b864dc9b5887973a3147783,0,1,1,0,2
3463,41d59834f1ea45e5924e99063c639cdf,2017-07-31 22:18:52 UTC+0000,701bb8be7b1d49bb98e046c4ab2df093,932072052d8346b7be8de2c325b46b1d,2,1,1,1,3
7068,41d67c27e2f44e718d8f3d74bdcb602d,2014-03-23 01:59:55 UTC+0000,42bc70b3e15a4fa99f0e2ee100ed5824,b688e766eed04a37b7abc9218aca1ce4,1,1,1,1,3
7829,41dc803bb508400eb2819b31ff3ccfdb,2016-05-05 04:57:11 UTC+0000,9f7e379374a245eb8bbc7b3aa5c5b62b,3843a956582a434eb0ebee396a71982c,1,1,1,1,3
3332,41e218a340e547f89a927a23d333e48f,2016-04-17 13:56:43 UTC+0000,00ee4c14b4af46429e134283320f9849,58fa5e95fe9e480a9349bbb1d7faaddb,0,1,1,0,2
7353,41e2a4917b9e42c2944015624984ed9f,2016-07-28 13:33:29 UTC+0000,4c54de2a83b34bdd8c9d49ce3dc5d1c8,e9f59ac3b7b54c18af7a01c111d876f7,0,1,1,0,2
2226,41e7a9dcab1d4e0c8cc4c9dab5ea0f88,2016-05-19 18:48:36 UTC+0000,f7e8b01954624eb5b430edfe57a16298,9d3d0927a8684e179eaf640c9dfd66ac,1,1,1,1,3
1189,41f5ea8f3056407daba6f87399042c26,2015-11-10 23:35:24 UTC+0000,dd37059df1a449cbbb262d2cf6dcfe4d,a1006e6a58a0447592e2435caa230f78,0,2,1,0,3
983,42099e3cd1bb4236831a92d27b4f3283,2018-03-14 22:01:02 UTC+0000,ae47dbd580b5464c816db39be89c0404,887c5a142b42466fb74740d72989fc74,1,1,1,1,3
4453,4246ab411a904c8cbece303c9627ff20,2014-04-08 01:29:36 UTC+0000,55c5a04708204ebcb95723e5df944b2d,0dc4c381bda94701a967703ccec5c676,4,7,0,1,8
4107,424d2462d8164dadb50558b2d280b583,2017-05-31 19:13:04 UTC+0000,44e34585bdcc4e7fa8242bee443cde35,4dc04945263c4e13a43025ab8e5a53c8,0,1,1,0,2
6861,425e71feee35456a9fd4373beed30534,2014-11-04 14:59:03 UTC+0000,8e1f958644bd4d34b6a4c086599ddf0e,6d3aeebadc6a403a814b2ceafd79862b,2,1,1,1,3
418,4261a8f63aa645aa87856cea302242e3,2015-05-12 03:05:13 UTC+0000,0c804db538584e4abd41e7ee726a1822,70ffae634cf2427cb5c2baf3e7478097,0,1,1,0,2
7137,42679b12a55a42a895abb774b8acfdec,2018-02-28 20:24:33 UTC+0000,52e5387de4174a2c902886fd3d343c2e,458efe7ee61b4efcab6c46dcec7daf02,1,1,1,1,3
6020,426ad419509e4d3a8c1f2f5452578490,2017-01-13 03:47:37 UTC+0000,e4994ff381684a78b1a7bbaa84c45518,a72bde6ac9e349d195a6d356444c9578,1,1,1,1,3
4803,4270d9a26a6848d09beb903735b0152f,2018-11-05 21:04:12 UTC+0000,9ae5aca0c8f84e9380db20e8993d75ce,a9d82ebbd59f4f239d92d960c86d96b3,0,1,1,0,2
1099,42988a3555fd4216afeadd04385be37a,2016-06-26 17:15:56 UTC+0000,0c08c91eb24e450d906383556da3b295,58fa5e95fe9e480a9349bbb1d7faaddb,1,2,1,1,4
1792,429d0a1379334ff2bdec86bdba5c211c,2017-02-14 16:10:22 UTC+0000,23ff4d749a27430b816cd30a890810c8,f64df9b489864952917cb631be1ddac7,1,1,1,1,3
420,42adf4a7295c4d9881496b6a513799ae,2015-11-02 18:54:07 UTC+0000,3c7a6663b865480c93c44639489acbfc,564ef581bed64addb3cf0ff0ab652ffd,0,1,1,0,2
1672,42c8baf9be2a4b658c1ee1eb7a4d3373,2017-01-15 06:26:28 UTC+0000,94de88341bf54c29b1e3b11ead23541b,ead34fe989d9426fbe214db2cc3cb08b,1,1,1,1,3
155,42db8d7107a74e52ae650c6c24cd7521,2015-06-25 16:07:34 UTC+0000,54e036c56b9f45deb7ef7410a7baeb63,89fdcd2a7a944b1cb08b3ac8c1b8a855,0,1,1,0,2
2256,42ddfcbb5fa541ee8eed590e32c28754,2016-05-17 13:32:17 UTC+0000,f57da5bcee48489e85a6d832109b704c,b1759ef11fcc4fa2ad9a58f4d9d9b52f,1,1,1,1,3
5914,43027d624d574cd480ace19be79942d7,2016-03-10 13:34:18 UTC+0000,b21254b6940b4cb7a7e96c76edf4cb5d,36ff3b3666df400f956f8335cf53e09e,1,3,0,1,4
25,430891b24acb4dd6a2137787f1f55c76,2016-07-12 16:48:51 UTC+0000,2f4d391aed8b4d95a22155d8e6091b5f,12e8dea2f3534f6dbc31701cf64f9a4f,1,1,1,1,3
7377,430e5ea8ba9442a497089b35e9bee83f,2015-03-23 22:33:01 UTC+0000,c65e51a6235f4d2ab653bbcdc1fa4596,a2ec54ab6e52447c81fead2e9fa2483d,1,1,1,1,3
5956,43152bbeb5f742d09c39c0f2df687e8a,2018-01-24 18:38:28 UTC+0000,fcb42f2949e048c882e010080ac55f9e,b583de3ec79b4bcd992b09a087df1f36,0,1,1,0,2
1310,431a70351bd2468e8afc636a8cdecb69,2018-02-15 20:06:24 UTC+0000,ed16b0887bcb43309e98b4f5beb89b2f,c6490d966fd14ee98546c8929a3e9b74,1,1,1,1,3
689,43213b7d6e784d07a1fd6df994921d94,2018-03-30 13:35:02 UTC+0000,1c842f69be424d6cbd0c9753533b6aa7,a6d33c38902546849c36ea7e9e9f0870,1,1,1,1,3
1331,432a9a97524d4666b05da75ba13b5657,2016-08-18 16:02:02 UTC+0000,4e5ec275413b4fcd9ebc55e60f392423,fba595034c5a4f3aa27c3607b19eea39,2,1,1,1,3
5465,4333ac62181340b3acf2984cb6952f4e,2014-03-31 22:33:38 UTC+0000,b4006ab43b804873881b939dfa5615ba,9c6312f59b624c309242ed7b87988e0b,5,5,1,1,7
4776,4341823ccd0043d6b19da05bf6bba695,2016-12-20 00:16:14 UTC+0000,f819b30ed2e342c58f6d3168d14b6285,f7fcb2e873804383b9d0e407367579df,2,1,1,1,3
1783,43429876373748e6a78e726afae76074,2017-01-30 22:04:59 UTC+0000,4b9d03ddfbbc4fe9946a29b65ddf4fe6,036358eed7044c66a6058d1006fedbad,1,1,1,1,3
944,43466d483e164a04aa7d013afa160dba,2017-05-29 04:45:19 UTC+0000,45a459fb79774d148cd22eea40ef030e,3db1d58345f74a9eb731e3c316a8ddf2,1,2,1,1,4
7402,4347f5e9799443f794613bebb5e86ab9,2018-02-28 05:45:02 UTC+0000,b21ed69e1bf043eea731cd0d316446c9,7f5bc9e50fee45858f138c2f9308f890,1,1,1,1,3
6436,436400e3874d4e708ac0d3c4e6b46a4b,2015-08-11 14:02:45 UTC+0000,40c0db065a834138956cb3e36f1b9d46,a1006e6a58a0447592e2435caa230f78,1,3,1,1,5
2815,4375b7df8b3043d69cd9ac649d400e66,2017-03-06 12:36:57 UTC+0000,65341f318fc4467bb8d657cc8da5a6a7,36ff3b3666df400f956f8335cf53e09e,1,4,1,1,6
610,437ed76407c2482c88047ad6d80e16f2,2016-11-19 21:49:50 UTC+0000,adb170dbb2ff4891840be42f1e1ccd83,36ff3b3666df400f956f8335cf53e09e,1,4,1,1,6
375,43a43df70dd5481ea0c81719d5510b45,2017-02-05 00:16:41 UTC+0000,d6b4d0f316a34c4e9f74563ad6044f7d,d10ff3b541fd40afb27293de3c178804,1,3,1,1,5
7578,43b388439bbb410ea8ca082b4484736b,2012-09-09 11:59:58 UTC+0000,c5942c9fc2864a7695bc8fea7ddc3912,b1776598991649088c0a00a6e0a2c766,4,3,1,1,5
199,43c06ab613db49a7b02d4e7fbcc65365,2012-02-29 21:19:10 UTC+0000,13277979c93a418ba4a8f9b32a21dc8e,9c5803ae43ca4cf6b27ea85871625116,2,1,1,1,3
4882,43c1f19b25234543bc68eabd53b2134a,2016-07-31 00:18:30 UTC+0000,ff5fc85e9b084ba68ef3cc0a59cae4c4,4ff6e53bea2c4917bf130619b663c809,0,1,1,0,2
6815,43c353e42f10490b9be0bd5e80526c9d,2018-03-03 01:34:14 UTC+0000,a5b0198caa1248cea2955a2f34d7334f,64785a078a564c9c8719d84097165905,1,1,1,1,3
441,43ca25b3c05f46eabd627b979f95b6dd,2017-05-10 13:51:24 UTC+0000,e27df607b4e24ebc819ce27bcc14d58c,952428ab5d6849f9a9d30d2f5bb5b391,1,1,1,1,3
6279,43de6eca5f7b4911a916bcc359d24f78,2013-09-30 18:33:34 UTC+0000,cd926e466a05466aa1873ecf7ba91ee1,e3529e64e70643b6889353db79eeea3e,4,1,1,1,3
3779,43e0527f7e6642c8bee59aa993759061,2016-12-22 05:21:34 UTC+0000,f10b6b67b6294452a4fb3c4126671132,4f3f080d728144d9b57a72f6533101fa,1,1,1,1,3
1762,43e7f8a72fc64f22ba6938266beec591,2013-09-30 17:49:37 UTC+0000,c9d5fcf32c4d44b0beb4b2aa41073423,207c8c62bcaa4033885a24a8a5a10d51,2,1,1,1,3
7021,43f0f503dbdb4e039b7434ad868d412e,2015-07-10 20:41:37 UTC+0000,601f953d75014f2c855b1b40ff08b123,a1006e6a58a0447592e2435caa230f78,0,1,1,0,2
5182,44082c0641c141d281ce6d9b564888bc,2017-01-01 15:57:31 UTC+0000,959ac52f674546abaf52586d696aa768,67803efcf6a94b53bfeb21ce8050d742,2,3,1,1,5
4560,44180896810b4a0381300968a834a399,2013-10-22 20:46:46 UTC+0000,1c33c6faa51d42ab990f92d4209d4f1d,a5806385db1845cc996f66a99cc19dab,6,7,1,1,9
5136,4423c796d33f4665b2ffd82a68404cb5,2016-05-20 05:29:36 UTC+0000,c0fe28a3aede44eabfad727f0719c1aa,d063618ece874d08acaad27c82bf67a5,1,1,1,1,3
3163,44428fc80ff64b5fae5c6672f938bddd,2017-05-20 06:43:33 UTC+0000,11d9ce77701b4e62a106a5c440d974dc,97da3942e54140a5b8fd088267b7482c,0,1,1,0,2
2852,44429d51fbaf4c40abba36baf6a8eb42,2016-07-08 23:14:12 UTC+0000,97c537405d1b44efb8bfe89d48fb87ee,41149875d05f47a4905cc1466ed6ab34,3,1,1,1,3
5455,445fbb098aaf4d769b6fad00d380b653,2016-08-26 12:04:21 UTC+0000,d8d441c72e484c568102165340c1cc9b,36ff3b3666df400f956f8335cf53e09e,1,1,1,1,3
5561,4469972d60464a1d917f018de0b7d04b,2016-06-22 19:08:23 UTC+0000,b179fa7cb991465da84538548d091646,e00ca8adf6514ababc3d1d4548fa36ca,7,10,1,1,12
3774,44873cc07dc1470a9c520bd2e9acae65,2016-12-17 03:35:29 UTC+0000,6da27b396c5f48d3ad5d185f80dc493d,89ffc7c3266344b68c2dbce832d102f6,2,1,1,1,3
639,44972fad2e6a48a28c1f0693d7344e6b,2016-05-19 00:25:56 UTC+0000,42342e10fe59485c86ec311b0966a991,1ce19b32e24445cf9fefcccc91ebd211,2,2,1,1,4
4484,44aef1557e4b45ea96d0b257b112021d,2016-06-27 08:25:48 UTC+0000,4f6d0003b007477ea851b68713924564,26e5d6fe5f364e829c5838479d5fac82,1,2,1,1,4
3137,44b914abadd54da9867d22e3200da570,2016-04-29 14:49:20 UTC+0000,92910ce0f6aa46c1a1d69f75e232c0c1,e4e7cc05a0b64cd6b02168d404a45d4f,1,2,1,1,4
985,44b94f4479b343e9a3eb98cde3107fd7,2017-04-15 16:53:14 UTC+0000,0a151e9ccd804b7abc404f51fa820e2c,36ff3b3666df400f956f8335cf53e09e,0,1,1,0,2
4515,44ba165b51734e91a3255495f6936abb,2018-04-26 15:53:33 UTC+0000,eb3197d9c9ab418ba3d577bbf1f6aaa6,b9d984e161c64171a9018e02b03eab3e,0,5,1,0,6
631,44c840b002854623817fdfccbbf9bfad,2018-01-15 05:06:46 UTC+0000,b72db018437046b1abd56514158c1aca,598351eefc5d436dab91070c7a0e6ba1,1,3,1,1,5
2381,44dd4aaa5de74c3fb7117a6a60b5f625,2018-07-13 21:49:21 UTC+0000,38214a1d4e884ae0a8f014fd91d767c4,cf25490065f24c63a4b94f6e60712d36,0,2,1,0,3
6083,44e74083b9134d2a9048de71b8a7fe7f,2017-09-05 17:08:39 UTC+0000,62139dacd1cf4f81a25f4b98dbcc53fd,4e9fe7ffb54c42eba0987c6119da9975,1,2,1,1,4
1705,44ee816701f54d4c8d65d5356aaafed2,2018-10-21 00:48:36 UTC+0000,0784ab33e7c24e9eb6f993144878bc3a,e1d39b665987455fbcfbec3fc6df6056,1,1,1,1,3
1325,44fe475b3ca44f6fa26aabd47eb89a88,2016-05-22 17:41:26 UTC+0000,e777c218f93543c2898b276865373794,a2ec54ab6e52447c81fead2e9fa2483d,1,1,1,1,3
7234,4510a0d39cf249379e4475b661c7386c,2016-04-29 13:43:59 UTC+0000,c1ebbae569de4d2e8885eeac75a23210,0a429e7732d64e68aab95e7a4ff6e8d4,0,1,1,0,2
5177,451b03ebfd624a1c8ad0ea71f0cd9d5c,2015-03-18 20:45:28 UTC+0000,5cdc02be40ac4c80be14d1a486331296,a1006e6a58a0447592e2435caa230f78,1,1,1,1,3
5429,451fdec3854a4c8babc0de81785f3a0f,2016-06-16 21:27:18 UTC+0000,03001a36a37848e6b14bc35315583296,58fa5e95fe9e480a9349bbb1d7faaddb,2,3,1,1,5
1557,45267059812f469ba501398c36220361,2016-06-09 20:43:27 UTC+0000,e6f4d18e55ef4aadb5790d40c4e7d899,a1006e6a58a0447592e2435caa230f78,0,1,1,0,2
5908,453150880d8a4774b455b13ca8ad1450,2016-08-10 16:09:19 UTC+0000,38ad618d7c394c55b7db9af218cff914,a1006e6a58a0447592e2435caa230f78,1,1,1,1,3
643,4532aa701f434fd691937993c4e646d9,2017-04-04 23:20:38 UTC+0000,7e01a8b40a2d4be2b9d589750d68ed52,32c2201166cd429c8bfc771493c0def3,2,2,1,1,4
2780,45446a202b6245e99e58f2651f1884c2,2016-05-03 00:42:49 UTC+0000,1e12f5dc3a5648f0b27db64562efb610,f5be5a9478ba4cc18b0f3d4baf9262ba,1,2,1,1,4
3873,4550429785b645ecbf03ddd3ad1d7b8c,2018-01-24 01:06:31 UTC+0000,a346ca9ca4844e0ea735c77cade6dadd,a0926afc60a04b02ad73da0e58351de6,5,1,1,1,3
75,4562a840b13a48f4a380c0a4bbabdc4a,2015-10-07 17:06:21 UTC+0000,0f82cfefe490403fa8429afa32783706,dcc628d262024b6e8f16ed1765f1d227,0,1,1,0,2
906,4568395b82f24afaa28ec0b9a6894228,2018-05-17 13:11:26 UTC+0000,881c976312cb4025a25b4190069b27b4,4dc61581ec7b409bbd037e483f53ba0a,1,1,1,1,3
6419,457157c57b654e07b9b973816d53f4b6,2016-11-16 16:18:45 UTC+0000,10f8b65fd0c64a1e842d43567670761c,6dc5ad647c3a47ec950de79d60d84462,1,1,1,1,3
5829,4571edef21fc4d3cbfbd21b7b0aa5d4e,2017-02-15 18:41:00 UTC+0000,2d1268a1fb924c3b996859dafa9ddfcc,36ff3b3666df400f956f8335cf53e09e,1,4,1,1,6
1733,458365174c484f0a8ba5ad300eccc021,2018-01-20 21:47:08 UTC+0000,2ded89ebdb98440bae4793f9ae0ebe1b,8e986814d99a4177a67808088fc92b64,0,1,1,0,2
6426,45905340316c4f02ab0866da7da60a59,2014-04-30 22:26:23 UTC+0000,2ec06902ed19414f88c73ac07bffd1af,3b7e352267da403695a5c0f50f28da8b,6,3,1,1,5
7993,45a7f4d630a5411e802881e1e2e14f86,2014-03-04 23:04:20 UTC+0000,f498e0d4ba5341fcbb9bdf73c9e9eff2,23b6df4d73fb4d9bab3eafb6dd8bfb86,2,2,1,1,4
239,45b0a61b97e94f3c874bd2b773d5430b,2015-10-26 14:53:18 UTC+0000,e164e27500784a4eb4c16e3ee5bc58d6,c1a24b8f746b47488da02a0e5044a7a9,1,1,1,1,3
6670,45e12296c46245c9b2c9105ee23c303d,2017-01-04 17:04:54 UTC+0000,36398cad856c4f5d8da53c8facf5a699,a1006e6a58a0447592e2435caa230f78,0,1,1,0,2
59,45e77dd3a1754edbbc62ab0643bab316,2016-03-03 18:55:35 UTC+0000,3a816f86ecd741dbbdcbaef5ad120a7d,06eebab6ea4f421daa1c7ebfb4467021,0,2,1,0,3
5997,45fe0cf40321469f839bec07237ba3c6,2017-02-14 03:28:03 UTC+0000,6d692456e2e64e48b70c6ba0861d586f,d97aaa6b7f7e4b1e9a6d65d5a0958183,0,2,1,0,3
6211,4600053877594fa1b3dbfaf0d8df973a,2014-04-08 22:59:32 UTC+0000,1ec027dd23fa412ea5aa0b630d41db5a,b688e766eed04a37b7abc9218aca1ce4,1,3,1,1,5
4714,460d6ffe92534a99870879c5a917dd2d,2017-05-22 09:43:04 UTC+0000,fe8eef4b31ad4019aee2bca287074871,4fd49d7ac3ef40b086bd90e09bdb0f68,1,1,1,1,3
3676,461587c6cc6144cda080b2e00653f484,2016-05-14 21:39:58 UTC+0000,be6e16268d434cabae820af248055066,58fa5e95fe9e480a9349bbb1d7faaddb,1,4,1,1,6
2329,4633cec8e1da49eaa78fe4149c5b552c,2016-01-08 02:00:43 UTC+0000,6729370a4e114f04b74980273bee1331,a1006e6a58a0447592e2435caa230f78,0,1,1,0,2
7797,464bc84a311a4a7d8a5b445a2ae680d4,2014-09-17 12:55:44 UTC+0000,c342fb0e78454622a799cb5106abd9f7,fe4543418c0846e5a65fa22b4ad9a304,1,1,1,1,3
3539,464d0f8598de459c9de394b685e795c1,2017-06-01 10:56:01 UTC+0000,0fb0f0eed15f4e618d0d9d2ae994d5e5,ff756e4cbe524fae83839203604a8d9f,3,1,1,1,3
3568,46545773df7a4a87b16137b17a3171a3,2014-03-06 00:27:00 UTC+0000,dab68eb5d8534dbfbd2e349ca7d04c09,fec9c7d2c98641979665c0e8a0a0848a,2,4,1,1,6
7542,46608b7fc4d14ae6b8f674e47fbf4e21,2014-11-19 22:33:17 UTC+0000,ece068ab2721481f81fc337803376a12,86002c4c89f64661b4d4eae198beb730,4,5,0,1,6
4889,46628cc426fa4aaf8bb610a34355d793,2015-03-17 19:15:05 UTC+0000,a9e335d279714432963f7461020a548b,369f1c8646b649f6997eae7809696bd5,2,1,1,1,3
1258,4664f5d2c2fe4d7cb4eb2420cafd36c9,2014-04-07 16:46:42 UTC+0000,93a4e071c1094c9182a1bf19526eecd6,fe4543418c0846e5a65fa22b4ad9a304,2,2,1,1,4
5664,467182fcd6b1425aa23a3635d89998f1,2016-06-11 22:07:28 UTC+0000,a624cea07f934c7f8e2ad28c9f38b8c9,4dc7d9040592416f98c0bef1ad2c31f5,1,1,1,1,3
1033,4678dab3427b497d8343d084af50f46e,2017-05-10 18:49:00 UTC+0000,1176b29158f34296956bd150404de3f9,41d0ec69657649ddb3bd8158d27cd464,2,1,1,1,3
789,46854a369c4649d89edaa0e8d1997228,2018-04-20 04:12:49 UTC+0000,9844d814b6be4fa996f0ecf14182406b,8b81055e41274e099e6bbc4f20d20703,0,1,1,0,2
5443,46893e7055e24b0fb7b2adf99fded596,2016-06-26 16:50:08 UTC+0000,19bc778feedb43ad95eff923fb03fd41,58fa5e95fe9e480a9349bbb1d7faaddb,1,2,1,1,4
6678,469781484f89449d95e3cbf0dd72a952,2013-09-30 14:40:52 UTC+0000,e56e4609ad7a48c69ba7547eb6b16121,85277e26b7834849bc653e940c3658f0,3,1,1,1,3
3036,469b96fe8c214d0d83dd147e85602339,2015-10-27 18:15:05 UTC+0000,09e235b1025c404db1d02c1eda3e4002,fba595034c5a4f3aa27c3607b19eea39,0,1,1,0,2
1516,46b03272a162433b9436cdca8c3a39b8,2018-05-15 16:40:47 UTC+0000,bd6f22dd24d54593b651c27995ee67c1,60d8da72a97c48b080a2f5b38fd4ae3c,0,1,1,0,2
2954,46b4aae5933b4b809d085e1035b3ebd6,2017-02-07 17:54:20 UTC+0000,bfb42b1106c74c1396d354f9a627b750,8d0a435611bf4922919777c1e07b8ab1,1,1,1,1,3
7995,46b63568040d4006b053220c47842196,2016-11-20 00:33:35 UTC+0000,31e4c16cde6b47a8b9c49f550e55b830,34e6995ff9cc41ac853af7da4c15cfce,1,1,1,1,3
2009,46b7df33b1b5410a9ac930bf147e6452,2018-07-09 02:11:46 UTC+0000,8a9df1242a4d47928684a50edb7272fa,ecbe372b1e61417999a563f7c1708033,0,1,1,0,2
3054,46b9c1b229e14dacba362926308bf24f,2018-02-01 04:13:59 UTC+0000,161e6a6c25e94bbe9faba8d0e10f18e4,460fd56dcb694172bce9ed71f48af804,1,1,1,1,3
5425,46c58492de61488d8973ba6777f63485,2016-05-24 23:10:29 UTC+0000,39fd53c6e7724c8282f2c1f2ccbc84ba,030fcbbba31647938b176a90c04e38df,1,1,1,1,3
2496,46d940f35cd8424e9cceb773391887cf,2016-11-05 15:59:04 UTC+0000,81184dfbb91f455fba4f620038ce615a,899d9edd944048aaae4faf23bc96493a,0,1,1,0,2
1357,46e589ff73314baeadbb77fd993944bb,2016-04-21 08:05:43 UTC+0000,fd821d9376d84bc688dbb97adf9d92a1,30504395c3ad418bad5de2954ab8d0fa,4,2,1,1,4
649,46eda2bfac9b4916a2c144fac39626be,2017-10-05 20:17:12 UTC+0000,0fc84362199841babf1573ce0f01ccf3,a1006e6a58a0447592e2435caa230f78,0,1,1,0,2
7243,4704a1378a7a467db282305fdd2ac561,2014-08-11 21:52:16 UTC+0000,a6e82e93e7d74404bd39cc8b8b213e65,5b4cce100fc64fc18106cb9233ecc6ae,4,3,1,1,5
6645,471cead32932419585d0dcddf09caad5,2015-02-12 15:11:44 UTC+0000,f9f2452e908a46c2b7d84b197a3c41e8,369f1c8646b649f6997eae7809696bd5,1,1,1,1,3
2956,471e4a3d8707486fb69852a8288e110d,2018-02-15 21:01:58 UTC+0000,303bd00263e04008b4cabd8fd8ae075c,887c5a142b42466fb74740d72989fc74,3,1,1,1,3
2808,472572e099c5454083859f84dd666fa1,2018-11-14 18:56:30 UTC+0000,8421a042d2b44eb2a8352cabd12e46eb,c021b1cc3a0c45b79a72fb04e2651d35,1,1,1,1,3
3570,4738b0e7898e402a947c3f1dce4927b7,2018-03-21 08:08:07 UTC+0000,69dd313168754207b461e2e2dab35027,0e9f742d2f9e47de8e5d8c7267c19d0e,0,1,1,0,2
1373,47408de8a2734967a2c5c8f31cb68e03,2015-07-13 21:04:19 UTC+0000,dc3fe9297cbf4309917c14e0a21cb520,a1006e6a58a0447592e2435caa230f78,1,2,1,1,4
4868,4744200117b14fdf9591d16e0a62d485,2016-10-20 18:58:38 UTC+0000,5de764b3e215431886f4df872aa324a6,5f95b0ac821e4e8e9b4fa9fc8eb9ff61,1,1,1,1,3
7727,474fc5eeab7e4e64a928a29f8a61aafc,2017-04-13 18:43:23 UTC+0000,34f13a19a6d943b891d7cc50c3e788f5,ab0b1c1190a64715b0433885d5c88df1,1,1,1,1,3
4196,47571575ca604afa9e3fafed16977a3c,2016-05-16 01:29:48 UTC+0000,ea46fa75c8a4477181662a75a031bdaf,58fa5e95fe9e480a9349bbb1d7faaddb,3,8,1,1,10
2713,476323480fdb4df29cca9e6e899eb3bb,2015-07-30 17:18:45 UTC+0000,78fa54b0d40e4c668f7d504f6f225e34,1daab08602eb45f8a33f5e064092d6db,0,1,1,0,2
1887,4765647e275d48149c5c096e1e434665,2018-04-12 15:55:26 UTC+0000,4ec7705b15fe44a685f5002f18bfcb84,fa7cdc9f082145f98e50d5972f36655f,0,1,1,0,2
2867,477ad02906ac42e09628669d5a7e26e4,2015-02-10 23:09:02 UTC+0000,507fb93e980d47a5aa936b3bce30805d,369f1c8646b649f6997eae7809696bd5,0,1,1,0,2
93,47836a7a3c1e4ce18d904c9ee37143ae,2017-12-04 22:52:56 UTC+0000,3d4a1177a0bd46f88552cc04b01673f0,2d4da8840d17404ea179bdc48c13fc47,1,1,1,1,3
5895,47a3a4e05080497ca2efd82c514e75e1,2016-04-18 21:16:32 UTC+0000,b458c5cff83a47409a10bf95d609487e,e2c160ebc83b4f93af07af4850f0ae4c,0,1,1,0,2
3818,47c89b259aed4514991bc38707b55626,2018-04-24 02:12:41 UTC+0000,67b5eda144684125a80fa356818a3c1e,d11dfa57b86c41f69bc68e2b3d102637,1,1,1,1,3
5934,47f0f2c98691462ca7d957e3a59b12a1,2016-05-19 17:57:53 UTC+0000,10d8326fb4604732a8b521b6b6e28f2f,9d3d0927a8684e179eaf640c9dfd66ac,2,1,1,1,3
3661,47ff613f844c4117ab4d4a127513c5b9,2017-03-01 10:23:11 UTC+0000,0f7eec0b97bf4404bfb205764fd565b7,a1006e6a58a0447592e2435caa230f78,2,1,1,1,3
1049,4813283660874a9caea31385294db4d7,2015-11-24 15:46:37 UTC+0000,91c7856ee647433ba6cbe442daaea77a,5c3b849ea7ac4c8880e83089d0dc785a,0,2,1,0,3
3775,482ca7011f7045cb98877d81cd1f6490,2016-06-14 21:19:52 UTC+0000,7c3b1868778541bab392f9b0b7fc04b9,0c8001935b314038adb2a17cf57ff8af,0,1,1,0,2
4755,483a126ed3174491856b1db6d55a1a05,2018-05-07 02:04:00 UTC+0000,917d08750bd141a184877b013c9c0ff2,cbd8f30613a849bf918aed5c010340be,2,2,1,1,4
3110,4842cc1a7dce43d488d24c117e3ee388,2018-05-03 21:00:56 UTC+0000,27c3b9637a264cdba87b7ab9d10f7c76,e250f84df134459faab2187e01c1b39e,0,1,1,0,2
3811,4848a307a72a42dcb66dcbb5a751f104,2016-05-05 16:45:08 UTC+0000,f2258e1f9b334e269463bed8d54382d4,78a63dfd004d4133ac35dfb62fb0141b,1,1,1,1,3
2201,484e505ec1684549a048c49dfa9fabb3,2015-02-25 16:05:32 UTC+0000,771705cbf3fb4cb0a8886d833a17916d,c1341204dce1463dad3964c3f3f462c3,3,6,1,1,8
815,485ab41e953b43d4b0dc4e3504e2589b,2017-05-04 13:02:00 UTC+0000,8a634856c15b44f69c3ab7cfcc24f21e,90b56bd527b247c19b0ee820b0c6c00b,0,1,1,0,2
1238,487a6cec1a754992877a5bfbefaae45c,2016-05-13 16:29:11 UTC+0000,9ca709a65e284f8f987e77c336361032,8f44237ddad84f2184cfe4182fbf1105,1,1,1,1,3
546,4882413bc94d49779c0ae68fb6f3da42,2014-04-23 02:30:49 UTC+0000,17ff1e11d0734751a32c56460af22741,fe4543418c0846e5a65fa22b4ad9a304,2,2,1,1,4
777,48966643f9204d1fa0e3bb3a56124251,2016-11-22 19:14:00 UTC+0000,7fd054b5f6534d08a319f42ba358263c,428b3e58119c4f86b2cd628ceee8fbeb,1,1,1,1,3
3145,4896de9dbe28489ca2df5015959310a2,2016-02-24 18:13:21 UTC+0000,9a86454950874d1187bc5c9a7e08d611,96bbbdd06a334805a0501034d9df1aa4,0,1,1,0,2
6284,48a2ecf7355949f98d7eb9d2e26c3b3d,2018-02-06 07:24:08 UTC+0000,5e9c8e5195664743b89f283843ab4544,265f8307ac4a4a55bdba8e2d47550620,3,1,1,1,3
3552,48b034caefce4720805f931d3b4d7dcf,2015-02-16 15:23:27 UTC+0000,9b3bc2a9410a4c539f336f74b187592a,369f1c8646b649f6997eae7809696bd5,0,1,1,0,2
4187,48b3f4a4075e4fb68daf846ebd2bd236,2016-05-25 15:22:25 UTC+0000,4c45e8c451ef489db77f35c83a7b3921,a6f1102a68d44675bbf20835e288915a,1,1,1,1,3
3118,48ba396c7cb648e2b1cc4a86773ba589,2016-07-17 15:25:56 UTC+0000,59bf5496232a45eeaa6ad1ebdeed0a47,436070799f1e4bafb97a3b5c29deefe6,1,1,1,1,3
1351,48c132f6f3474cd48688ed62c247aabe,2016-10-17 23:31:32 UTC+0000,58349a1bb0e64c4a834157d3ebebf025,c4248bdfd5054785b9036aa7078c6b50,0,1,1,0,2
6294,48c7114ce5eb4b7cab38212d85beabaa,2014-04-03 22:41:00 UTC+0000,c73e5b3eaa6b49ecac563b5da025ed8f,fe4543418c0846e5a65fa22b4ad9a304,0,1,1,0,2
140,48d694366d564cc7b4d0b80e6a66258f,2016-08-18 13:20:36 UTC+0000,7401570a6be9453db6c20ae356523b67,97d44742b7e840608d45c1f55a103f11,1,1,1,1,3
3553,48e7f939ed8a4470bc8124c7008ed5c9,2016-07-23 14:44:07 UTC+0000,c347d992036148919469ea462e1563f1,36ff3b3666df400f956f8335cf53e09e,1,2,1,1,4
4732,48f7fa2b96e54ec78c7f7294454d64f2,2016-11-14 00:15:43 UTC+0000,ad6e65f6b54f4cf8b2d4fedb2fd863e3,416321b48a634ac8a53602625f0a5d40,0,1,1,0,2
5879,490541c2fb014229913cc2256d3d5c67,2016-07-01 14:26:33 UTC+0000,13c753ce5a59493abd1e57df9b6d0d06,1f52a53f782c46298b933a5f70d28f67,0,1,1,0,2
1892,492dbaf6c1f84d389c4a84d7b510a1fd,2014-10-31 15:03:47 UTC+0000,71bbff0dba74418a948b72ae5a7ca972,9a0f09620c6640718c1792a74f3b8438,0,5,1,0,6
6566,4930c888e7a84956bf3ab250993e84c8,2016-12-24 14:02:17 UTC+0000,e5f24cd1645f4af2857c4db62ecc6ba7,36ff3b3666df400f956f8335cf53e09e,0,1,1,0,2
6604,4940143b02b14feeb6b4db80ed25ffcc,2015-05-07 14:27:18 UTC+0000,39c95ca6a95c4257a683a931245fb8fc,f319c1c9280847f48f6d703aff76b4f6,1,1,1,1,3
5865,4952f5245ef14976936e70c5617cb0e4,2015-05-15 20:51:35 UTC+0000,20b08747c55846df8c2e1aabadfc5c05,a1006e6a58a0447592e2435caa230f78,1,1,1,1,3
7073,496992a17a244a25a157d488430768cd,2017-01-13 20:57:25 UTC+0000,d63cd45574e24bbcb0e9484d2ed7021e,9496418c2b6a4c059442c81cd73d55e1,0,1,1,0,2
7423,496bf02339094f7cbb7552932c2bb34f,2016-02-26 13:52:18 UTC+0000,44be6e437c474edb92cf09e91a88da56,c7ecdda876ae4fcc9ac838da85921ed5,0,1,1,0,2
3607,49825b411d974b2c8ed57547fa4376fd,2015-01-27 04:03:24 UTC+0000,eb69d7a0a3bd40ed9e5f6d765391a8b0,4520f122d31241f6b83e3606ae3a1922,2,1,1,1,3
502,498459846fef43099519794393965ec6,2014-03-26 21:38:26 UTC+0000,153abf2b219c42048a6768c905aec1ac,23b6df4d73fb4d9bab3eafb6dd8bfb86,0,1,1,0,2
2646,499a4939443544dca630910e75351ceb,2016-12-02 15:51:34 UTC+0000,aa82a44110eb47a483cefd0d9e686e46,f64df9b489864952917cb631be1ddac7,1,1,1,1,3
2369,49b5bd09fb734d9e82fd8c9f68d85186,2016-06-07 17:54:17 UTC+0000,3f58cd1716c8470bbcfe1fb414921661,de51e745b6354185a0ca5d02dc628416,1,2,1,1,4
3359,49b757085d6b4b2b851fd5d5b84a1137,2016-09-12 02:23:15 UTC+0000,3a217892e57046aba35f4bb91784fbc5,b0e916f9368640afbf1db030c4ead872,0,1,1,0,2
2217,49d4fc1afc224d78ab1f5586d59e2623,2016-09-03 13:08:58 UTC+0000,c63680e819174a93ab51edf9d2878cf2,36ff3b3666df400f956f8335cf53e09e,1,2,1,1,4
1412,49d6f40d92a44bcbbc325df39dcecc4d,2016-05-04 01:17:50 UTC+0000,9dee36263ba64618b3e4636a31e15ea3,6ee41b99dbdf4840b06981e2f89acd77,0,2,1,0,3
48,49d83b7ff67949c78fc1323f11cc9f42,2015-01-11 19:21:37 UTC+0000,0e9dbb9d417044688eaac35826f6461b,be1c38072aa44ad0bc3942606e33e162,3,1,1,1,3
7680,49ec12633fdb4fd68623cad7cdbdb2d8,2016-05-24 03:26:22 UTC+0000,eba43808a3c8464a8bd0a440b507f35b,fafeba89ca764bd891862fb8440a2962,1,1,1,1,3
55,4a21a785d8ab46778e7f778633ea4de0,2018-02-07 21:08:25 UTC+0000,bc668af5eff64e54bfd08e1ea7f24ad5,a6d33c38902546849c36ea7e9e9f0870,1,2,1,1,4
2654,4a36e685955045e69a98e761c48ef3fd,2016-08-30 18:56:53 UTC+0000,aaf5d2521fc44ddeaaf9f32dce541f67,a1006e6a58a0447592e2435caa230f78,1,1,1,1,3
2083,4a3abe4fe71a4eff9479df03b1b8a690,2017-12-06 05:11:16 UTC+0000,a5408fb0ec394fe2b79abb268c3b2cac,ff6f69708a854b5ab0925cb55a146a66,1,1,1,1,3
5062,4a451a40a1b54ab0b8fc902fee16c870,2018-02-16 01:29:41 UTC+0000,317a492e8e764b77aa06500e50105de9,5fb15f468af546bbbf7861b0025b947d,1,1,1,1,3
6463,4a50abc8f76542ae85d3267a321ebe1d,2015-12-01 13:53:53 UTC+0000,089dce8ea31047be9a23b70e8fa1dd63,059210ca80d44bc9a63b854fd2111d09,0,2,1,0,3
5132,4a571792aec945b39bc78592d51a25cc,2014-03-17 22:15:10 UTC+0000,b964b4f5dd714a35a02e97237ce874d8,1fbcd8b315de45c29ff87cf912b535fc,0,4,1,0,5
1723,4a6a3793edb84c38985ff3a693205142,2016-04-23 23:16:32 UTC+0000,6e52c9d672454b40b2cd993d6bb6ed49,58fa5e95fe9e480a9349bbb1d7faaddb,1,3,1,1,5
1764,4a84d32e9ed44b18ab3a927c7a73193e,2016-04-29 14:56:04 UTC+0000,3156eff5a8b64852bb134c2257b7866d,677f47d4daf5467f9ce9b5a0611d3ffc,0,1,1,0,2
6177,4a869d6b7a9c4da3b1de5713dff0c799,2014-07-23 11:59:32 UTC+0000,808eb4df9994468d8618f85acaf473bd,72f89e6b13df4e3ebe5f86501738c744,1,1,1,1,3
607,4a8bbf58e097432e8cb82a0d781cf5be,2012-10-25 01:26:49 UTC+0000,dd41ab53764b4fc89bd3a4fecf7a7e53,4f9b6ed9f6fc4a90b9abc0faa7d3edba,0,1,1,0,2
356,4a8f74072c6e4201ae555717997a5b84,2016-05-04 20:20:07 UTC+0000,7a10b007ce1d4c97bcac58c35df74205,36ff3b3666df400f956f8335cf53e09e,0,2,1,0,3
1800,4a92bb74398c442ebb7ebe5018807be2,2016-10-31 15:20:58 UTC+0000,5f7a6aa1b5d643e7835f9d30c1159a85,36ff3b3666df400f956f8335cf53e09e,1,2,1,1,4
1050,4a94144764f64548a773e69410cadf23,2015-03-03 03:18:29 UTC+0000,438e22e8e3b941d2ade73b8fca4fdfb2,072fee1551324584af69f246b444f688,0,1,1,0,2
3246,4a9bf210886a4ddeb63c9a91abeb2504,2018-01-29 11:56:07 UTC+0000,c32d959c1d2143968d698fab081afca8,331c075b95c74215b0435818457f0324,0,1,1,0,2
4831,4a9c2cb8b3dd45e2a7ce743f7b73252e,2018-01-25 13:33:02 UTC+0000,0898aaeeb844421fad33ec9c943e7f04,8afdf873f15e4d228476c29f9c2b1b5c,2,1,1,1,3
119,4aa221fe863340fdb4099638c1fca2e3,2018-02-18 23:16:56 UTC+0000,0a3e7851178049b2b9c088ea563627fe,be5d23056fcb4f1287c823beec5291e1,0,1,1,0,2
2488,4abad210a8f24a2aa519abd41899a5a8,2015-01-21 19:39:13 UTC+0000,0c928380852d4c84a0dd5f11b9347208,05444a2f42454327b2ac4b463c0adbe0,2,3,1,1,5
1936,4ac99bf9004244d6b61abb67c41e5b89,2015-10-26 17:07:56 UTC+0000,3ce748b2386f4c3fa60ed0ea3e9d64e9,7cce25cc8c1042b1b4f135bcacfdad82,2,1,1,1,3
3393,4acd5cdfa25e4e9da6c1e7a14c8927e4,2014-03-26 19:54:16 UTC+0000,f55b7cb1bfe641bb8f0b26722674408f,24cfcef51f0e4a0d86a7d331ae6cb3c8,1,1,1,1,3
7881,4acd6a1b47374183bdb7160ec8188c43,2015-02-09 00:11:34 UTC+0000,9db7113c5bea468fa880da336fc8cc0d,072fee1551324584af69f246b444f688,1,2,1,1,4
7998,4ad12ad4389246d8a8c815e18ec1b737,2015-12-10 22:30:02 UTC+0000,41552611a2774246b4acd29b7ead90c0,13b55ed4834e4814bb33a4c87001063d,1,1,1,1,3
231,4ad2775d8f8d49bd8c4a517a7461ef63,2014-04-03 23:38:16 UTC+0000,e1ec0f5a237d41e9a0b3f73c123b63c8,fe4543418c0846e5a65fa22b4ad9a304,1,1,1,1,3
7513,4afe64bdfd88494086167cb0cfbd7c7f,2017-02-06 00:35:03 UTC+0000,a5590d68f49a4d5f977ae5097558d182,04232f5addad44b686d6676119ad04e8,2,3,0,1,4
7555,4b1386caf70a4f2784178970f0737a1a,2018-02-20 17:48:23 UTC+0000,4bc67f43ad7340bcbd529af290b21c07,9a2982f4d0fc4ac9a3dbb6d42bcf2aa0,2,1,1,1,3
5410,4b2dce098ed142a2b03ec72233b34f95,2016-06-22 15:21:28 UTC+0000,a31a52faee704848860e455d36e6a4ca,369f1c8646b649f6997eae7809696bd5,2,3,1,1,5
580,4b51809381b448ab9616232424acf990,2016-05-25 02:42:18 UTC+0000,aae37f439aa94775ad10d55f747ffdd6,06eebab6ea4f421daa1c7ebfb4467021,1,1,1,1,3
371,4b5eccde9f674e09a49c10626db94fb2,2012-10-15 16:54:36 UTC+0000,bd9592a576584598ab8f0db9217f5080,05444a2f42454327b2ac4b463c0adbe0,1,1,1,1,3
1823,4b755052529249d1981de3dc70206159,2017-09-14 21:07:35 UTC+0000,74ec33139e8b4305add2581b4a4b619c,1fad1619594b4a9d9367cd1413fd221c,1,1,1,1,3
3872,4b7595fd3fad4856a7c2df90e62ce9a7,2018-07-11 16:43:19 UTC+0000,24788c88778f4493be543097f28259bc,48bd58b40c2d429c8c74347c6e40d357,1,1,1,1,3
7303,4b7aa56a332c4085a6a5f4206065bf73,2014-08-23 15:11:47 UTC+0000,62bbc8b8a32c47c288a5a3a75e8f3ec0,3ddfcacb3aec499fad320c2a46651c0a,4,1,1,1,3
5357,4b8808a5037e42848b36974c11493397,2017-03-08 22:16:10 UTC+0000,f9231dc3bdc24af6a3a99c8e33deeb19,751d8ab497b04dd5b71b94e20c072b0d,0,2,1,0,3
3354,4b989fba86fa485cbd2782f3f58f4a40,2016-10-11 20:48:17 UTC+0000,bafb37f4696d4d80a6c531a835246670,b8b77df14ad94e7bb64f14eeffb72d9b,1,1,1,1,3
3262,4b9e5ae5c4a64422b29d961b3b4a771d,2016-05-15 16:21:31 UTC+0000,6934ba7bbb4e4ba493384d0051bd2b70,58fa5e95fe9e480a9349bbb1d7faaddb,0,2,1,0,3
3086,4b9f287c15be462cb9adbd1c73dd95f7,2018-02-22 18:06:24 UTC+0000,94ce301fd88d47bcbf74f75229f28df7,79f82aadb65943bcb2addc4111291419,0,1,1,0,2
4046,4badb6c9dfd94c74b9b4a4742656149a,2018-05-22 04:38:41 UTC+0000,ee7d490cf5b74bf2871da715b3ef4bd6,4dc7d9040592416f98c0bef1ad2c31f5,2,1,1,1,3
61,4bb237244e6e4ddfa91bc652db176456,2018-02-04 03:21:59 UTC+0000,20b25f79df984c898c79a2038cbafa93,598351eefc5d436dab91070c7a0e6ba1,1,1,1,1,3
4475,4bb2c18b121f4ad5805fdae6b2db3c82,2016-06-24 16:09:52 UTC+0000,06753045616848c4aec5355b9dd8e4b1,89ffc7c3266344b68c2dbce832d102f6,5,5,1,1,7
261,4bc2903b8c6c4f0ab4b1350598646414,2017-11-01 20:44:13 UTC+0000,5e871c7263e94d65b41aa0f06bf71562,4eb0c8a55a774472b14e19d46ae3045c,0,1,1,0,2
6395,4bc2d413681b4203addb1e7770bd08ba,2017-02-04 00:37:01 UTC+0000,7d115b2dabb1491a891f617e90c9144c,d9bae0de3da04c7ebbe0879d410a8179,1,1,1,1,3
4329,4bcff9c15fb14d7fad57e88afc976156,2014-03-05 23:43:46 UTC+0000,6374fb7c2ea94a91ada9e5120bfca6fa,05444a2f42454327b2ac4b463c0adbe0,1,1,1,1,3
2980,4bd22e9a9a8f450aaa7c5bfbab42a350,2011-12-31 18:09:31 UTC+0000,f6b853bec98c40539e2e18028c7138ef,d5ee0b2f7ad0476285401be4bcc9311c,2,1,1,1,3
7096,4be17312cce4470991476361b96e4368,2016-04-13 22:58:43 UTC+0000,a5798910cde4487f8f2116f34d204a4e,d44de0857b2244a38fb1d3787511277c,0,1,1,0,2
310,4be49d4132854a44956488ab851e00d6,2016-06-09 10:57:47 UTC+0000,e4ea696bbee14c39af145094dba7cd74,de51e745b6354185a0ca5d02dc628416,0,1,1,0,2
4493,4c011ebe0bfa40c79eddc4f2c67ea50e,2016-05-13 07:10:38 UTC+0000,41874b95d48b428dbe9ceefe4aeac3dd,cfc850edeaca49a38bcade9006ecdc64,1,1,1,1,3
3361,4c108c42235c4ee5a18897e0408a8cf0,2014-03-15 01:26:26 UTC+0000,9e5e1fb4fd144480866d1eb1b5961f0a,23b6df4d73fb4d9bab3eafb6dd8bfb86,1,1,1,1,3
3105,4c17f8b869c6417982ee725071019d66,2014-04-22 03:39:37 UTC+0000,8b1c76398f4a440798e27e49ecde2ecd,fe4543418c0846e5a65fa22b4ad9a304,1,1,1,1,3
1034,4c1edc63e35d46ef93c5f47c95c6a41e,2016-09-20 06:58:30 UTC+0000,b3891224fc93405b84600af58e5ee308,9d3ad4a464a64e99925341d617ce647c,2,1,1,1,3
5157,4c238a8fc6fa4b89b59f18ff8534bf5e,2016-07-31 01:54:45 UTC+0000,1b944d68687f4163a2a41189e011a5e1,58fa5e95fe9e480a9349bbb1d7faaddb,0,3,1,0,4
2062,4c256434a1fa4f4092fb71d60c2144f8,2018-03-02 20:13:06 UTC+0000,a6eaf2d99db44b34a8df97aaa8951a4c,5b85a1dee8b74d79a87d53e758d897c4,1,1,1,1,3
1989,4c2c4095d80a48feaad4c17c5ed09844,2014-05-03 13:50:20 UTC+0000,5b660260f7f947b08b35dcd58ec16c30,3d8847ddc8d04185976a9e78b190ebdb,2,4,1,1,6
305,4c36b538f8cb498e824016e1931bc990,2016-05-15 07:14:19 UTC+0000,fa4d79b516fd4465b92ae4c8f127f7dd,7873744371da478f8d24242468aa1b3a,5,1,1,1,3
3778,4c3e1ac47239419eae016caccdde7500,2016-04-17 00:50:19 UTC+0000,93581f358647448f873547f4c3690b74,58fa5e95fe9e480a9349bbb1d7faaddb,3,1,1,1,3
4575,4c4ea4c19b5347f78ee6149cc6df3374,2016-05-10 21:33:28 UTC+0000,55973c490c014772923f0014c2d0c4dd,5b85a1dee8b74d79a87d53e758d897c4,1,3,1,1,5
6026,4c51d1d6b7ed4791a4bd8599ede55d90,2017-01-28 14:42:38 UTC+0000,2eff4636326e4189b06126f1f254ed3c,d97aaa6b7f7e4b1e9a6d65d5a0958183,1,1,1,1,3
5844,4c54596054a14842b89f78519ebde475,2017-01-11 01:03:03 UTC+0000,c6066e7a3244423f9f03c218635c59fb,6232d3d12c824cbcb3abe1739fa21bd9,0,1,1,0,2
4745,4c5c9b6ddaa74199b556033a93808c2d,2015-03-25 16:42:00 UTC+0000,d81a851bc79947dd9596c7f960e14ee4,369f1c8646b649f6997eae7809696bd5,1,1,1,1,3
2981,4c62cc26d3ff4335946861cf136fbc3e,2012-07-23 15:40:03 UTC+0000,1efd85f9e6ef44408758ea11236065a5,57bf55fab9b549d3a2d9afbe5a6ed7dd,4,1,1,1,3
3662,4c8328233aec4d1da210d0ece2757ce1,2018-02-19 20:27:45 UTC+0000,1ef5d3e47520424d8cfb23cebcbadff0,0f0d050807914b11b16ba75743543025,0,1,1,0,2
4323,4c8c45da78f84beeacf283bc08c16a3b,2015-10-28 16:23:23 UTC+0000,6e4c9cc28ff14b87b3505f1776725778,e98bd839b4f14cd6a3fa1cd9833d44be,1,5,1,1,7
485,4c93aa1d54c744fcad6cf35fe893cbe6,2017-01-01 23:51:20 UTC+0000,ff908dc54880488ea1af8523bbccc81a,e3605142dffb4d87a0f8b950da727f73,0,1,1,0,2
7704,4c965f210cff4fc488eb8d86f4959eb9,2018-01-13 17:47:14 UTC+0000,bf6014439406491eb4ec6326d20e77d1,48ec7b4620564234a3a3f6e4428f09c8,1,1,1,1,3
7643,4c9d4e3dd0ab440e958b99fdac66d9fb,2017-01-23 23:19:01 UTC+0000,e5cfdf34ec954ba7a807bcf527252c56,c423b56f85034f50a12b0a8600ac6e19,1,1,1,1,3
6918,4c9ead3650894fff959f0b512aedf27b,2014-03-26 19:24:25 UTC+0000,485b40bc55ff4854ac99799952b035b3,9c95af26ebe84e8a9d36a528572f7141,2,3,1,1,5
4855,4ca0899b874a4d11aa9ef7a5ebe0ace9,2012-05-24 04:23:57 UTC+0000,ffd76f9b8b13430eb4fe6788c2b1b0b2,9c5803ae43ca4cf6b27ea85871625116,2,2,1,1,4
6703,4cbee02505f3411cbc8224b6f7b3bb61,2017-08-18 16:59:08 UTC+0000,ece97a9ea53448479c3aed4f057feb12,9c58abeb085b4537b4a4d95a2d2cd6af,0,1,1,0,2
3712,4cc8a953f9aa44ecb0e73631a933674b,2016-06-22 14:39:06 UTC+0000,9be1569eba4f4ef68c2e63bc0ed48e69,a418123481e74a93b129f8fcbec2494f,1,1,1,1,3
4985,4cccb4b5977e43f5a8cbdf34da4c33ba,2014-02-12 02:39:04 UTC+0000,e19b651ca1c84723a319cf4b28caec38,7e326f43554e4bb8854b470f1d87b069,3,2,1,1,4
3632,4cd9a821c330415d84a1a7e609d0c02c,2014-08-12 14:58:03 UTC+0000,d322f4fd6430413386834ebf67e490f4,53939a491acb42a4815463845a638186,3,3,1,1,5
1576,4d113fee52a24a10b7abb7cf7dbb0f29,2018-08-14 23:25:11 UTC+0000,352735caf7444378b2133ef35e15cf45,7c523236d74b4840ad1d7e398ef15fd7,0,1,1,0,2
2816,4d1a5210dff242acbcdbc8910dff37cb,2017-02-17 19:23:05 UTC+0000,96ca74d09c99487e9a84e2fa4810270f,03cf1fd186ce43229b93f29557216762,1,1,1,1,3
4094,4d359e6cf17f4bde9b8683ac154a82ea,2017-02-16 19:55:39 UTC+0000,79257e00b03349d093ffe784db67cfca,a1006e6a58a0447592e2435caa230f78,1,1,1,1,3
723,4d3d812576a04380930ba0e34c99997b,2018-04-03 12:55:32 UTC+0000,4c5c32ff38c94c0d83cb17703fca1840,ebc5b7425fee42838a87cb0e48241116,1,1,1,1,3
7605,4d3de7e6a85a4cd9927d29a6508ae1c5,2013-12-07 14:24:25 UTC+0000,69c1409194964b8c92aa5a08aa3a6c53,02ca0119e1724d96bced4d361aeb4318,3,1,1,1,3
5262,4d3e57eb976b4e078e72d269bbcbc529,2015-10-12 18:38:26 UTC+0000,5251024e3dc1476d88e5401fe75e080e,6e88fc11e5474c7db3e11b2aff0fc2f2,2,1,1,1,3
352,4d5ad0ac9c0f439cbe4cc7d0da51a329,2018-01-24 22:00:14 UTC+0000,feb234a750c94c8491507529484507f0,e6b29607f1504bc9bdb81783016df845,3,1,1,1,3
2797,4d76b2c23c5b4f148be31119643866c2,2017-01-30 22:35:17 UTC+0000,553d674c05434f498192fdb26a8b4f4b,036358eed7044c66a6058d1006fedbad,1,1,1,1,3
2449,4d7a3cb5ec7b421f9c4c31607a338b61,2016-10-19 02:35:19 UTC+0000,e2a93010c0e246a58a49a449284310ad,91a66853dd164250b6df8a22115e9f88,0,2,1,0,3
1135,4d80f01b01b944b6a812c923083fea51,2018-09-24 18:44:30 UTC+0000,3aa9e9774b154f8aae675de2b51457f0,9221f63656ca4e8d9fbbac486a4e4292,1,1,1,1,3
6379,4d9f2744d85c4bd18f920f14fe109088,2016-08-09 23:57:15 UTC+0000,02b36fd16a7f40fab3bc5d624947f430,41b3984603ec43bdba6404c675800889,1,2,1,1,4
2290,4da22e6d0fb94cbe9e419481eecadd60,2017-05-19 21:07:58 UTC+0000,131c8b2781d944ff89848fc7a5ac2ed8,169fe41bb6dc42e98ced634c7ea6430b,0,1,1,0,2
5746,4dad3f5978424073986a6a743b755311,2015-11-05 15:03:12 UTC+0000,446ac4e7eebb41209d0984641ce673f8,a1006e6a58a0447592e2435caa230f78,0,2,1,0,3
6213,4db14dc24ccb4b4b9c13797d9497fdd3,2016-06-27 01:20:42 UTC+0000,6dcf4c28b5d4473a85438968f4a5b06d,36ff3b3666df400f956f8335cf53e09e,1,2,1,1,4
6021,4db775dd292b48b1b5727d1d4b32a208,2014-03-04 23:05:37 UTC+0000,35fca6c483b24ce1949a505f3ce08cb0,19c30dfeabb64b108617c81d87f538fe,0,1,1,0,2
7757,4dbd2869367a4575bb80de88d04f5775,2017-08-21 19:14:37 UTC+0000,cd9f6dbc24014d5bad3f584ccb511713,a3f8626fd02d40eaa5497cffcbec562f,2,4,1,1,6
7236,4dbe773dff774ed7aa6b7eccb7d53ff8,2016-06-04 19:59:51 UTC+0000,2dfecb3f061948fc90019e5aca39fe4d,f67f06766e8e4b57afa9368889483822,2,1,1,1,3
7622,4dc393b1fac54a7a86e36dd1745becfb,2016-07-14 00:22:23 UTC+0000,ead0535bd6484713b5f0d3758da6ec83,36ff3b3666df400f956f8335cf53e09e,0,1,1,0,2
5529,4dc6b1bc581042fd9e873175cb23975c,2016-07-19 08:49:01 UTC+0000,c1f405875bf6469ebca23d3f2974a8c7,469511d445a54bde93e944da3dbd7a9d,2,1,1,1,3
6766,4dca8d6ad78b40c2a06943bff0bee92c,2016-05-19 04:42:15 UTC+0000,dac472a08152487d9dfac647a26b8198,19c30dfeabb64b108617c81d87f538fe,1,1,1,1,3
5649,4dd01ce444884d68bf525e04d604bd68,2016-10-11 19:48:36 UTC+0000,450d197b7cf342dea455451a5a262a1d,45032ce1a536451fa4dc3db0a526c4ba,1,1,1,1,3
6154,4dd1fd1a304940c784ec605032d60fe3,2017-05-20 17:19:14 UTC+0000,bd1908fd9f8740dea15d067e7d894d99,2c7cfae7b5424b6fb2fc57bd43cefa59,1,3,0,1,4
1179,4ddbe8ea9efb43c2ba4db7c3b1f4c489,2016-06-23 17:31:15 UTC+0000,89cfde0258b64d5fbf4b6c108b28aa11,8ed84e59c3794a5b82ce06e855ef67be,3,3,1,1,5
517,4de6dce200a14cc58542bedaa0af2547,2015-03-26 19:21:00 UTC+0000,9c33691befc74aacbec57c7cb868257c,369f1c8646b649f6997eae7809696bd5,2,6,1,1,8
3635,4de93a442f1c4291998902c0e76ce0e3,2012-04-10 14:30:12 UTC+0000,6d2989a575d64b1089b8b90700a37a70,aef2e9377f994faf98219268b7e0bc3e,2,1,1,1,3
6345,4df7c8a5784b414d82446364fcc54ecd,2015-05-27 10:43:54 UTC+0000,28e3537cfa804b1a9957195227cdd316,05444a2f42454327b2ac4b463c0adbe0,1,1,1,1,3
6921,4e05bde1175d4b4a943f3c4eaf8deea7,2017-01-26 13:44:15 UTC+0000,8b1289815c6d4b17befc953a6489e175,81a594b683d54e6dbb4b04ea00a5e25b,1,1,1,1,3
2997,4e1fb396e0284e1da55b633e1422dc05,2018-02-16 00:40:22 UTC+0000,66ff6311a1c74069b1c6be3a5f4862df,57d0fa457cd24a12a37e0d66236b7a1f,2,1,1,1,3
4299,4e24713ce3854f0db887f851d849ccd9,2018-12-18 02:45:13 UTC+0000,1bbe7e5592104838824daa4a9a241ed2,d2395075d07c4768bf98f24e7083b662,2,1,1,1,3
1943,4e26f97636fc487b85f35627fcdd2a65,2016-03-24 03:04:18 UTC+0000,1fe6f820a788464db7363ca46c387790,52a53212ec964340b11aa914d94d3483,4,1,1,1,3
1754,4e28673179984030842deffc58a3978a,2017-02-05 17:57:56 UTC+0000,f75f012a7ae040809ee5019d225545bb,32c5b4ffac524531a64b161442a64510,0,1,1,0,2
7143,4e2d34931b594059ac4307577128df1e,2017-10-06 00:10:24 UTC+0000,a46cc80b02e1454aac83388f0b6956d2,b3503b231c10436d8095edb0c293adad,0,2,1,0,3
484,4e315b49418c4dfd916bc249bcaea37a,2017-04-19 00:40:20 UTC+0000,b1ff714fc5504dbeb027fee919cd98dd,be5d23056fcb4f1287c823beec5291e1,4,1,1,1,3
7667,4e3a8434968242358d61aae35ad5034b,2014-04-05 16:49:42 UTC+0000,b42ee4dc2a1240e3949a98c4fbf632fe,fe4543418c0846e5a65fa22b4ad9a304,2,1,1,1,3
581,4e46bba85cf24a09b39ecee20cab4cb4,2016-05-21 20:21:09 UTC+0000,4bf591bada354b2fb505e812b42bb5f6,58fa5e95fe9e480a9349bbb1d7faaddb,0,1,1,0,2
3885,4e49aa275f3c4664b3dd77a1ca79fe2c,2012-01-26 05:08:54 UTC+0000,27cf07eddfed476789b4411cb65fc77a,624194ea296c49a6a8ef1180787476dc,5,2,1,1,4
3055,4e5077ab33d8462b9a0453378a6aeca2,2015-10-22 18:28:14 UTC+0000,fc29f198298842578af9cf51e558a31b,369f1c8646b649f6997eae7809696bd5,1,1,1,1,3
1834,4e58a8e7898e4f7e94b335c9d8dc0296,2015-03-17 15:10:01 UTC+0000,f8bd030223b5456c833b69abe397e4c0,3166cc28dcb84b73bee485ede7d07dea,0,1,1,0,2
6391,4e6b1b323c3e476ba03c33f75df9304a,2018-03-26 15:40:22 UTC+0000,0a38fe7562274c41ab96b62f6b4a8ab6,dd5aa5b5b1324c06b808f55a2d33599c,1,2,1,1,4
3924,4e76d639bbf944b49b038576281bb71a,2018-02-02 22:55:36 UTC+0000,ccdb102e3e9043518c2d6c830fb4a577,a6d33c38902546849c36ea7e9e9f0870,1,2,1,1,4
5928,4e893518f1e74707983ec346cd3e32aa,2018-08-21 16:56:55 UTC+0000,f4f8afa98a3d41e9870587517a0feb5a,3868597c0e1f40b69f68cbacf0a0f265,1,1,1,1,3
7999,4e8ae20eb9e94f6f9cdc25cdbb863c95,2016-11-11 03:09:12 UTC+0000,5597ec6d06c74aecb5e14587fbefddb6,168b649125b54d6c84f9f5fc1f4033a1,0,2,1,0,3
3058,4e8afe210af94ee8b3e215905b660d77,2015-02-09 18:19:49 UTC+0000,93ce42e798b0423196f13cb605b2711a,369f1c8646b649f6997eae7809696bd5,5,3,1,1,5
3082,4e9b0dd7076a47bba6dee99668677938,2016-08-17 13:36:12 UTC+0000,559f7ad923674d1fa6ee8bf85c4b5c18,3e66f046e4cd4328a79aeee3a8438c96,1,1,1,1,3
3187,4eaa7836f9a348e2b960692a03bdd794,2018-02-22 22:12:36 UTC+0000,2f8cdd3525b040cfab5aea3a027c2971,ecb98732bf08492e81f6bbe0161b5f43,1,1,1,1,3
7997,4eb64ed1527847f29d3e3d8a713bb3dc,2018-01-29 15:05:24 UTC+0000,9a26961d2bca4a9ca923b876576e456f,4e9fe7ffb54c42eba0987c6119da9975,2,1,1,1,3
7354,4ed6023e18044587b5d548b2cb19b39b,2015-04-03 14:31:59 UTC+0000,f341a97ee9be43c29b890630c5da9f53,0895796423534563adcec1c208e9e0bf,2,3,1,1,5
7195,4eec1472301a427e988f067cc381626e,2018-03-01 16:57:21 UTC+0000,3ebae6748bbd485197cb7d85a2359d8e,c4776518f0f2440ab66aa9ee3dafa213,1,1,1,1,3
6750,4ef1718144db410a858d87d96970aa5d,2015-10-28 19:44:09 UTC+0000,6f7d5fc1d6134bc6af608d5adea645e7,36ff3b3666df400f956f8335cf53e09e,1,6,1,1,8
3941,4efbe11e960d495dbf8642b02ba7228b,2014-04-25 20:22:19 UTC+0000,821990a298c4405bba89a4cc8cef3967,fe4543418c0846e5a65fa22b4ad9a304,2,1,1,1,3
5190,4f01c29823324a71ab2cdc6c9d4c57c4,2016-05-24 23:43:13 UTC+0000,3723a1f9687a43a4ad7dbd2930111933,030fcbbba31647938b176a90c04e38df,1,1,1,1,3
7491,4f029994ca47473897044300252a6a8d,2014-03-18 01:32:28 UTC+0000,d5f099b5a1fe422981eee2e6e3f03ddf,77a65aed859f4b11983cd07399f1e3b1,1,1,1,1,3
4792,4f02b9341bee4e3b986b67c5ad5d52ee,2016-04-26 03:52:32 UTC+0000,328970830ac34052a34c8b266e70fb0d,19c30dfeabb64b108617c81d87f538fe,2,1,1,1,3
4190,4f050cb64886443f9e699e646ee39516,2016-06-26 16:52:38 UTC+0000,1bdb7876f4054f79a518548c62880c91,58fa5e95fe9e480a9349bbb1d7faaddb,1,2,1,1,4
3546,4f058de380164f4e9b5a45a9f86dc01b,2018-08-22 15:39:00 UTC+0000,038d7b9bc56949e5938f302f83571990,36ff3b3666df400f956f8335cf53e09e,0,1,1,0,2
7318,4f0b6734d4d248988330a5a410591db4,2018-03-02 23:08:00 UTC+0000,54c57750a272415fa70570a7187afb94,51d90d993709471eb8c1f45fcb39732f,1,1,1,1,3
5122,4f0d232d004f40458645aa4b506de867,2017-09-11 12:40:22 UTC+0000,086ad99332fb4aa2821fbc845d23493c,c9add60c674a4f1495020834346f241e,1,2,1,1,4
6333,4f20d1edef5f487dad11b89d0ad6c842,2016-08-14 18:53:52 UTC+0000,2b81b697ad234c3487d9ff53b146dfe4,58fa5e95fe9e480a9349bbb1d7faaddb,1,1,1,1,3
5726,4f2e491156284b5aadd17065716d9d38,2017-04-14 20:48:59 UTC+0000,c239afa8c1084dbba44fdafb9e88252d,067a3be8848f41a592e5303a778a0f53,2,1,1,1,3
4664,4f4566523f5c498783673b3439f94428,2018-01-19 19:28:49 UTC+0000,7d7a01880d4c4e5f94c2972c644e4940,e4b617982f7541d88dd091849596d92d,0,1,1,0,2
739,4f52b2e05b634f6aa6155b40a5514513,2016-10-21 19:04:30 UTC+0000,383cbc47d7c841ff9b62455c2efc94bf,2dda27e71d6d4771b7fd0b9eb34f5b0f,1,1,1,1,3
4854,4f5b8a1fb5fb4126b7e85fdd67913e2e,2014-03-17 05:34:53 UTC+0000,58e8d29254ee44dbb5a640206ed4471a,4bce59e2537b4228adb73b856d2c6102,3,1,1,1,3
1214,4f5eddac981c40ec83bdceecaa20e6b7,2017-01-15 06:44:12 UTC+0000,da0af92b81a64c39ac1bbd8dc1394fd4,ead34fe989d9426fbe214db2cc3cb08b,0,1,1,0,2
7475,4f6d198830b44e1d8edb0b98b8c30d5e,2018-05-06 16:39:01 UTC+0000,960e904ee8f4471fb648f1e3df057918,2e1d8de06dfb4d25a297bcd9e3931ef9,0,1,1,0,2
3386,4f8030edbaee438896a424c2eeaeedca,2016-05-08 10:56:46 UTC+0000,b0fd594a4d77463ebf8ac81017e50da0,7919ea19db274c1fb862f3456cd25ac5,2,3,1,1,5
3592,4f9b37ea0a054cb39873af3f9e3e16c2,2015-06-27 01:23:10 UTC+0000,eb4a6e6f739e44ad8792e07023679420,1bb341c8874d4dae9235cb6480ef7d57,1,2,1,1,4
2285,4fa3ac206af048d09a56d640b392ad05,2018-09-21 02:00:49 UTC+0000,8b3454c46ca441c4b2f62cdc04e7ebae,36ff3b3666df400f956f8335cf53e09e,0,1,1,0,2
3492,4fa5fb3c49d34ce9a61f0114a5b6ece5,2013-02-10 17:34:34 UTC+0000,feaaa1c444bd4f739431f69a63720989,8442ddfd38bc422fb4677785db0630e6,2,1,1,1,3
7583,4faaea4cee8b417d9be95c5ccafb65cf,2016-05-16 18:01:19 UTC+0000,b98609832c8b4025bd81111ccf5166f2,8356a8e385b84823ab0d3fc16530a509,0,10,0,0,10
2583,4fbb159ab7f84a7abb8c777a7fb16938,2018-08-15 01:53:34 UTC+0000,48b7e253363b4f9c91da612624eb9255,1232315022424e71b440d41e35e9dc89,0,1,1,0,2
4851,4fbe699f1f1a483c91f2ccba68197fb0,2018-06-11 13:51:52 UTC+0000,ab093f16421044f6b4a7f3a54e1a68d4,36ff3b3666df400f956f8335cf53e09e,0,1,1,0,2
3453,4fbf9dbf21cf475abfc42db2d18be515,2018-11-03 14:48:29 UTC+0000,9b14dac8586e4b2c98b6c06560137c83,3dd3295b9e934cbaa42488db94abd709,0,1,1,0,2
6335,4fc8513fd2064b83b149d2e60ae5c40b,2014-04-09 03:04:49 UTC+0000,72417ad2a2cd4ecaabfb0ba73ece7944,fe4543418c0846e5a65fa22b4ad9a304,0,1,1,0,2
2963,4fca7836c5cd444399a23dd479928d9e,2017-01-28 15:01:00 UTC+0000,f7ac2e9d08ae4c95955ab1c1fe88a04f,84e08b7c127e4e309a0f9853f5e0ea1f,1,1,1,1,3
1458,5004ebe96ef144c6af017f4fa5ecd3cb,2014-06-03 21:53:58 UTC+0000,39becb2e054e4456ad2eab0c299febfb,dcea3f9e1a554c099f8d08e9d139d195,0,1,1,0,2
6268,5016770ad367451fb3e88a97f0201910,2016-02-24 21:11:59 UTC+0000,5a63c11378c84972b9eeafd0d3e4a36f,1f569e302915421a8f901ba0f39270f1,2,1,1,1,3
29,502233ea1ceb4f13a1656c591cd592e0,2016-06-21 20:50:54 UTC+0000,9b7fd35af3c6499996fdc9a10069925c,edefbb692fba4e3a90a7b426dbc4d9a7,4,1,1,1,3
6024,502f8a286763490dafe11da8a33a76ef,2018-08-04 16:53:05 UTC+0000,c70dac954b334fcdb402cfcc8a2e29d0,ffda74a4fd8841d385c349c242347381,1,1,1,1,3
612,5034e26b2e44433aa4db1d9725ab3291,2016-07-12 18:42:36 UTC+0000,d6348d69573148e7aa677a2dbc328a24,bbcdcd790f8d486987535a5c5b362e9e,3,1,1,1,3
6235,5043e035a1ca4cb6a8779220269490f8,2014-05-01 16:21:17 UTC+0000,bbccab52528b49fa9c183a9529e1cbb4,fe4543418c0846e5a65fa22b4ad9a304,1,2,1,1,4
713,504a1fd930d042578f7dbf00986f96bf,2017-02-13 15:19:26 UTC+0000,9847ceaf0682450fb4bdaf299dcc8d72,eb067e405dde49d3b8d3975212dff022,1,1,1,1,3
594,504a3c31b4294086b23c41776a8b5ac5,2017-05-26 19:02:39 UTC+0000,3b71cd10068f4e34ba6839e03ecd2394,8c1ed7125e6840bd935fd317dd9fb219,1,2,1,1,4
1777,50523e9d26604643b036a8297737fc8d,2015-09-28 16:59:19 UTC+0000,5ed3f97c4811492eb687836f4cd46ac3,369f1c8646b649f6997eae7809696bd5,4,3,1,1,5
3942,5052b9e17c144d0691fde63f8afdc635,2016-09-14 00:08:34 UTC+0000,2a347b33e89b42c8aafd802d4f3527a8,e1f680fc6bdc472dbe3024f7bf1aa290,1,1,1,1,3
2616,50a7a48162b64f0da35dd9a94b07f5da,2018-04-17 21:00:24 UTC+0000,b6d35f0d09ab45ee82a1cbc0fd5963c0,36ff3b3666df400f956f8335cf53e09e,0,1,1,0,2
5057,50af2e8fa05342c1ab5c13cb31a26031,2016-06-21 19:14:14 UTC+0000,71f4722f54804d319fb10c7c678042d8,ed3d991e46944d7e95ef8eee2f0d555d,1,1,1,1,3
7228,50bb02c28b6144969d12d5f024333a71,2014-11-19 22:38:50 UTC+0000,f1261cf1463341c995043a86eafd2dd5,2728abe4d08149c9b100f523b4c86716,1,2,1,1,4
4961,50bbd94d68c6489f8d83b23af1160711,2016-10-30 23:58:16 UTC+0000,bc0b1de3c3364e9bb0bc176b553adcdd,be5d23056fcb4f1287c823beec5291e1,0,1,1,0,2
698,50d2b35577724ba588985d9bc6ca1913,2017-09-11 12:51:43 UTC+0000,3f6797ee8fac47268be03076cf489cb3,c9add60c674a4f1495020834346f241e,1,4,1,1,6
6328,50e47d29db0542f3bd0e1f68c3cd1638,2017-01-13 20:54:20 UTC+0000,1aec9773b8ed49f584be518d4528b252,9496418c2b6a4c059442c81cd73d55e1,0,1,1,0,2
603,50e5288e457d4998adc6bac7a3f21f56,2016-05-17 16:19:21 UTC+0000,4e0764f3cfad4deda155b6c5dbf26d67,f6d9369cd0a24b52877450757c451dcb,1,2,1,1,4
3560,50f439fe5f8b46b5978065119e6cf98c,2017-12-01 23:06:16 UTC+0000,284581cc60c1480f931d229a47984a4f,29477d85b65d4e37a754a83f2f779790,1,1,1,1,3
4063,50f78c8a95d54c41885da49e626214bd,2018-02-16 03:35:41 UTC+0000,9926ee42ee6c4f979a8d3fb281f5c1b8,19adde8973034043ab515842ecc0d038,1,1,1,1,3
69,51043ca7c6e54a789a35862926b2007c,2018-04-04 00:14:32 UTC+0000,8a0336d2c17340da88e530f9f56dcb81,cf4d747b013247c08775128477da5502,2,1,1,1,3
6214,510a0131a8b64fe9b1bb653bbcf67382,2016-05-18 14:43:17 UTC+0000,d4ccafd024cf4b379ff02a72a969bb2d,7bffa1792d474359b922e5de700d7a82,1,1,1,1,3
1215,51150eb55f3d4da2831d8aabf6c8b8fa,2018-02-08 14:41:29 UTC+0000,5df72826cb85471daab6fffafb619b07,05ab77d4c6a141b999044ebbf5415b0d,1,1,1,1,3
6901,51153aa9b2ff4a5a90eb5e8edad2c25b,2017-01-20 18:27:14 UTC+0000,70bbc4fb75f14e1e84297a3cb1887f3f,36ff3b3666df400f956f8335cf53e09e,1,2,1,1,4
5297,511a0381fec847749776c897b4e5598d,2018-02-21 18:20:13 UTC+0000,1d58a3230f9647b0b4c50f72d92069d9,a6d33c38902546849c36ea7e9e9f0870,2,2,1,1,4
4421,511c0156f37b4260aca4bbad7befaf9b,2017-07-11 17:07:53 UTC+0000,3420a95e4cff46bca6ac76e52ae627c4,1dc4613a0fb34b4d8786586a3dafaad6,1,1,1,1,3
3257,51298da120a6416897e334bb082f933d,2018-11-27 11:18:06 UTC+0000,d50f1e53d4b64d1ab076e892bcaf7419,04ef7b7f004a4c11b606d24c92643c07,1,1,1,1,3
7646,5139a5f128144421bf29741fa6684692,2016-04-25 17:10:02 UTC+0000,92e0f8b9ab004dafaeb62a98f2bab79e,8022e3cb63e840c98c27148713777ce3,1,1,1,1,3
524,516c7e6d3410452f92665c3ba135b73e,2016-06-27 01:43:50 UTC+0000,4406a16b1f2f420d9c4fddd09d65c858,ff463fd04d644058a5009ba506724cd5,1,1,1,1,3
3792,517ee576697146bea34fdc58bf58aecf,2014-04-02 13:33:54 UTC+0000,7dca67452ae74edabe48ad2fdb2397ef,0355aaad83704ad98e6d71b79db85849,5,5,1,1,7
984,517fe616367d4648ad2905357076a207,2017-05-10 16:51:04 UTC+0000,d743b5a5664247c888f67d8eb1c22364,58dd370805414e6ea8fb96aadc69ec8e,0,1,1,0,2
2930,51896b12b407439e84564ef6dbb7f6ef,2016-05-26 11:17:08 UTC+0000,7b26e543bb1541eaadfd971c6f86d653,eebf2942b3c1410c8aea50bb5214f093,4,1,1,1,3
3401,5189dd95d4bd46bbbfd6802529837974,2016-06-17 04:44:37 UTC+0000,9dc05130a1444e70b1be0511833c7f4a,dbfc21fbff414832beed41c7a5966096,0,1,1,0,2
5666,519371e87a254c26a27db16ba4a52f68,2016-11-16 21:54:47 UTC+0000,5e3ff57a3c104cc0bebd4f9dbfe3e9fe,c7174378cda74e0886100523dde4913a,2,1,1,1,3
6374,519546b52aae44f3a2ba187fcf0de25f,2018-05-25 14:11:59 UTC+0000,6af89d8208d149babfe594d8d8986712,4dc61581ec7b409bbd037e483f53ba0a,1,1,1,1,3
624,51956c848e88428685120fa870608f35,2014-05-29 04:13:02 UTC+0000,e768e2cc402543d791131b67c43a2a60,564ef581bed64addb3cf0ff0ab652ffd,0,1,1,0,2
4603,51b389a9d7f949f9abc2c3a661e70373,2016-07-31 01:35:42 UTC+0000,0de5e3683942475c9c6eb236f7d774b9,58fa5e95fe9e480a9349bbb1d7faaddb,1,2,1,1,4
5936,51bb4fc3c1e54bb8ab90d65c7364f067,2016-05-18 23:55:28 UTC+0000,97d772c006b44eee948a00193b4d9543,60356f8e5d854b6f9d7f5c868345d07a,0,1,1,0,2
1104,51c9cd85050a45878e97b762c791426a,2014-11-05 01:16:55 UTC+0000,c2dfcfd17f2e4f518f1d3b1da5a0cd8f,53939a491acb42a4815463845a638186,5,3,1,1,5
3092,51d150521d614250b87838f46c8680e8,2018-11-02 14:06:00 UTC+0000,1b5abfb882f243f99e3218d5d6509ad7,e1d39b665987455fbcfbec3fc6df6056,0,1,1,0,2
5347,51d17f9c0a1c40b5bb1d194f16c852ae,2018-04-23 19:52:40 UTC+0000,bd4903caa99d41d19f17ea6f93df0df4,950898c71c6b4616b00b1d984ee71024,4,1,1,1,3
6858,51d494a5fd34400d82655a92958e75d0,2016-07-08 18:10:23 UTC+0000,39ab97bbd9e74a9e989c494fd87cebb4,52bef8bad59d4aeda57b312edb6c23b4,1,1,1,1,3
7326,520aee05a5d34dfcaf774574c0013360,2017-02-03 21:06:17 UTC+0000,835e84238ee84fcbba877a40b6015190,36ff3b3666df400f956f8335cf53e09e,2,4,0,1,5
5973,5213db790a73488bbb316e5dc167a9dd,2016-05-17 03:56:04 UTC+0000,ff7441619f8a4bcfaa3323f7991fa521,aa372f7d830b4167b32877a8c805208e,1,1,1,1,3
6282,52213f9cdde44af4afbce26658658eed,2015-06-03 16:35:58 UTC+0000,8833520cda0e4ca18e688cf8f10bad6b,04b72521eb474b8bb79f7bd95e8b637a,2,1,1,1,3
4446,5229a566233840daa71a69a7f7729eca,2014-03-04 22:33:54 UTC+0000,61a46935f7ed40259f74dcc0bd6b1b3b,67b5053978424ed09bb00b5854a6228f,2,1,1,1,3
3648,52327e466c5e447b958e4493afe9ff3b,2016-04-25 15:22:47 UTC+0000,1e0ddf2ffa22433497ea7d73194467be,81eb2470138d44abb5e5a16053f75e6a,1,1,1,1,3
7333,52474b65b5ec4a84a176621c1c944c8c,2016-03-13 19:00:15 UTC+0000,4d9b192e254b4f259869cfe933db3894,aa480c6fe3b44f8ea5bc6299224b9953,1,6,1,1,8
2884,524bb83b5a184b1093ce0f62e92d56a9,2012-10-11 19:12:46 UTC+0000,db903b37d4d243969e3a9087f366fa82,8442ddfd38bc422fb4677785db0630e6,1,1,1,1,3
6291,5257fe9a76d546508804487bd45c187f,2017-01-23 21:15:02 UTC+0000,144e5e48855d4045914c134a69632731,6fc2a662a6f141a18ed3c99f17dce4ab,0,1,1,0,2
4103,526253025c73489190494deb5df4f901,2017-10-28 00:57:03 UTC+0000,2c5ccb1adcda426e82d5fa13dc9688d6,1e6b499537cc480794dd2ef57a460d4b,0,1,1,0,2
4207,5271645a061d471aab5617f3c2f17aa9,2015-05-09 11:34:17 UTC+0000,d814ea54dc2d4dd3823af527481fe427,a66204e927314fd6acda8ec79b57f9ac,4,1,1,1,3
3222,527fe6804d3d4e5787fa183b977747d4,2014-04-10 03:47:06 UTC+0000,63abb3e821874a5a887390f824e11751,6774ee9e8f9247728dbbe896726e911a,0,1,1,0,2
6234,528b275882734f19970a4e42b830c3a4,2016-06-12 19:43:48 UTC+0000,20fb5cb7ca0a4c298e1f3968319dd4f9,58fa5e95fe9e480a9349bbb1d7faaddb,1,2,1,1,4
6996,529585ceeefa4d34b06e0574e371dc85,2015-03-08 19:46:34 UTC+0000,0140aee53fcb4d8eaad389d3f6bde219,56444eb4b925439186a995602e9d7037,0,1,1,0,2
1159,52a073f25b324553bd3f125dbc7d3266,2018-02-20 20:38:21 UTC+0000,7f42966096e7447dba5503a7796faaab,243c51ebbd71471d9af55cc34ce305e0,2,1,1,1,3
1083,52a28fce100847a79bed159968206e64,2016-06-24 14:39:03 UTC+0000,85ff0b0edce342138b2deb739cabfe3c,17613500e1584f6480218ef42080e54b,1,3,1,1,5
745,52a3985812104ce79787c3911f57abe3,2018-05-23 14:36:25 UTC+0000,991d4e62fc3d4340b142485b8427b416,4dc61581ec7b409bbd037e483f53ba0a,0,1,1,0,2
4385,52acc38df1374605a435026a595df5fd,2014-10-01 01:44:11 UTC+0000,ff2f4411e227433191f98dffaf040a72,b7d1223032c446d686cb258c654aa115,2,1,1,1,3
5407,52bcf137524b4fa1b40cf199f77d12c9,2016-07-22 21:55:29 UTC+0000,b96afb0a59b84a3c8fd0bcd986f3c0f7,8147e4d83ebc47b689901dc534981de8,1,1,1,1,3
2796,52c9dd99f2ad45bab19734bbb43d590a,2016-07-31 02:12:01 UTC+0000,fc709b4d788f441c92da57b6ae70a18b,c258f388f42b4f608dd6fd8e9b6c1dd6,2,2,1,1,4
2191,52d796f66d7e4f4b81970c4ab66f1469,2015-11-18 20:56:18 UTC+0000,a2eab0c5a9214aa1853c61131f8d54e9,a1006e6a58a0447592e2435caa230f78,0,1,1,0,2
6098,52e7c51fffba4cf485d8c447133c7de4,2015-03-23 20:23:52 UTC+0000,d9575a22357644e6a3e4f7de70db61cd,05444a2f42454327b2ac4b463c0adbe0,0,1,1,0,2
6693,52f51400e31240cbbd2b88133e3dcee9,2017-05-02 21:01:17 UTC+0000,632c019479b44312aff0910489bdab89,ace7c8056c834104a8378c86e7fd0180,2,1,1,1,3
7114,52f62e1066044f2988cdac1c08a0f561,2016-08-20 00:28:18 UTC+0000,7206e54ec3744b8180f6b513b6276603,dc28056163a8447686e5691f4c1475b0,0,5,1,0,6
503,530000c3b6f04214a90cfdd967dfc5f9,2017-05-05 20:59:24 UTC+0000,7004b3aa7b6a4926ab016cf29f39479f,c258f388f42b4f608dd6fd8e9b6c1dd6,3,1,1,1,3
2105,530f68ca5bbb43f7bc20c6a07539c97d,2017-05-19 16:12:02 UTC+0000,d5ad89500c0b4db189d089f6b29664f3,75b168e0dc4e4bf28cff7754567ad415,0,1,1,0,2
8003,5316c679717b415f96ed629bd7f0414c,2017-04-29 21:34:14 UTC+0000,b8cd418f314742d7a3d47176f6500a59,36ff3b3666df400f956f8335cf53e09e,1,4,1,1,6
3600,53178581d92d4a599c51973e5169c591,2018-08-14 13:56:29 UTC+0000,23450c88331e4401b786e43e10ee993b,b56e79f4a4dc47b08d16620fe7760ae0,0,1,1,0,2
1731,531e294423ff4b859717ec8c2bfb4ac1,2016-06-06 00:02:04 UTC+0000,700da0f24ba04ac5b437ff6e51ddf1e3,58fa5e95fe9e480a9349bbb1d7faaddb,0,1,1,0,2
6110,5322f88d1b6f4ac2b330924250944fa9,2015-03-27 15:14:39 UTC+0000,306436d061db40359a35848fcd20ea2d,8ebb786d56fb4fb18888beb445bab5e1,1,2,1,1,4
7756,536b9c862ec54775ae5c6d6207a4c94a,2016-05-15 23:58:55 UTC+0000,61e15a556a274a34a854b874f42861e7,cfd777ed4f5a428fbe28e76e06ab858b,2,1,1,1,3
2671,537d62d1396a436baf2c642b5edfe229,2013-09-11 10:53:27 UTC+0000,a87dc3f96165420dba30a41b894d71f6,0dc4c381bda94701a967703ccec5c676,3,1,1,1,3
4357,537f41f9c2844cd3b1195d54fed3e181,2016-04-25 15:29:11 UTC+0000,5c86d2b5dedd496cbef04d5c148f46ac,81eb2470138d44abb5e5a16053f75e6a,1,1,1,1,3
5894,539a7b90c9fa445a94744feadd7034dd,2015-08-10 19:09:04 UTC+0000,e28d62bab8fa43668f48843ec79fed9b,369f1c8646b649f6997eae7809696bd5,3,1,1,1,3
2567,53bef4c02eda4fd1a776b62ca628aedc,2014-11-11 14:51:23 UTC+0000,419ccfdec0ce4110bdf0f60f1e38926c,0355aaad83704ad98e6d71b79db85849,0,1,1,0,2
3449,53d4159d4edb4e67a57052e4237fe381,2016-10-08 17:51:03 UTC+0000,eeec760c49bf40b28111b427460383f7,0b17f4e9d93c40eb9a5d087865084ce6,0,1,1,0,2
1267,53d4dc0104f4415cbad751326e054d93,2018-09-18 17:41:38 UTC+0000,a87efeee4f824e29b59173a4eb3315a4,36ff3b3666df400f956f8335cf53e09e,0,1,1,0,2
4947,53f2a83894d2459a922b370589072bf9,2016-06-25 04:16:19 UTC+0000,349d705fb03a46bda390daf4aad81b6f,6ea2a8a29d904015959ae16913092ac0,2,4,1,1,6
3099,53fc55102c83483eb254fa83c1f01aba,2018-12-06 01:12:21 UTC+0000,551e6c7966264836b41579b91b58b3fa,909eb5c8d66e4fc185656ea6772b127d,0,1,1,0,2
4697,5403fdea4e924c3b803dee4da1932582,2017-11-01 17:28:18 UTC+0000,aacbc693ba2a4b658123aaceb48bcd16,d2db5801127b4e3399610833c3239e3b,1,4,1,1,6
2245,5419620bbb8643f6ba57074209b14cfa,2014-11-25 03:49:58 UTC+0000,f086669608bb4dcaa57a259cc5423469,e0fbfa616ab7409b8263f4afa590fcc1,0,1,1,0,2
6265,541cb67dd6004f6bb497fd3e628c3a51,2016-03-16 14:18:27 UTC+0000,a5addf2f58f0473ba69c9bbd9539c7dd,92ab430dcffa4a3d8225bb27698bc7fc,0,1,1,0,2
2464,5423cd9e371445dab32e4b7f55269649,2018-03-23 22:43:34 UTC+0000,f6f56249f734445a8578f87923ac0bad,887c5a142b42466fb74740d72989fc74,0,1,1,0,2
3644,542a3185d39341228d2be6f9e13d38a8,2017-05-01 02:39:23 UTC+0000,33ed0fe803134aa9aff4db974a8be127,be5d23056fcb4f1287c823beec5291e1,1,3,0,1,4
6854,543ebe63085d449aadb60c98109f4304,2015-03-24 15:06:05 UTC+0000,e2d5606f783946f08d01d1f49896d51f,b953b3a5cd564558a13b7bbe04dd0fd2,1,1,1,1,3
7005,5441bd05fd3b4921ad6fc57965e78bd4,2014-01-03 00:20:59 UTC+0000,88c25438575b46e3851aa145e234fd59,3e0f8b09451c4a8b9ddce027951685f4,1,1,1,1,3
2946,544330da6bd747d28be729b45aa44099,2017-07-05 15:46:09 UTC+0000,bd910b8f9dd04a668ece7694a545e29e,704f599b85354ca4a79ca3847f585ec8,0,1,1,0,2
6141,5448c7bf54b04e5caffaea2dd96cb976,2018-02-08 14:07:05 UTC+0000,2d99c0286ce645cd97481a80a9c87f2e,826e706f2e564d52856aa71abff6a00e,0,1,1,0,2
2112,5455e3b16a16428a88a90e523869f64b,2018-10-25 15:37:32 UTC+0000,2745031b18084a748c18726ca16c2ad1,a7bf251a290b418e923e8f04a67b7ebb,0,1,1,0,2
2509,547a388a194f4e4b83e97d1c11f25af2,2015-12-04 01:30:33 UTC+0000,3dc8abd6917a4c0596ad03d758b2467c,920deceacb504890b1a20201616814c3,0,1,1,0,2
4064,547d32ea5c804ad49c7da0d84b4fbefc,2018-10-09 00:53:48 UTC+0000,bd4bdb6cf00f470a88dbacb84b814dd9,dc28056163a8447686e5691f4c1475b0,0,1,1,0,2
7283,547eeaa69d2d494384a6c63ce3da393f,2016-01-24 01:57:19 UTC+0000,32bb403071ca422fa22611c5b47eacf0,a1006e6a58a0447592e2435caa230f78,0,1,1,0,2
6217,5481d519e67847b38b818776153a6859,2015-07-22 18:40:02 UTC+0000,7059785b7e6348548fc037083813c269,6d93ef38f5bf4250b08ffb183c463f46,0,1,1,0,2
7779,5482bb6eaa254d508a01716db2ef4286,2016-11-21 15:28:31 UTC+0000,cb78cd3fba8d4dc8805222170e98a415,8e8bdc9e013942029523cd32daab22f7,3,1,1,1,3
6917,548e83ea253d4da389261b03737bcfce,2015-03-04 14:23:42 UTC+0000,035e017f51e244099bb62f3118ffd482,369f1c8646b649f6997eae7809696bd5,2,1,1,1,3
7488,54ac43364349441c9935a12497ad0f67,2017-02-06 13:06:26 UTC+0000,b0b15d8c4b9242b3966b8aa426b1691f,d9bae0de3da04c7ebbe0879d410a8179,1,1,1,1,3
3799,54ad2f36e5104700b557c7bf35d08d19,2015-02-25 17:56:18 UTC+0000,ceeef55ad784422b936a81cadb85a574,3610651286574769b899efd7204265f9,0,1,1,0,2
3179,54b0874d8fdf41a99b38bf6af9208ae0,2016-12-19 12:25:28 UTC+0000,5f43dd65570f46b097a438dc0a996e3b,a1006e6a58a0447592e2435caa230f78,0,1,1,0,2
5009,54b3a64084004bad975223f1c50c884d,2014-04-07 21:36:23 UTC+0000,848c29e0c24848f8a7589a2f2fefbe05,fe4543418c0846e5a65fa22b4ad9a304,1,2,1,1,4
5609,54d3762d106445a3a5dd50f6c50eb58b,2017-03-06 01:55:22 UTC+0000,248e264fe8404b678a01463bdb7c98b4,be5d23056fcb4f1287c823beec5291e1,0,1,1,0,2
5939,54d68f3d3dc54a5eb23ea1be4534b4c9,2016-05-16 22:44:36 UTC+0000,1d9baa0200584d04860b825662aa884e,8d0985f515fb4c3482fce4cc9cc9783d,0,5,1,0,6
6115,54daae9f120c4c1db36044da58827c83,2012-01-27 04:57:58 UTC+0000,574bd06c5e344a938795c3bbf92d0014,81999d5ad93549dab55636a545e84f2a,7,1,1,1,3
1459,54e31d6fe3424e318fe4e768104df089,2016-04-29 13:42:45 UTC+0000,6a580d364ab84c4894381885f3ffc322,0a429e7732d64e68aab95e7a4ff6e8d4,1,2,1,1,4
1044,54ee4a3e16f647049ffa81f39f755d27,2016-01-08 13:37:32 UTC+0000,dc9f9523447b43f3be178f58b9857a43,f35bb614ae6c4347b2f8bf89251bc6cb,2,1,1,1,3
2492,54eff07a465e425c9a4d67e8cd7bf03d,2013-07-11 15:30:36 UTC+0000,69f4846f1bd2491d9e9972bef47081d9,2adab7916b3747af85b2d82e188c1dc3,0,4,1,0,5
3240,550c11c9771d4e77b4f978c013431441,2018-03-01 13:20:23 UTC+0000,e687ec2c28b64de6b0117f3709e656e8,e1d39b665987455fbcfbec3fc6df6056,1,1,1,1,3
1385,5514c206cc05421f8c634c18fda1b42a,2015-10-24 20:59:17 UTC+0000,93f0fdae5aab4a789d5c0b8d007c3fdd,36ff3b3666df400f956f8335cf53e09e,1,3,1,1,5
6620,551e520e951d455d9cdd8655d3ddab7c,2014-08-11 13:27:03 UTC+0000,3d3e4b75d52d4e228e49569fa5c218ba,05444a2f42454327b2ac4b463c0adbe0,2,2,1,1,4
1394,552d50f5579c41e6883fb962e6fab6cc,2016-12-26 22:28:16 UTC+0000,828feb0d9c1c4a4eb002a4c84d7954f1,a1006e6a58a0447592e2435caa230f78,0,1,1,0,2
1917,55323df85b5f499f891ea118248060db,2018-01-19 19:48:22 UTC+0000,1e7a4f986a154154af73be0cec554f0c,4726d9fe14ca49d981b08890cc373993,3,1,1,1,3
1985,5535fa00bf144f71a8b6f7dfc861a948,2016-10-13 18:47:46 UTC+0000,4c5e4ccf184741cca00b28ed6f74924a,2a3e4ed0d0d3495f85f6b8b735c590f1,0,1,1,0,2
7781,554d1b83e8fe41d0b94e2712ad5a5d36,2015-07-07 21:16:06 UTC+0000,4cc8b1c5ed3645349d5f66c0ad87d65f,369f1c8646b649f6997eae7809696bd5,1,1,1,1,3
4276,5553e5ddefca416c92c84d7e36649686,2015-10-26 01:36:39 UTC+0000,27898dd4b2b84b9cae365788577948fc,e6f749cfd2634083baac3f0d1bc0449b,1,1,1,1,3
4506,5562e531b6f240989f317290af9db284,2016-12-26 04:30:17 UTC+0000,b210de36dc914d2cad569e49488a3214,36ff3b3666df400f956f8335cf53e09e,0,2,1,0,3
7155,55672db8c44946479bf3db21b205e43f,2016-08-24 00:23:55 UTC+0000,3f248fb2c188417cb827ddc07c5573a7,50d1429c5c6b44b59e581b53c92c60b5,1,3,1,1,5
3331,556a3322b0df4e25badf8c2cc36407c9,2019-01-08 23:12:21 UTC+0000,83816ac4e2f849dea631e47368289200,3e901e480287430fac7adb4f9b2ecfb5,1,1,1,1,3
1965,557373a3301a4db08879c95488bd6062,2018-08-21 00:44:27 UTC+0000,7e029d8f7b714f1aa0b9e98bcff3ded9,36ff3b3666df400f956f8335cf53e09e,1,1,1,1,3
409,55833e86a90d4789a0d156920e7bb6a4,2016-09-05 15:55:23 UTC+0000,36eaccf41ed1413389cc6873f0f58e36,5f95b0ac821e4e8e9b4fa9fc8eb9ff61,1,3,1,1,5
436,5586a422f4aa4128ac3c5f1713d5c262,2016-03-11 02:52:54 UTC+0000,596bbc6f0f5e4b26b672b02c58e143e8,64fdb079c8bb499896c91874764b6910,0,1,1,0,2
7761,5589a235cfbe471ebd22e7a1f74a93ac,2015-10-07 17:37:32 UTC+0000,778d1a0cd9364eb69dbc9501a14d08f6,fba0925c233d4f8093de3bb6cbcd9641,1,2,1,1,4
7712,5594f3e6405042e68bbd0d6cd2b6bb6a,2015-10-26 14:18:02 UTC+0000,53411023a0c94b2db77ecbdbf820dcff,5e96344ef7514af6ba0a4f4c2a070b87,2,1,1,1,3
4040,55a25e9f43a54417bf96c038acb0f6e7,2016-10-04 15:24:26 UTC+0000,b9f7210bf05a4ea5a49ddf9de3658653,bcdfc56380fd4f9c877021e815a2ee6e,0,1,1,0,2
6164,55b04a06d5a343a79848ea8e1c1966a7,2014-04-08 23:04:46 UTC+0000,40fdc17a5ddd408aab89da0d101afd75,fe4543418c0846e5a65fa22b4ad9a304,2,6,0,1,7
3705,55ba697c784545c1bbc8b4e9794a0bd0,2016-06-10 00:10:38 UTC+0000,14bdff6a3ad140fcb93c60c70ad43fbf,7f3b11c0f75b44e39543a21c1e320f12,1,1,1,1,3
5247,55c03079f36d49288fc43207fa497107,2014-04-15 17:36:06 UTC+0000,2978d174728c406096313031fd372d2d,fe4543418c0846e5a65fa22b4ad9a304,2,1,1,1,3
5716,55c4ec568ec84118931808493e981e2b,2017-03-22 20:49:10 UTC+0000,7f857e77863c439a86b043edc1f6136a,54539d99e4304cf0a18357bab287dcf1,1,1,1,1,3
1607,55d1495ae5854029b27dba8d00860976,2016-10-20 00:08:36 UTC+0000,0b9970dabc7d40fdb65a37775b8e1039,428b3e58119c4f86b2cd628ceee8fbeb,2,1,1,1,3
6520,55d2ab4cdcca496ab73ff14879507fa7,2017-01-13 21:17:32 UTC+0000,096be703c5b74827be9d92a3e27aafcc,a1006e6a58a0447592e2435caa230f78,2,1,1,1,3
3139,55d2b3ce5898473ead2b3f3682c31343,2014-04-08 12:32:56 UTC+0000,a8a062cd51fd4d25ae2b3ccd04769f47,3d8847ddc8d04185976a9e78b190ebdb,0,2,1,0,3
1913,55e516c2ca5d480592ae40bd9fc99a89,2018-02-16 18:22:31 UTC+0000,623fbc8e882c4c2eba735f2ca25427a1,7ea8bf1cdc884eadbda0346ace69be66,1,1,1,1,3
2063,55f8b88b2adb4b558b008c76b7a1696a,2018-03-08 05:49:24 UTC+0000,7634c2dbc56a47f78f2ec7591ee2466b,265f8307ac4a4a55bdba8e2d47550620,0,1,1,0,2
1793,55fd85f79a9c4d509f9f666ed496a315,2016-04-29 23:53:20 UTC+0000,f175c10bfc954bb7b59ed0ba424d1012,fe5fc534894e45c191e87f8c2ea0c6bd,1,1,1,1,3
5225,55ffd7ba3f5b450eb9158c4d924b7f08,2016-06-23 19:30:32 UTC+0000,106e78fe125644eb97dfd57635520e62,42deada7c50c4859a34615d70193317e,1,1,1,1,3
4966,56050f0313b9488d9e31c24e36f34266,2017-09-02 22:14:51 UTC+0000,d7fe313a6bb34add99638d318569ee2c,83cfc4f44b9d4fef8cb95530319d8b53,0,1,1,0,2
2093,560ac11ba19644f6b6b40d65150878da,2018-01-24 18:54:01 UTC+0000,a08d051b34b5418abeed33c0350203a1,0bd0643ed5e24bfe8706223970a0ed5c,1,1,1,1,3
5517,560b9d73505240d0af356594649399fa,2017-12-13 21:09:40 UTC+0000,a459d69496f143269fc0668d48aa436d,7d45f7fd74ef42498de1b67a3f6f7e38,0,1,1,0,2
2922,561934444d474880a93546e5bbbd8b9b,2017-01-21 02:32:15 UTC+0000,754fdf4f95744387a67d8effc38d0f36,6764761f177e43879c232ec50fd9bbe9,0,1,1,0,2
1713,56204940b3f54cb49b930556b5e74365,2017-05-17 11:27:58 UTC+0000,fddc0a6901ee433b87a6318aa1302fe2,bd6aed48e54f43ff9e3936349ca9fab9,2,1,1,1,3
1750,56360171a1354ffdae526c7fb3ca2a8c,2016-05-16 16:43:53 UTC+0000,5b1b131863d5406a937dc58c266fbe5f,8289453ddc724a09bae95e94d2425856,0,1,1,0,2
5602,5637c3537aaa476fa285aa243335cf51,2016-04-20 19:42:15 UTC+0000,6c6d39a501174f6f95509db2eb170477,36ff3b3666df400f956f8335cf53e09e,1,2,1,1,4
5187,5646c7062d20460681acb806edcf5cef,2018-12-29 00:12:57 UTC+0000,4e6fb1aeafe8422884a59d5c0877518d,9a00ca5482364b5ebf8d38513e7310dc,0,1,1,0,2
6199,564dce01df644d1685e79e627a17b997,2017-10-12 10:48:06 UTC+0000,71fad473e6d04d708863f1e6137cfed2,393bb163114340119a88944a061c397f,1,1,1,1,3
4425,564ff65f4caa43508388703d082474a1,2018-02-21 17:37:48 UTC+0000,a16580ad96814405ac679595906bff83,6938283635004fe49961bf8c64f6bb43,2,1,1,1,3
4009,56698effc0c44433b01095a745cda05b,2016-05-16 14:07:20 UTC+0000,37afd95217ca43fcbf123f37662fb751,57e26a0b2ad943468bc42fd35f9fdba1,3,1,1,1,3
2079,566a6dd1cee4471393f1187979af8100,2014-03-05 23:11:33 UTC+0000,59b57e6579864ecc8aa5c8a35948213a,05444a2f42454327b2ac4b463c0adbe0,2,3,1,1,5
7063,5694a1c968114b2283bda2454222fe3d,2015-05-26 15:37:00 UTC+0000,30795b027af64ff4902bf0d1c61d6935,7cce25cc8c1042b1b4f135bcacfdad82,1,1,1,1,3
6561,56a89f646060441dbb610c9a56c41c39,2015-11-13 19:11:09 UTC+0000,9d979a8849464498bb121efe292b2892,a1006e6a58a0447592e2435caa230f78,1,1,1,1,3
7844,56b95527716a40faa2a47c6ee9290b23,2014-02-03 16:48:18 UTC+0000,9018e55caad2448aabc69494d22fed44,3d8847ddc8d04185976a9e78b190ebdb,2,1,1,1,3
7604,56cc87c954804e90ae41bbb8477f11ca,2016-05-21 14:38:57 UTC+0000,fcf17002206647ef8195c82b5e044fb8,36ff3b3666df400f956f8335cf53e09e,1,2,1,1,4
2998,56ec38c5018743ba84eb29e68a18c7cd,2016-12-16 00:12:30 UTC+0000,37f2ae3ea204450386dd73a4283908e6,be5d23056fcb4f1287c823beec5291e1,2,1,1,1,3
973,57021943981642c786428780f4e4b9c0,2016-05-10 14:21:17 UTC+0000,24790b2367f24413b6dc650042ad9868,952428ab5d6849f9a9d30d2f5bb5b391,0,1,1,0,2
568,570a317d94914b51acb58c79df025df5,2017-04-04 01:05:20 UTC+0000,162f6aaa17bd45de9f5d2e9eaa3fe3cc,bf6edb3e76b94594a982c5776764cf75,1,1,1,1,3
3446,570fbe3b01b7496d9ab142abf766e557,2018-01-25 12:52:42 UTC+0000,cea4637e85d0494491eb1ff5f39039c9,5ec9d442785a423ab4c0bf1dd110071b,1,2,1,1,4
5099,57117018912340698667dc593952092f,2017-05-08 22:56:11 UTC+0000,97a3d72a611640bda40a838fbf2aedc4,097d36ea4706463fbca6f0d657d80021,0,1,1,0,2
4936,572935df9d7e4d71a7ed80b72d21e4b6,2016-07-27 14:49:46 UTC+0000,889028d9376c41abba54b71f5564345e,286b35050a2e424f86d1a2c50aa9b595,0,1,1,0,2
4605,5730251c33e84a6ab80149f6d268454c,2016-06-30 00:14:19 UTC+0000,31cf86373da74f96962ab89f0ffb0e09,5b85a1dee8b74d79a87d53e758d897c4,3,1,1,1,3
887,57320a334abc41b1a1715af9518ad96a,2014-09-16 20:29:07 UTC+0000,676cd3aaf1344dccbbbea80fd3486e23,340c27afe4e44bce89f7b292a50b179e,1,2,1,1,4
7885,5736b32a9db8428ab4037338d1103821,2016-05-11 15:55:41 UTC+0000,16a780bd43a1439c8a5e3bd61f7612bb,a11a04feda014b9485d042e321ec17aa,1,3,1,1,5
5158,5742e19b0bf24ac883ecf204aa54112a,2016-02-09 21:32:55 UTC+0000,4f7f7b13d15f4eea9365b3a0b1d5ec5f,a1006e6a58a0447592e2435caa230f78,0,1,1,0,2
2599,574ee72016c1431382527b059cb8f7cc,2016-09-12 23:39:32 UTC+0000,44b1ff25fab64a888457f8ea6eae3e0a,525836fedf034f7286c56f91f4f1ab48,1,1,1,1,3
1606,574fd55dec78487faafbf4ebc5dbdc2e,2018-03-22 11:27:57 UTC+0000,5a3e832d8ff14487a5c3324a4c2af0be,107ec56b4e7948439ee5b6b946f576d1,1,1,1,1,3
773,5757c9b13ae5454dbcfcebf55e949ae4,2014-07-18 23:03:51 UTC+0000,141732facb594c9ea573030771f84db3,93740a4bb6624eabad6f2e69e80c415e,1,1,1,1,3
7151,576555fbc9b640fbb319f772543d3a61,2017-07-11 13:12:59 UTC+0000,e4bb461d230d46da935a9a84d601018f,32c5b4ffac524531a64b161442a64510,0,1,1,0,2
7091,57759720c9c04a8fbbec30381f429f31,2017-01-04 21:04:01 UTC+0000,725b85e8ec264afea67f9b73b8e7f74e,36ff3b3666df400f956f8335cf53e09e,0,2,1,0,3
3917,579245b8df264e6e8bcf1a2bb081ac20,2012-10-25 02:55:36 UTC+0000,fd1928c9550741ec84b6867c2cefe4e5,4f426674724f4753b6d6292b33edf31b,4,1,1,1,3
846,57a26aa4cf9b45c89643708eb83ba33f,2015-10-26 23:31:45 UTC+0000,217fc2e23f3b41de84d905e2080c5f12,8435fd16c86e492885acc2cf5b6e372a,0,1,1,0,2
32,57a36925c9134d8d99ae969053f3b0f6,2018-02-16 15:04:04 UTC+0000,1ea3d98a8653413d8bf6854815d1c805,92bfff6673fc4a9795a09210bdd4ae95,1,1,1,1,3
4360,57a5417f0b1e47e48d25b571ee17b523,2016-05-19 12:20:02 UTC+0000,1276e9e454a8456caaf424bf609717ad,01c0de6835fa4a3bab76a8158a02ae3e,1,3,1,1,5
7432,57a71dcede574a71b310f6051e7842be,2016-07-16 01:55:32 UTC+0000,fa0254a197a445b2a327f9983e114499,fbfffdeaa5b24cacb0a93a00f93dd54e,1,2,1,1,4
1330,57ae577717d549ed80fbf0b58fe424c7,2016-12-26 22:32:42 UTC+0000,726c4d21b7ab4580995822b5c052f2bf,a1006e6a58a0447592e2435caa230f78,0,1,1,0,2
3188,57b71988f87446b3be35ae40ef98cb9d,2014-12-12 15:08:20 UTC+0000,32c7202096954fe59aaa3de090eff073,7d425e8d7cfb4fe7b0702fff4d6d84e7,1,1,1,1,3
2059,57c26aaab2094e8b83c092385e34cb43,2014-07-25 17:47:49 UTC+0000,50cfc2614ae742caada125bd0000fdcf,e3529e64e70643b6889353db79eeea3e,5,2,1,1,4
3525,57cca922544845da81871e9bf403c0ba,2016-04-28 17:38:16 UTC+0000,59beb0b9b5704310b5565dbb3c7fe8c0,d1f04208de3643c088f4a25e57f1cb2d,1,1,1,1,3
4681,57cdc2cf562a48ce825a777a84e19214,2018-03-21 19:57:09 UTC+0000,a3ce37d44d7441c280d0834c2d6c3a53,4dc61581ec7b409bbd037e483f53ba0a,1,1,1,1,3
7804,57d53326b70547d9933b73d040ce9df2,2013-11-08 07:38:56 UTC+0000,9a9eb1c083224172bff40127c40820b2,4bce59e2537b4228adb73b856d2c6102,2,1,1,1,3
3876,57df8b5ca0f6415e8eeb23d6d2db8f6f,2018-09-05 20:07:12 UTC+0000,b18874c671fa46e798d9625fec2abeb5,9d156b9a1650453fbeeb196f47c89576,1,1,1,1,3
6599,57dfe1020b3b41b5a9400fda9200f7bf,2013-10-03 17:59:04 UTC+0000,2c9d9fef19634b419d71b02a46df51f2,ea4326220b3042e2bb38ea35514f7321,3,1,1,1,3
304,57e2149b3d0f490c9fc07d8702f3297d,2018-09-27 21:46:33 UTC+0000,f7b231001ae1488d813bf6cbf635fb81,2dccff1a117b4af8be9a42240f84761e,0,1,1,0,2
3735,57f394f613fd4761aa83ab6eb52adcca,2017-01-25 16:43:39 UTC+0000,c83efbd54e5c477db1e9e13b73d57483,331c075b95c74215b0435818457f0324,1,1,1,1,3
6765,580f95d9150d4e8c815d230bc8827bac,2016-05-19 00:52:32 UTC+0000,922c9a1e374147da91760aaeccccecd2,be5d23056fcb4f1287c823beec5291e1,0,1,1,0,2
2471,58139c6f7aaa4293afe397ab16515d6a,2012-09-24 02:48:58 UTC+0000,c93067c752b24acf8087cea17d101ab9,a96726e8c1e14e099965898bf2c4d2d5,7,4,0,1,5
5617,5814bf0c788148f1b124a99fbef43080,2012-03-29 14:46:21 UTC+0000,de648e8b351d4db888f4f71bc4c2c380,7d425e8d7cfb4fe7b0702fff4d6d84e7,4,1,1,1,3
5409,581766816142411991ca61b37f446011,2018-02-16 21:21:49 UTC+0000,b17f7c0eeb1f40db9738120ecc2a463b,6938283635004fe49961bf8c64f6bb43,1,1,1,1,3
5229,581de2f50bcd42459f81d844b8906667,2015-02-25 06:45:06 UTC+0000,a1062591417f4151b96a68fd294e771e,56444eb4b925439186a995602e9d7037,1,4,1,1,6
7258,58237116ccc94579bd25dae8edf4dc2c,2015-10-07 18:05:03 UTC+0000,8b6a0bce19354952b5a7ddc1d2dcc121,180fd080660449da8cdb139f033ec4e8,0,1,1,0,2
5704,58261485a4334a0a9f1c1eb18a2d8957,2015-10-28 18:11:59 UTC+0000,f2ec006de33a4c8c9021eb84717a92b8,a1006e6a58a0447592e2435caa230f78,1,1,1,1,3
3128,58492469199f49738354e2280e52fff1,2013-10-11 01:47:04 UTC+0000,113fa3c2600e42b48b8d51238381d462,47e48174d0854928908e62ca34b026bf,2,1,1,1,3
6449,585048f787764f7f9f9af70e4ba82be3,2014-04-19 04:53:52 UTC+0000,a4867ea58a2048069637602a2decbfe7,fe4543418c0846e5a65fa22b4ad9a304,1,1,1,1,3
1612,585833caefe84e15a0276710632a96e2,2012-01-20 04:26:28 UTC+0000,e78bc11b17d847fcb1fb391fbd8ae88a,7d425e8d7cfb4fe7b0702fff4d6d84e7,12,8,1,1,10
3430,585ebb5f61db4c68affabb680bf763ea,2018-02-15 20:27:21 UTC+0000,07c1d150493e4fbc93d1e63ba288206a,864b256290d243d38afb68afe60d847a,1,1,1,1,3
5031,588e414dfda44ecd83115c731ffd02a0,2017-03-12 21:55:35 UTC+0000,8ad9e9b108f94ac18a02e4055606df8d,be5d23056fcb4f1287c823beec5291e1,1,3,1,1,5
3710,5893f5f1d4b44a31a934af1d76e6abe6,2015-03-27 15:55:16 UTC+0000,cb8e3651dba44fa8bd0afc5ec6ab6630,8ebb786d56fb4fb18888beb445bab5e1,1,2,1,1,4
1708,58a6b0cff4754d26b1da76faf8d906c0,2018-08-24 13:36:57 UTC+0000,ee5500cf8ead4a6b816e0c01123fcee2,348394c7ede6467c98f59d53dc0b0284,1,1,1,1,3
2144,58a7d0dbff744be099fb621cc60b7348,2018-08-18 11:44:51 UTC+0000,5666a6a885df42de86b50fda570d06c0,36ff3b3666df400f956f8335cf53e09e,0,1,1,0,2
5975,58aa49a7dee243b6b1b5da2e1044cfdb,2016-03-01 19:04:22 UTC+0000,b197fc40b611424595ce47b5071ad355,bdd28bb878494d4bb10e7ae0afc3ec0d,1,1,1,1,3
384,58afff74ea594886a49d42c02639e598,2018-10-25 01:58:45 UTC+0000,785755e040a34287885aa2a3afc6f718,e2b4c84bf1ca4aea9b108869692d8017,4,1,1,1,3
3431,58b36728be4a4a7aabd7f840c53cb347,2015-05-29 16:51:03 UTC+0000,d4cdf603413b49d499353d573688e7ad,369f1c8646b649f6997eae7809696bd5,1,1,1,1,3
7157,58b93fa9904543c0997a2bafd9e5bd52,2016-05-06 02:25:32 UTC+0000,5d51b677582644d59bbfb1b349994614,58fa5e95fe9e480a9349bbb1d7faaddb,0,1,1,0,2
6188,58e2d8c331084a4aaaf51dc6b6978c8b,2016-06-25 16:20:38 UTC+0000,eeff47e6745f43659aca4a021450cd98,3dbf68e5ac6f45549bba213fcd71c913,1,1,1,1,3
97,58ee52a3165a48a2973c78fc14c84325,2016-05-17 12:03:26 UTC+0000,c431ca6f157143cf91ff8b33301d2f02,9428eb3c67e540f3a1d3e5f2649656dd,5,16,1,1,18
7437,58f1623abf664b1eab4065389ed4855d,2018-05-03 20:07:35 UTC+0000,2bcc6e43576d46fc9a810993ba685f8f,4dc61581ec7b409bbd037e483f53ba0a,0,1,1,0,2
5076,58f76d4486be47768486f3c0a15f7abb,2016-05-27 00:01:22 UTC+0000,9f7978c8e7894757914bc6c9a23a25af,47b0e0eb62da4ef3ad95e1ffbf0d72fd,1,1,1,1,3
850,58fcc685fda5458bb0aa51b1b8a1afeb,2016-04-28 14:25:22 UTC+0000,22a60c06378b4564a868089ef4a30671,d1f04208de3643c088f4a25e57f1cb2d,1,1,1,1,3
5574,59093e552648408faa57b80a055fc7c4,2016-03-17 06:00:48 UTC+0000,704503bd6f404cf9a5c9b69e0456d267,e6ae38ca62d5423daa34d7088f4295e4,4,2,1,1,4
7105,590e99e172a14b2f860b29cb516942d8,2015-04-02 19:54:25 UTC+0000,0d99517e953b46cb9b1222fc9f907877,2c285600a07f43508baefa37cd53cc02,0,1,1,0,2
986,593ba47b6c27423b9818d0fd24a16661,2011-12-30 03:54:49 UTC+0000,47554a26bd48497da0f91e3728ef6675,8fa038d69f5647a091c766bf460d2616,1,1,1,1,3
1228,5952f59cb43b4c3ca9e99993410ecbe9,2016-10-13 13:50:40 UTC+0000,e3f5709abf724e55994c99b762e8a236,9b1c83cf58f6497f8c0a2a141b86b034,1,1,1,1,3
3402,596608b421214610b15c5ae00d295adb,2017-02-13 00:32:26 UTC+0000,2efa470ab99d400a8827e2d46376bb09,665a4dc589d94329b7a752ad551830ba,1,1,1,1,3
4528,59666f60e4094cf9b12d2ae02eed37eb,2014-04-08 23:25:19 UTC+0000,c6f9380d88744096a40c3156751aa9ae,861fca48f47c4fccae43a799f4442684,2,1,1,1,3
4876,596d2d1c688b4950807647a4b112b6c6,2017-10-05 20:42:20 UTC+0000,96e705f8da3c4bbb9ed8cd72e10b6571,eae09bbc30e34f008e10d5aa70d521b2,0,1,1,0,2
6774,596eabe5ca18408d9b15ea5aa69dc0c9,2017-05-04 11:46:19 UTC+0000,32f10c83f6374f36a9881b0f156e854d,bdf6bd58b5ee49e0ab03bb52a4945d2b,0,1,1,0,2
1435,5981d6c007aa499f9cb81a8e4bcee007,2016-10-27 21:11:57 UTC+0000,8ce6b994068c4ef9a2a8bc1dd110b097,393ec95ca2094e41b6a66ef9f940f768,1,1,1,1,3
6079,59984ddb9c294f0b88812a01b6f50b1c,2015-10-06 13:34:00 UTC+0000,fbdeb875b0704099967ad8e9fae1ee8f,ec1ddfc8de6c40aa9ed91b502050a6ea,1,10,1,1,12
3279,59b2d50f44774800998f13e065c61692,2017-01-04 00:27:01 UTC+0000,39d17c67dc544b6ca80b8d19e055b882,36ff3b3666df400f956f8335cf53e09e,0,2,1,0,3
1054,59b331e014aa427daa2d591384695b73,2015-09-07 19:38:46 UTC+0000,4f947a2c4ada4d9f86c52b3ae697d6de,a1006e6a58a0447592e2435caa230f78,1,1,1,1,3
4822,59b412e967c641ca887b4f852ad59ab7,2014-10-10 18:18:04 UTC+0000,296868e0db444563b29bdbe8a7d51139,10a36a30ceee4816a7e7ae25ec25345f,4,3,0,1,4
7574,59bb497f84054cca8c5f0495970fc86c,2016-06-10 16:45:46 UTC+0000,4422062edf004f5bb5a9a8e18fda5072,976b9fe0968a4032ad42f2bb2a94d9a4,3,1,1,1,3
6175,59c9ee394f6c40068b9fca0890de6926,2018-02-01 19:14:08 UTC+0000,2ffc19e1599a4a6c8c64fff22c924625,21d954e0bb414a74adb126fa846d0255,0,1,1,0,2
2179,59f56a4d6e4b452885d4ff7db3ac489d,2017-04-30 05:14:27 UTC+0000,3aa19bef020c48a0975cc088574eafda,1c8d375dd4f0464684b23a43183c5ec1,0,1,1,0,2
2131,59f64764a98f4812a0f392b577a6ceae,2016-08-07 02:23:01 UTC+0000,0e08a5b6250d45aeb1f5263ab4b72533,5b85a1dee8b74d79a87d53e758d897c4,1,1,1,1,3
1591,5a009facd48d41a59ab7fed463369029,2016-07-11 23:54:46 UTC+0000,309ad60fa4db405e84f7611102e8ddd7,4bbd6d03e36b445198780896632a01f1,1,1,1,1,3
4275,5a0bd259849847f2a5f48d4c35292816,2013-10-06 18:30:27 UTC+0000,6c03e2060d2b418bb2b3dbd88971cf09,61e38cc0afbf49b78780fba866f30dfe,2,1,1,1,3
7145,5a1c56247eea421b9736667014c5a4a9,2017-02-07 18:34:13 UTC+0000,8c26f3c22b2c42ef99f417db101c7ad1,6764761f177e43879c232ec50fd9bbe9,1,1,1,1,3
2533,5a22edc65d13441fad2dd6ca76f9013c,2016-05-09 17:41:11 UTC+0000,ee9d7bad0e1245fe9347763db4834e6a,819f5f5dbb664501ab3e300d96e37e24,0,2,1,0,3
5682,5a25d986901c4a78902843a178cf1c24,2016-09-14 14:21:35 UTC+0000,1181c64a8216470faa6113414945b7eb,40f102b1f3c14a5a98e06b27cc643241,0,2,1,0,3
5630,5a27ccbc25cd43fea229be9a45680be8,2014-04-14 18:46:21 UTC+0000,88df6d8fa15d4c7f93819683e62d1aae,4fd49d7ac3ef40b086bd90e09bdb0f68,0,3,1,0,4
7888,5a3719a9742e4b0eba44ab7f4b6fb23a,2014-11-03 19:09:41 UTC+0000,b3007eef6bf24db68dad233aedd340db,77e2af08888a4965aad9689d9b9b34a1,0,1,1,0,2
6986,5a38a703baa8464f896714c47a14b6a7,2016-12-21 14:53:41 UTC+0000,886cdae5e56d4cb983a00af4eaa4c867,0355aaad83704ad98e6d71b79db85849,1,1,1,1,3
3091,5a3c6d9104264b1491f1a14d2e5a2cd6,2014-07-21 14:39:44 UTC+0000,276a842bb0d54c928d6f8a26716de0ea,7cce25cc8c1042b1b4f135bcacfdad82,1,1,1,1,3
5318,5a4ad078513f420f84cdaae92c4fbb38,2016-09-05 18:55:21 UTC+0000,0a6d974b6d984257a6f3c6337bc752e3,a1006e6a58a0447592e2435caa230f78,0,2,1,0,3
3280,5a4e14fc4f6e4b5daf363e829256ae48,2016-08-12 01:55:04 UTC+0000,d183e6bfb8f14f4b9f74e43b94174643,04b72521eb474b8bb79f7bd95e8b637a,1,1,1,1,3
6704,5a5a09f016e8445b9657908cfb3b6981,2016-04-25 22:26:13 UTC+0000,ceaebf7cd4844534b10d2a2be3996124,976d64ba932643938e76adcd31e110ec,2,1,1,1,3
6731,5a76b692dd5642bdabb5cf5b229f4754,2016-05-13 05:14:52 UTC+0000,641d3ccea6774ed7bb3117e02816404e,016a39b2253648af948d915ab30520d2,1,1,1,1,3
5526,5a7a4b6d45b94ffca9b5ab92b3ee8acc,2016-06-24 00:46:07 UTC+0000,c0d07aac735746bfae62c9b27e8a8a93,f1bddf5261b14472980399de58a78a7a,0,3,1,0,4
3170,5a827bd8aa354303b910dd8433e435ad,2016-06-26 19:19:50 UTC+0000,dc16946ffbd04626b097a52c46bbab93,58fa5e95fe9e480a9349bbb1d7faaddb,1,2,1,1,4
4616,5a8f730a77b2471eb477243346ff11ea,2017-05-03 21:04:15 UTC+0000,626802fd04f94e9a96c7e717c3f6487e,e5482466b7fb48cf95dbe26ddd4620b9,0,2,1,0,3
4828,5ac151e26a4042bba475073f6ec772fe,2012-10-01 05:04:55 UTC+0000,ec23f318f5e34bef8f8dd6eadaf756c2,f05b33a454c048f3bbc73f5f3f7f5127,2,1,1,1,3
2045,5ac784b00f8c4b30b3ef77686a560d7c,2017-04-27 19:52:22 UTC+0000,698ac80f40794640b7a710c27feddd70,416321b48a634ac8a53602625f0a5d40,1,1,1,1,3
1668,5ad739747d3a4e99a93b42e45f10d09d,2016-05-19 02:43:51 UTC+0000,204e0bf32cbe4003a3f558dd33b46b47,bb62d86f4d104d1bae1dab379f837a0f,1,1,1,1,3
2633,5ad8fc6b155443b29b28a1454dc2e60c,2016-12-19 16:25:17 UTC+0000,99e6fc128b434af7b87470b60a3018bf,b0c289fe05884b889ac98cea3d47a111,5,1,1,1,3
5677,5afb36c2b30e4f9fa3d3098eabf8e770,2015-02-18 23:13:41 UTC+0000,e38562f957d64a24a1f49374261611c7,24fac8940aff427c848b2a59265c1204,4,4,1,1,6
584,5b0505cb8b8d4a25a7b8be97724d6378,2018-09-09 12:59:35 UTC+0000,99f2817ef8d041e7921e458640a5398c,36ff3b3666df400f956f8335cf53e09e,0,1,1,0,2
6097,5b10a71293914e538b0ab48bd9cece32,2016-06-26 21:45:39 UTC+0000,7e839858a9b9437a940b5d98d44b2026,58fa5e95fe9e480a9349bbb1d7faaddb,1,1,1,1,3
3547,5b1a5f311368423abbbec6368c59dab0,2016-05-13 14:18:12 UTC+0000,51a0b6f44d38443ca848e2ff14ff690e,422412a0f6154a4ebf8f7dd026d66a5b,0,1,1,0,2
5733,5b226ab0959b46be9c2f7e7c6b39f758,2015-10-08 19:30:32 UTC+0000,aa633574569f48828d1731e5ac35b9c0,05444a2f42454327b2ac4b463c0adbe0,6,10,1,1,12
3565,5b2cbf0895c14994b50c2b77ae361ea8,2017-01-26 22:36:31 UTC+0000,74d6637454c24ccda3822a9027e3dc91,ef5c13c48ecf4dfe98a638c6aa593e17,0,1,1,0,2
807,5b467c288bff46eda0826702c999a03c,2018-10-29 18:12:06 UTC+0000,015c350422c943b288b4cd297fef2203,be5d23056fcb4f1287c823beec5291e1,0,1,1,0,2
1105,5b472a5a3e8845aab9dcc40f396b46d7,2012-09-09 06:13:02 UTC+0000,2f93b0539c574844bbfbd80c266ac11d,f05b33a454c048f3bbc73f5f3f7f5127,5,1,1,1,3
598,5b4bf25df2764f5e94ec3226e1e493d7,2015-02-27 17:46:23 UTC+0000,d65a04be944642718411a17bfc83e8b7,c1341204dce1463dad3964c3f3f462c3,1,1,1,1,3
5402,5b4c84a40aa5456b86e3391722885441,2016-06-30 16:46:10 UTC+0000,992c8a82f331467e991ca584f9a49a3b,aabab3ef40c4423bb6934fea9935ac36,1,1,1,1,3
5592,5b59616a9595495f82588cd4d92bfc04,2017-02-25 00:39:37 UTC+0000,b2d593fc800949488abd18eb4763806e,adf2ed6adf1b46f79140c717ed804a6f,1,1,1,1,3
4954,5b7003feb44b4b85bf8f983f4f2a636f,2017-04-10 14:43:28 UTC+0000,c8a1733868ab4bd1932e92b1b2627824,464f1cf7d3de43ea85f8e4a8e6873426,1,1,1,1,3
1924,5b78b7cbb0fa4d05a6a5376e37147510,2012-06-21 04:12:42 UTC+0000,5beb92ced7f149dcad9826438f71fdaa,05444a2f42454327b2ac4b463c0adbe0,1,1,1,1,3
5818,5b796797d5274fbb81bc0cf56b5b7c2d,2016-05-25 14:59:48 UTC+0000,dbd658a5647c430bbf0d0d567982cdf1,7667c23d26ab409ca3e49758f5367925,0,1,1,0,2
2254,5b9669ffd3e845fc9d14e9fb6bfac807,2016-03-10 23:02:14 UTC+0000,5476e23a039e4406aa7c0eed0eca0d0e,a1006e6a58a0447592e2435caa230f78,0,1,1,0,2
2935,5b9d71773b5a4cf8bffa7cd7e4800f27,2016-08-14 01:19:14 UTC+0000,31a99a512e164cbcb24c277d624776ab,58fa5e95fe9e480a9349bbb1d7faaddb,2,2,1,1,4
2310,5b9f5d75ca2f421fa71d4c473c8b1629,2016-10-31 19:47:45 UTC+0000,f822d654fd904108acd7fcf0539631e0,3683da98bba844a19aea7e79e76ff3f4,1,1,1,1,3
6100,5ba467d11ff34486a5b281d873450c49,2015-03-27 15:06:03 UTC+0000,3efc1729583b4af29f166aa9bd042132,8ebb786d56fb4fb18888beb445bab5e1,1,1,1,1,3
5800,5bb80cdf91c048348308c638615c82d0,2016-05-12 21:43:04 UTC+0000,fcb28e57763b4ee18ee7937227f93fca,eef8b7c2cbb145f19e0d4dbb9e62719c,0,2,1,0,3
1128,5bc9f45a73854f1db8a0cb07ebf2295e,2014-03-01 03:46:01 UTC+0000,7dabb21f0dee4f4e8b688ff084e6f7da,f33a960155944fb781de493e371ae46f,0,3,1,0,4
3353,5bd585028efe49f4b89701b84e6fbe8c,2012-06-03 21:05:38 UTC+0000,d0388adf192c4683a1d9a079f88fbd52,0c673e046d824ec0ad0ebe012a0673e4,1,1,1,1,3
4969,5be520424fa7460c9ef7de3ecba233b7,2016-07-17 21:04:09 UTC+0000,c30765d69bba4b34a3dab426c30979f9,5525f642a56e4c6ca01e027e58ed677a,1,1,1,1,3
21,5c0138327f424dac998b7911cb14537e,2017-02-27 06:02:03 UTC+0000,2bd0a2e2f86240f28fb1513a31c6c840,b8b77df14ad94e7bb64f14eeffb72d9b,1,1,1,1,3
3044,5c0b6a14d034427f9fecc0c3128e34d4,2016-05-17 18:10:51 UTC+0000,d34ba7e2c8b446cc9fdeb3e24f85a9b3,460c189dcd074de0a7dd7c85606eaadb,2,2,1,1,4
3685,5c0da564690e4f0686571f2770d933f1,2016-11-26 04:10:51 UTC+0000,cb63339a8d694da6a2180992381590f7,aa27976302f04c74a36ac18825e490c5,0,1,1,0,2
7465,5c136c7ff43346a9830668c0d5160114,2016-07-14 13:47:36 UTC+0000,ac8e3319544b4cdfb9415b5101aa7430,b74860355dcb4cd7a24efc7e16427589,1,1,1,1,3
6461,5c1e4254058247508798af1475fae2b3,2017-02-03 21:18:11 UTC+0000,935d68cb14bf4f6dbd31306d9f8be261,bb4fe08bb5424f08972927d90bad9642,1,3,1,1,5
7369,5c3c2d84b40f48f288740ec3980a36f5,2018-01-26 19:53:06 UTC+0000,08be89d1700b47edb3412ae5427a2334,6a023e22e10842f288c0afb5acd4f716,0,1,1,0,2
6095,5c63078ed74b4e28847c20d9fb72edf1,2016-04-26 03:39:04 UTC+0000,41d7045bd0284d7bb48d6eac1a6b5712,19c30dfeabb64b108617c81d87f538fe,2,1,1,1,3
6671,5c68e06e32494912ab6ed1f9e067efaf,2017-10-19 18:48:06 UTC+0000,563be75b85dd488abec94899758ee370,4847b8b70759483aa8ee280219da1b5f,0,1,1,0,2
7722,5c85053e6e34432cadfde94af0601123,2016-08-04 13:55:03 UTC+0000,8fa2640ed4d84770b2e559ee04de7eba,036358eed7044c66a6058d1006fedbad,0,1,1,0,2
3394,5c89c0955c234fc990facae6b27f4d25,2016-05-13 21:10:21 UTC+0000,385bd798de8a40218292ee82f601069a,d3ba15fee0584d72971b06fb5cff6fae,1,1,1,1,3
6804,5c902cb824c9407f8dc9f4b1e5577c2e,2016-05-17 22:34:24 UTC+0000,ed609198c3ef4a01bb2a6e33a1f13995,ef359653a8af47328b5a47879590bfdb,0,1,1,0,2
3883,5c94e46ffa784e4196d5fec4efa4a717,2018-08-30 20:50:27 UTC+0000,298bc83feeb346a395ac2175dbf225cd,0d2a7e6e2d944dfe995c2f5e188bd2fd,2,1,1,1,3
4938,5c9a201436434f649744b7783c40994d,2016-05-11 19:41:44 UTC+0000,831818e1ae294079ab71c4060bea963d,3ba830433bb0445f945b006d51f42a59,1,1,1,1,3
7801,5c9c1a1271c141fb87a80856a61fcd1c,2016-08-28 23:26:49 UTC+0000,18704e76611b47d582d8448a6b00c29c,eefcfb2ec1974407ad9bdf1dc9735715,2,1,1,1,3
2430,5ca1c7832fab463986831f5da780a6b1,2016-08-17 20:07:29 UTC+0000,0101f63100e443e0ae5be9f342a216b3,6a045ee9dfab4e339cb2e8b3ddff1cb4,0,1,1,0,2
3311,5cb0e7318eb34453a20b5430f965e280,2016-08-21 13:01:48 UTC+0000,35bc907667cb407289a8dbb90fcde554,36ff3b3666df400f956f8335cf53e09e,1,4,1,1,6
1880,5cb0efc5fd804a9dac4e8122f3d5e179,2016-07-28 06:50:41 UTC+0000,96ffca294b0e42348e57723109e9c358,1c0f24379d2b46a0aa102ce29d7f84df,0,1,1,0,2
2529,5cb6acd2f4ab412582a504e024a53955,2017-01-12 14:36:28 UTC+0000,97b9f1064cfc4d12ab3335052c44e074,369f1c8646b649f6997eae7809696bd5,1,1,1,1,3
442,5cdcacacb5f24a3a9bf34507ab7bb0a5,2018-06-19 18:54:39 UTC+0000,3a9302e39e424b9d8f5edd856819b5dd,95514a56a6d843a6a5163b3b42337ed6,1,1,1,1,3
3702,5cf29b69f9f44160a4c19f51f61e7140,2016-08-16 21:52:43 UTC+0000,f932730abfba49b48e1fe8c94c44554a,18770c021ef64b488ccb8b25a6e430b1,1,1,1,1,3
2392,5d1ed13d63bb4e8a9d0965559d2cea8e,2016-04-25 21:16:18 UTC+0000,7b17f9969b17470cbcf9ed05059d819d,215b430910074aeaaf24538cee33e35a,0,1,1,0,2
3186,5d23bfb547ee46859a2ac194535bc968,2016-01-24 01:50:17 UTC+0000,a42968ef8c274785ad85ed912ae5aeca,a1006e6a58a0447592e2435caa230f78,0,1,1,0,2
823,5d38c63f51c14175b117d728422ab277,2018-09-21 14:15:36 UTC+0000,a383bbe9732a4bc9a16ad5e800999fb0,36ff3b3666df400f956f8335cf53e09e,0,1,1,0,2
3760,5d3ff87a1a3f4993be2b5a34fdaa02e3,2017-02-03 19:16:26 UTC+0000,4051546e166c40bcbc8182bf572b4b7f,8cdbd92d0e4f4d7987a8c3148e1897bb,1,1,1,1,3
2719,5d41ea6868eb46249775ce796fbd6fb5,2016-11-01 12:24:42 UTC+0000,4ce49a278e104bfca90acb2c6cfd69e7,d67ce930870945109a7ad86d29ba2035,0,1,1,0,2
6178,5d54d4981ea34b6aa68ab90947ccdf7e,2014-04-30 15:48:04 UTC+0000,6450eb83bf5543d7876c4932f0506707,a5806385db1845cc996f66a99cc19dab,2,3,1,1,5
2577,5d55d58a2cc740bfba204c8c3ddcf5aa,2015-12-10 04:35:38 UTC+0000,bec303843e7a45eeb11e68b7c9caa5d6,9e90c659a3e34be28c3b97695f1cf518,3,1,1,1,3
4900,5d5c07151f6e4b1492facb327853ddf4,2015-06-24 07:21:50 UTC+0000,aded28850213473ab72706362f233cf1,d03a0dd01aba41fe962527368d3af340,1,1,1,1,3
2227,5d60451cfe3641509d35ad780ec8fe61,2012-09-11 01:54:27 UTC+0000,d047182600224157ae516e2c2a6af4de,8442ddfd38bc422fb4677785db0630e6,1,1,1,1,3
1173,5d6db52148cc4e9188db79eaa0078b8e,2016-05-05 01:30:35 UTC+0000,340cb3a2d8f747c6a3ed4dbac29dbbce,e4e7cc05a0b64cd6b02168d404a45d4f,1,3,1,1,5
4473,5d6e6f6f2dfa44568a1cd0665b730ff5,2018-03-22 21:35:16 UTC+0000,231de890430b46b69e6a25ebf304594a,08358b6c65f746b4a1305911a8a97fd6,1,1,1,1,3
6321,5d760720236a498ea72aaa3877407919,2016-12-09 14:00:52 UTC+0000,c5fbd443c1ac4a5891b46704ddc040da,36ff3b3666df400f956f8335cf53e09e,1,2,1,1,4
5139,5d88708a751d4804925d24270cd19f4a,2018-07-26 00:40:01 UTC+0000,73567525cb964063a787ad6eef802036,9421dd803d164e5da26436a01a92ce13,2,1,1,1,3
4101,5d8c6593ffdb4c878f347a804cc2b6de,2014-12-06 04:15:09 UTC+0000,b9cb925c8bd14bc58f19c7fd37783144,53939a491acb42a4815463845a638186,1,1,1,1,3
5721,5d9da511d3e5430eb74a836a371d6b6c,2018-03-22 21:33:54 UTC+0000,cc0fa3fc238345c9a55776363c055c83,c3b4d116426a47c9b9b85c739a7f68a6,1,1,1,1,3
2057,5da4e4e611854c9ca99e9c3d4413d80b,2013-03-28 20:20:19 UTC+0000,aa9952d1854d4e5696ebf94f413cd7d5,7d425e8d7cfb4fe7b0702fff4d6d84e7,1,1,1,1,3
4775,5dab163aa1f34f44b35a87cbc34f4d24,2012-09-09 12:44:57 UTC+0000,a61eead9bc3942908867f5fdb6b82315,b1776598991649088c0a00a6e0a2c766,1,2,1,1,4
2975,5dbaeac08fbd46eabd3df00b53c1a1a5,2014-04-18 03:40:23 UTC+0000,d6fe92998f2d4ad5b8e7848b80d68f46,fe4543418c0846e5a65fa22b4ad9a304,1,3,1,1,5
1812,5dbb5acc4fca4b01b273e954c7a0b750,2018-04-29 01:25:19 UTC+0000,61a1860565164a7cbe1d8efb4997b468,93acc65fba694fb5a4a9e590dcd81c68,0,1,1,0,2
1566,5def62da96014ff0a1d8011d6e3f4439,2016-05-10 04:11:25 UTC+0000,76542b01b6d4489b90b2c935f8a338c1,37ffe631da5b4b39837faa7b80e2a0a5,0,4,1,0,5
2304,5dfa5cd23fc84b30aba7c92d66a9fc10,2015-01-11 14:08:51 UTC+0000,b5ce63df6ecf4ecca3f58c3ca643244c,a2ec54ab6e52447c81fead2e9fa2483d,0,1,1,0,2
3132,5e01fb0daa814c938826b5d87b5a3285,2017-01-07 00:03:19 UTC+0000,6e0de6ea63c94babb4f0dc91a27a5ad1,01b3e033848b41f6b7a55cefc59ba61a,1,1,1,1,3
5404,5e10667573664550aa7e42be98794e0a,2017-01-30 16:11:51 UTC+0000,494e1d41ea9843f8a831aee46728f3f2,a1006e6a58a0447592e2435caa230f78,2,1,1,1,3
2024,5e17d6e4348c46f5afef1f5bc787e8ae,2016-10-13 11:48:59 UTC+0000,c95a54a20bde48d793568b4741d645ec,f9f7a40cc78c421a87ab8185c6d9078c,2,1,1,1,3
5886,5e1dfbd4f401454bbb76b79a09bed581,2014-07-18 03:54:42 UTC+0000,79be15d8c6334880b2a063b61c80458e,d6ffa381611e4bba9f92d7a5b188e195,1,1,1,1,3
5022,5e1ebd80bd72458c80f7651dcb86ff12,2015-11-10 21:06:41 UTC+0000,8eace19dd7dd4144bea9a35448e7e00b,69bc891d18f94347b202823b3cdca59d,0,1,1,0,2
6262,5e4416b2b78642f296e0e71d2160b950,2018-02-03 11:03:24 UTC+0000,001b447646ab4501ab2b3e2192c32135,4a7f9f11e34d47da8ccff00936bb3d5a,1,1,1,1,3
7093,5e48dedd10904410b3772adcb92cc9d5,2014-04-08 19:26:40 UTC+0000,7a50e893407542178530616a8afaddea,3d8847ddc8d04185976a9e78b190ebdb,1,3,1,1,5
6588,5e50b489289b43fcad3bc2d57b73d947,2016-05-07 15:56:21 UTC+0000,86c4d40f64aa4dc98e7dc70ddc12fcbf,58fa5e95fe9e480a9349bbb1d7faaddb,0,2,1,0,3
2094,5e5a015467e24894abf5ab992964d7ad,2016-10-21 00:23:09 UTC+0000,900a744a246a4c0c84b460a48e5a54fd,c0f7489f842f4ebfa548af41402d9571,2,1,1,1,3
6218,5e692c6a5774465588a930b5bd8056cf,2016-06-23 18:06:53 UTC+0000,4f6525679a584d518419b18c414615d4,c3b4e11154f74a858779be7ba9b6f00c,2,1,1,1,3
2110,5e697a79ce8744ef906bb43add310893,2015-10-27 17:55:45 UTC+0000,03a6c4a5e0b042659bc48319e4d14378,a1006e6a58a0447592e2435caa230f78,0,1,1,0,2
3688,5e775b9b8cb047378bf8af2d63bccdd6,2014-06-02 20:41:33 UTC+0000,149207ca57304c46a5fb37cd00c6b73a,0355aaad83704ad98e6d71b79db85849,0,1,1,0,2
2315,5e820dd6f65e4e129a06b31c4730cb41,2017-05-08 21:08:23 UTC+0000,f20183ad87124151b0c098a47ffffd48,36ff3b3666df400f956f8335cf53e09e,0,2,1,0,3
6116,5e8522b3a23e473bb07c83cb2f067a92,2017-04-26 18:31:29 UTC+0000,8043fb2406f34f4ab00b96a5be62cb37,edcc1bad6e60420284cb752b8826a822,0,1,1,0,2
1514,5e93899ea2424c6ab6f8bde680101063,2016-10-28 13:03:47 UTC+0000,5c3db0ae5b0c4d0e9eddf63d2456eee1,c9aef91f804d47b7acdc138135c34dd1,2,1,1,1,3
2664,5e944124cc7549dfb6a52972ca824a4d,2017-08-01 00:25:20 UTC+0000,97191c189f4b47c1bd832717835756d5,e3bedf3f2e5340fdb97d28181bcac5dc,1,1,1,1,3
548,5e98af14ee5d450ab9432017f1f5886d,2017-07-11 00:34:04 UTC+0000,40a6a5ff1aaf489ebadccef89da4b982,c258f388f42b4f608dd6fd8e9b6c1dd6,1,1,1,1,3
3714,5ea7987e4aee4d06b0c65432c0217de8,2018-12-06 02:56:24 UTC+0000,47ce9b12d4b4465f91f4214aa8f2ed50,26fa41ec95e34398b87445aaee81fcfc,1,1,1,1,3
6046,5eae4181d4414806be7d36bca782d73d,2017-01-13 16:31:11 UTC+0000,a788aff7358c448596d57e8dce02ca00,416321b48a634ac8a53602625f0a5d40,0,2,1,0,3
571,5eb61ed41eaa4b99a4ded5689ec17a41,2016-08-12 15:56:15 UTC+0000,48d19a0d12e3493eab5c4ee9fde00cf6,de51e745b6354185a0ca5d02dc628416,1,3,1,1,5
2426,5ec192c5fc0c434e9b33891395e4ebf1,2017-01-31 01:37:31 UTC+0000,ba4cb61e79f448b686d9595727b01e98,a3f6d682096743b2b88e7d3540f3dcff,0,1,1,0,2
6655,5efef770c8ec412193ff0e6b974c188d,2014-10-02 18:44:53 UTC+0000,fe6aef8191784500b8afc45ccb5fe842,7cce25cc8c1042b1b4f135bcacfdad82,3,1,1,1,3
4117,5f0404c425ae4c2a8ba433a8b3fb6b3f,2016-05-22 23:00:15 UTC+0000,0a47da9fb6ea48d2a11aeb5e83e2a8d7,250a771338344a65a67ea74e4229e62f,2,1,1,1,3
2881,5f22bafdf08447cf81937f28f19a56b4,2016-10-26 00:13:18 UTC+0000,2fb71b040d934b358a25da0e7099c721,6500d4a48e064af08e500bb3c9f6b3bb,1,2,1,1,4
6139,5f31c8dc746945edb56b4c93d03113ba,2012-09-08 17:26:20 UTC+0000,c64d083e0df74b9d8f1680aec42c45cd,2a8328f6ceb548699a64293f986f3d19,13,1,1,1,3
4042,5f3265e08aa64a528910e3da7940056e,2018-02-17 00:41:43 UTC+0000,b1c28c4f17e443b783a5811a4b540717,a6d33c38902546849c36ea7e9e9f0870,2,2,1,1,4
3972,5f33cda2727643bfa8db7663d08eb261,2016-05-05 01:22:17 UTC+0000,a60019f8b43446068276b114bd332e3d,fb706c7fc09e48cd94929e0af8ed3cea,1,1,1,1,3
7742,5f380e272ad24c1598ac5cfb8b663ad1,2016-06-20 16:45:20 UTC+0000,041cd63e9fe84080a7ff297b223fa73b,628ba982dfba43c0b6d692983cf5a3a8,1,2,1,1,4
5013,5f3cc20d64244dccbafa2e9d289271f1,2014-03-25 18:57:10 UTC+0000,0587ce380c014749acb494db50f7a6f7,23b6df4d73fb4d9bab3eafb6dd8bfb86,2,8,1,1,10
3937,5f5cb53d6b924a5c8d4c4652876e3777,2018-04-16 10:50:09 UTC+0000,d04d3023fbec4906adbae9f2e3e2a12b,107ec56b4e7948439ee5b6b946f576d1,0,1,1,0,2
2554,5f60813f82c54b1d97d62d9a111f1177,2014-03-17 19:00:56 UTC+0000,8f157f2d5cfd46069f557c47c594bc7a,05444a2f42454327b2ac4b463c0adbe0,2,1,1,1,3
1102,5f6b49247e1344a79a8b2ba227e7b732,2018-04-13 03:21:50 UTC+0000,9fe4b5cf78754ba78ffbbd3cc585bda0,1be339e48eab4385b347e4c62b0bdb78,0,1,1,0,2
204,5f6d806363e6462f920b4f3a09301db6,2016-04-29 14:34:53 UTC+0000,50f1c6e301e74dee8e152314c2cafd2f,369f1c8646b649f6997eae7809696bd5,1,1,1,1,3
1358,5f6d9552de3845c6be8de99a6256d825,2014-06-09 05:18:26 UTC+0000,d6bc8044ecb84ad8b935c3f08f166fcb,f0feae11574f4a94a37374f317c06675,1,1,1,1,3
4252,5fb1d1f6ec154e7688bc354faa8f586a,2014-05-04 21:37:33 UTC+0000,770752771b254820adcc842dbd676abc,3d8847ddc8d04185976a9e78b190ebdb,5,4,1,1,6
4203,5fbab3e5b89d4db8852354bced17c582,2018-08-26 12:03:04 UTC+0000,84efbd47eb144b06a2ffd5587edc3629,36ff3b3666df400f956f8335cf53e09e,0,2,1,0,3
4011,5fde38c3ea424566a8acceb5a9080711,2015-06-23 13:34:36 UTC+0000,7ce4683a61464c0d8f345eaa50284a97,369f1c8646b649f6997eae7809696bd5,1,1,1,1,3
1975,5ffa82163d5948669960d8a42e1918be,2018-08-22 21:11:48 UTC+0000,c3070983736f4d37ae52072bb8150cb3,36ff3b3666df400f956f8335cf53e09e,0,3,0,0,3
2015,6000c8a4891245059f43b9115507f095,2016-06-13 00:31:42 UTC+0000,7841c1fb071f4088a5d4386f446befeb,58fa5e95fe9e480a9349bbb1d7faaddb,1,3,1,1,5
5195,60112916a9a3412f8189a3105375acfd,2016-04-24 15:03:13 UTC+0000,f1df597d1e1649ebba3d3855a5c29b5d,08f4c4808d8e4eb1b9b287cda01beecc,1,1,1,1,3
4448,601ec2f636c44d99b4636af221d4f473,2017-01-24 00:16:22 UTC+0000,7141d66f237a416a88f8c546ca324d89,b74860355dcb4cd7a24efc7e16427589,0,1,1,0,2
2806,602227e1cf35478190d58ab5940cf080,2016-05-25 01:52:38 UTC+0000,020b446026264363bdfaac3c1113fe29,aa27976302f04c74a36ac18825e490c5,1,1,1,1,3
1042,6024e678c3d143c88f7317c55c1aa8ad,2018-03-07 22:40:55 UTC+0000,719269697b2242d49b7e03892fd3d4e3,4dc61581ec7b409bbd037e483f53ba0a,0,1,1,0,2
6919,6036a6746ba541828cd7006459548bf9,2017-05-05 17:07:14 UTC+0000,e1d84c48e93d43e1b83d4c044dc8c819,8ba7c732fe9741f08aa62736592e1ba8,0,1,1,0,2
4452,603d20e6f13543cf9c5c34c2c96030a1,2014-05-09 21:59:43 UTC+0000,5d6b8653ace744539da4304ca1ae8d18,ca1c49a2744b4d1abc1a2d7c154cadd0,2,3,1,1,5
2036,605a82b81cb84bae9978c2dc02b7235c,2016-06-04 13:13:10 UTC+0000,caa39ccd19c843da82f97cd78b8e892d,a14d2d2cc61d4275a722eeb7204cda90,1,1,1,1,3
5648,6067ce8093f64c0fb8f2ec6d64693057,2015-05-15 18:53:20 UTC+0000,50620f69785e4ff3859ae6262742550b,7aab6fb9a4ae4d0197fd2bc05960ba56,2,2,1,1,4
1814,6076c03c65224d5ca3691e953b180129,2016-12-07 17:52:35 UTC+0000,8edcb80ea47741319f22cf3ef866a0ba,5f95b0ac821e4e8e9b4fa9fc8eb9ff61,1,1,1,1,3
2957,608d80c04a97431cb8f88e2470d26532,2016-11-02 21:07:48 UTC+0000,3fc872cb8640466aa431a6675147882d,369f1c8646b649f6997eae7809696bd5,1,1,1,1,3
5378,60a36edbb8164e50b51441a83c2bd0e5,2017-10-23 15:01:09 UTC+0000,e06b8c55db1a424c9a56584227cb4c1c,a5082d995e9a440f96491d3aa51b5e47,0,1,1,0,2
2260,60b99c14fd7c4b968151d43505b309d0,2018-03-29 19:35:14 UTC+0000,7dcc8583409445e7afe183bdc26c83df,a85d8ec254734af8a74fa3478939a377,0,2,1,0,3
3336,60c1aaa152d941febe63d0d10ead1401,2016-05-21 05:43:37 UTC+0000,9247d7e896e84964b6a19a3749074862,6febf841fdbb461284ed1d30223a1366,1,3,1,1,5
851,60c2cdc8e4ca479e8750b809a214934f,2016-10-30 01:47:19 UTC+0000,47cceb67e09942fb96f33c6068ffcaf0,36ff3b3666df400f956f8335cf53e09e,1,2,1,1,4
3891,60c6445fbb6d41808cad88e1313c731f,2016-06-12 00:41:34 UTC+0000,7206aa1afd254381a205d0b67cd01aa8,27635b0b3d00420e8cb8c10f8ad9507e,1,1,1,1,3
489,60df1086cf854c4c8ca6bd6cfa1fa3ec,2016-10-25 18:24:21 UTC+0000,f75bc1f409524a7a8ae88f4ad1f522ad,e4cf99a1cc884d97a46eb375f23834d0,1,1,1,1,3
3217,60e7d4bc71604ce59732f2af3b92e872,2017-02-16 01:30:01 UTC+0000,9d574c90df5047a5ae40cfa02aa80a8b,3017ab48ef64404193186b3c8502764d,4,1,1,1,3
4433,60ebba5180544336aee64c875d7b3812,2016-07-23 14:51:33 UTC+0000,0e211f8450d94833b25c96dc20d23e88,b31cc952965442f7a593662c0b5bda8a,0,1,1,0,2
355,6112bffb6906409da74554b6a3edaffe,2018-03-13 16:48:40 UTC+0000,9d33b9bb76704726b64c3025b7febfe0,c099775fa5c742ba8c57a4f405768c9d,0,3,1,0,4
2208,611d5dcf7e074585a8575f9edacfb576,2016-06-06 15:26:02 UTC+0000,9e33e8168c094ada96a7db032f72b36d,36ff3b3666df400f956f8335cf53e09e,1,2,1,1,4
1589,612d1e51098e4cee8c174d058a21f447,2017-01-21 03:39:56 UTC+0000,f6dc2125d4fa4ebab85ba25d98503a0b,d1d2e77dcf9b4d5888bd4b856a9d1457,0,1,1,0,2
2508,612f2b21f63142f58448e2c59b8c229f,2016-10-23 17:41:44 UTC+0000,2f0198d523c54946a891251096b9c68e,b9b4b982f64c40388281e97c7d5cfaeb,1,1,1,1,3
2408,6131a2f45b5a4cd9af1b717396a77430,2013-12-03 22:54:11 UTC+0000,527c42e61e2c4e83afcd88a777e5582a,2adab7916b3747af85b2d82e188c1dc3,4,4,1,1,6
3427,6134747195ec43a4aacfe2f99bea9345,2015-11-02 22:52:01 UTC+0000,478b25663ddb48128092056a8314ff09,a0a6f44017734561b30af6d6432fe951,2,2,1,1,4
4015,613804f5e08c456c856beec5388f5f0b,2014-03-17 18:38:14 UTC+0000,c6cb947f17f94a9e9ef676ad780fb4eb,3dbf68e5ac6f45549bba213fcd71c913,2,1,1,1,3
1284,613f9e1a548d4ae79d8e9935d099960a,2018-05-31 16:49:49 UTC+0000,2bfeb649ab0b43cfafad3f3ddc01d724,c258e56484d444a3ad7f017c2bb4ef17,0,1,1,0,2
6036,61412b6f55ed4b0fafaac47d0971e7ad,2016-05-08 09:55:38 UTC+0000,61ca405c55a04c42ae8a50dffbc9e937,06eebab6ea4f421daa1c7ebfb4467021,1,1,1,1,3
1275,614b74bcc5224616ad0f98cce3e12c08,2018-01-30 11:07:34 UTC+0000,4ecf0de6c9d343c9838b25324c9fd2bd,a92449e77a1c4f129df86a930b5f4f24,1,1,1,1,3
1163,614e47492c7c4d4bb54aabdc0cb5494f,2016-06-12 15:44:18 UTC+0000,c6d61528c430489c9b3dcd2d9dcb1a0a,58fa5e95fe9e480a9349bbb1d7faaddb,1,2,1,1,4
7030,61628183b8954c6b90a9d22dc9d89749,2014-04-23 13:34:19 UTC+0000,c5cb92a42ff749719b0308c46bec7124,05444a2f42454327b2ac4b463c0adbe0,5,7,0,1,8
5494,6179d02ff2e94ce1aa5a875a7b0a0639,2017-02-23 00:28:14 UTC+0000,766b02f87da84faba7913616dc360223,d97aaa6b7f7e4b1e9a6d65d5a0958183,1,1,1,1,3
3124,617d2f74bed047d1951d1c2638dd61e6,2017-01-25 16:47:48 UTC+0000,e011030392eb4eddad47528cb1320892,331c075b95c74215b0435818457f0324,1,1,1,1,3
77,617df29a9a2044f4bb7d0311a25d7ce6,2016-05-26 20:11:02 UTC+0000,eb1220d1f12e4ce6b297291affb62ca6,58fa5e95fe9e480a9349bbb1d7faaddb,1,2,1,1,4
6972,61808c88d8ea409187ae0372c88049bd,2017-10-27 09:16:51 UTC+0000,0a141f89be0040169bb24e9e609681f7,56136f2f11d74f88bd07856c28543afc,0,1,1,0,2
748,61a0ec7d62c9421d801ee7940c69dff6,2012-01-09 05:50:01 UTC+0000,f96c18f53e594252ba817f6baaf7495d,392a273cb57b42389ec01a8fcdaff3af,5,2,1,1,4
5993,61a199272cfd40dbabb9a1d6ea31ba5e,2016-06-09 10:25:38 UTC+0000,859910a22bc546e4a0efff9e6d9d0cb0,de51e745b6354185a0ca5d02dc628416,2,4,1,1,6
3298,61a8e31609804f0a9dcfeb1207bc247d,2014-04-28 16:33:40 UTC+0000,13231cfaa911406ca196fb0e44dc1868,3f7d362aac0a4304b31cd37f54f41774,2,3,0,1,4
4724,61ad3f1420ef4ee4b5d5238311f6b94e,2015-03-19 17:54:24 UTC+0000,4fb749edcce84b1db079613cdccc64d6,6d3aeebadc6a403a814b2ceafd79862b,2,1,1,1,3
845,61ae9131e0bf4c7d97dd04c6c3cb8644,2016-10-07 22:29:05 UTC+0000,130e49bd6d884ddf9d392cfba31010ea,faa0582ea12e403180bbd18848cea2d4,1,1,1,1,3
6179,61b11a9e11e34bb696495a19d0be1a95,2017-03-01 03:32:26 UTC+0000,5901ee1a3045434780ada003dcb10a83,8136c8653d3a4895b49cac90b88120d2,0,1,1,0,2
1521,61b3d1b8fdbf4b2384ce44dc29dbc9e5,2015-05-27 10:58:15 UTC+0000,7910dc5d4c3742739402fcbd850118f9,05444a2f42454327b2ac4b463c0adbe0,1,3,1,1,5
6451,61b8c212fccc4ecfbf9e6bae1277a8da,2016-08-20 23:55:20 UTC+0000,0e09ac6efb3f422f83fd563e904e98b3,926c156d54a44a1780332ba20efc9f8f,1,1,1,1,3
2458,61baf191525b4a10aeca26fcd4290ad2,2012-04-03 02:46:45 UTC+0000,799f7674c1fd442ca7e6f98a2d9225f5,624194ea296c49a6a8ef1180787476dc,3,1,1,1,3
4024,61c3586529f441a0afc773ccce158706,2014-04-29 18:21:00 UTC+0000,40bb41094b13415c80c3805017b8b84d,2873dd3ab32540958460316783461531,4,3,1,1,5
2903,61cebac15dc4463697678c3d9b8b6b6e,2015-01-14 00:09:55 UTC+0000,b35e9fd972334f23b598c497da9ca14a,18237fb03c8d4d368085a5dd67c5307e,0,1,1,0,2
7102,61ec8185969b4ed4b72be4d3d63fdee2,2018-04-18 01:25:38 UTC+0000,cd4bb65a306c4befaad3ef750e45aec6,cff9a9679be1434f93afd0caadea94bd,1,2,1,1,4
6763,61f7505c8da14a96a40a06505acea398,2015-04-25 23:08:55 UTC+0000,5f925c987e3e4d31b2a2e0ca32673f5d,7aab6fb9a4ae4d0197fd2bc05960ba56,1,2,1,1,4
3755,61f966cc4bc2484b92fca2755318b46c,2017-04-19 16:43:41 UTC+0000,f9d53ec014d54558b65534a72a1a66c7,e7b5b274746a4f31acd01217f68a6fed,1,1,1,1,3
2377,61fd465a6d094eada477babc45019a9c,2016-08-11 19:42:36 UTC+0000,2892f5714a7040879681aa90de9505d9,369f1c8646b649f6997eae7809696bd5,1,1,1,1,3
4761,6203406e05a347958763646031f484af,2012-02-15 19:10:10 UTC+0000,d6a5cfaca6b448a090db726df8ae0e77,f05b33a454c048f3bbc73f5f3f7f5127,5,4,1,1,6
2687,62037e49d0554ae294ba225083aa7659,2014-03-27 14:09:58 UTC+0000,410117d038f548fc8a2f40913d40d7a9,3d8847ddc8d04185976a9e78b190ebdb,3,4,1,1,6
7428,62115043251f49dca5f9e1fb3e94300d,2017-10-30 06:45:35 UTC+0000,307ffc5d0d514c09a1ba59768f8b9a8a,4aa59b652ba34bea9f9ea8032f5a2d73,0,1,1,0,2
317,6216a24c60674990a769ce40bb5eaa26,2016-05-18 01:23:19 UTC+0000,48af4c56672a482dbf881a8b70225b4c,2706ab56034d4ead87747b981d4aa741,0,1,1,0,2
5212,621c88ac08ca44cea24c7e2ce82c228c,2018-02-28 01:39:37 UTC+0000,5b9d92c79ba74b3e8ba084f01984dd58,a40784e842d540189b38dd58a544f758,1,1,1,1,3
1389,62334b538546434e86b4c9bada8de402,2015-06-20 05:19:21 UTC+0000,0b8d1cb9309242fe88df9658138caca5,c3668d2d66334063bbeaf07cdb273ad9,1,1,1,1,3
6801,62351be2beff42568a2f9c68a71b5bd1,2017-05-10 18:36:44 UTC+0000,525bf4239b7044e08215dd7cc53511f4,11dfdee44f4f49bd8fe9e4c9c7905c59,0,1,1,0,2
218,623d9f8b6430469ab68d68c8c86bee83,2018-03-19 17:19:42 UTC+0000,8cd55e5f8de74cc490ef15b0eb894d62,ff32501104e64a18a0af82f367776c3b,1,1,1,1,3
5305,626e31690f5d4320ab309a60ec402fa6,2017-02-22 21:22:01 UTC+0000,ce8da3d5ff39453e8d8ea34d46feb581,9e0cb2a2914c4d05be76c85e7ca356a7,0,1,1,0,2
1645,62753627087841c2b8546e5478e11130,2016-06-08 19:51:31 UTC+0000,a3462187c6904ec79725936a247edd5b,976b9fe0968a4032ad42f2bb2a94d9a4,1,1,1,1,3
7348,6275e47d69014aedae5eaef9da0dfe77,2017-08-29 05:34:45 UTC+0000,6194bce5b76a410f8778642abc5a91a7,0924251979ce450898df0feafb7e02c2,0,1,1,0,2
2072,628051d25b104fd081eeacb8bf3dd422,2018-09-25 23:30:37 UTC+0000,85e8b810dc4d4dc98ee9737e4ae7c79d,b83c48fa229747ba8703340f49c0d3e2,0,1,1,0,2
4498,6292ea2b5db24b80b871a90b56fb20b9,2018-10-24 01:46:03 UTC+0000,8b7830a9df234151a97163dc5ab84cfb,e2b4c84bf1ca4aea9b108869692d8017,1,1,1,1,3
4746,62a7c89f63bb41d5bbce8abe85a6a530,2016-05-08 12:17:21 UTC+0000,4399285edfa9464a9c17f614866d4ae4,36ff3b3666df400f956f8335cf53e09e,1,2,1,1,4
5688,62bc71657e44403a8f4a5dd5e1391d51,2018-03-02 23:02:23 UTC+0000,9c82efd09dcf4597917ab30b7b8911a2,1177f525a46940fa9863f8bfd8149374,1,1,1,1,3
3266,62cf83348951487097e5da0f98c7810f,2014-04-08 23:32:59 UTC+0000,c7be365e165f485c9bf13ab485df2b48,fe4543418c0846e5a65fa22b4ad9a304,3,2,1,1,4
5191,62ddd96944ea4481ab0b8650c398e2ad,2015-04-09 18:17:00 UTC+0000,85459f7959bc45b28d6a7316daf477d4,1272964da2504fe8a8a6400539cd8b1f,0,1,1,0,2
5283,62e345c135c040e2806267d399a6175e,2014-06-13 20:05:40 UTC+0000,f12603db14f147089b01fc7066c8848d,17f3979e85604d14acc5cec635adcefd,1,1,1,1,3
1744,62f0beb09c8b4c43aa387f7736e15cea,2015-11-19 18:42:34 UTC+0000,b43b426b36ea4d2081f52d900f50b1f9,b2369630ac7e44a2a575b63f693d86c3,1,2,1,1,4
3295,630a88f32c1244a28081c0dbe9e432ad,2015-11-19 19:05:50 UTC+0000,d3401108c7264dc29463a672b4a464b1,a1006e6a58a0447592e2435caa230f78,0,2,1,0,3
3037,630ee9a832534e79a5ed4158a76bd142,2017-01-31 02:39:05 UTC+0000,d4f91f9d43c1461db3f9aebeb5588fc2,a7a8e9fc6f0849dab3d825c39b22262b,0,1,1,0,2
6635,6314955153c54bffa8d6bc7dc48a3265,2013-09-30 18:01:58 UTC+0000,0a74f48165dc4d14bb448870009ef9d9,207c8c62bcaa4033885a24a8a5a10d51,1,1,1,1,3
3021,6315f9d824c34dd5813ebc3da6ea3d56,2016-10-11 20:45:18 UTC+0000,d9807e676e7845d8b631d1bae7a5e3b4,b8b77df14ad94e7bb64f14eeffb72d9b,1,1,1,1,3
1356,632376f3496c401590bcb122568526e3,2014-04-07 18:26:55 UTC+0000,8099e275da7d4637975186195231212b,a40408127b504ab8b89118eaa328a0be,1,4,1,1,6
7739,63265211cce84c9eafcf256a7e246fb4,2015-11-05 02:36:29 UTC+0000,aeaebdbd191c4783828553b8b0116373,f07ba1e168b34c28bc9a71cbb8ff1869,3,1,1,1,3
3558,633f58847d8541c6a5975009ed8dde57,2016-08-08 23:36:32 UTC+0000,05aea6d8075e4b66a1b7ca6479d035be,0bcb14b92e9b40f9bba206b4315e4175,1,1,1,1,3
1933,6345fb5ba79b4d86ad367ae78b809e7e,2013-04-10 22:59:54 UTC+0000,9592b2ccd7664819b62030288277ec3f,35450f45d2a14a81b375183f581ae3f7,1,1,1,1,3
4763,63538bccfca64f87bf5e223fb3374896,2018-04-09 15:01:55 UTC+0000,767c047cc5ea42aa9c6be6329c90abd5,36ff3b3666df400f956f8335cf53e09e,0,3,1,0,4
3691,6369d256f2114cb58fd2247f194b104f,2016-12-24 11:20:51 UTC+0000,d975313ed9b94e39b431ccbaed812814,36ff3b3666df400f956f8335cf53e09e,2,2,1,1,4
6433,6391aa34bc63439d853d62ecdd03775f,2018-04-19 19:59:05 UTC+0000,ccb09a72c3d745e5a6e6b16590cd831a,912fd132ece74fea814ff1ccb9ff36db,0,1,1,0,2
3595,6396486c87fd40e7822491efe1db5a0a,2018-09-20 22:53:38 UTC+0000,0d1a74c227a64ae6a847ba3d25566b99,9221f63656ca4e8d9fbbac486a4e4292,1,3,1,1,5
896,63af8bc71dc846efa7244b5cba8d6c94,2016-04-25 17:10:21 UTC+0000,b16188e9dc9242b9b5397a1b2c743fcd,43e46835a4af467186a5d108072a4999,1,1,1,1,3
7721,63b02b6773bd4126bc8872b0ab473efb,2016-05-15 18:17:30 UTC+0000,0a7a89a54a5346b2af5d7630d62411ae,2a3644c6f5d140ffbae97dc57f9ce2f3,2,3,0,1,4
5835,63b054a38b884e7f84f2f19ea9d1d0f1,2011-12-30 03:44:40 UTC+0000,38632ab7a7314fc38526d6ced7b42468,8ff80b2548fa4e68892da71d1e320289,4,1,1,1,3
2463,63b54e7d9af241f7a86a05daec725f25,2014-12-16 14:21:59 UTC+0000,c388bf4c0eaf4171bdff4b7f1c1a163b,ec97070fe75544e0bc5888f9f6120822,0,1,1,0,2
2724,63b970975bcb412abb6fc2e3ecd5eade,2018-02-02 12:56:32 UTC+0000,744847b2399345d4849a7e158e87a1f7,be5d23056fcb4f1287c823beec5291e1,4,1,1,1,3
6550,63c5f20d6ec04553805b2744bf0860f7,2018-02-01 14:03:41 UTC+0000,c94f73d6bc7a4afb82b5e27ed4e904d3,5ec9d442785a423ab4c0bf1dd110071b,0,2,1,0,3
8042,63c89317413046f483020585f0cc8dc4,2011-11-11 19:28:14 UTC+0000,21910e89165047259510026f5d86368e,392a273cb57b42389ec01a8fcdaff3af,8,4,1,1,6
6153,63ca2a29a57d4d63b06eb05009d93489,2016-07-06 17:57:16 UTC+0000,1112168e1ee94d2d989aef6666508666,9faca17f8c834be38da9ecabba2ff1bd,1,1,1,1,3
6269,63d8982cebe54295bc6e80571a527db7,2016-09-18 21:19:38 UTC+0000,63c581a1319648d586e851ac19f1438d,5490c09b18a948beaa8fe67a52197216,1,1,1,1,3
5403,63dcea5481a0450592be17f9097f19b0,2014-05-30 19:32:10 UTC+0000,e6a1cac51b8148fba1667e8f08e5ebec,3b7e352267da403695a5c0f50f28da8b,1,1,1,1,3
1711,63e1f6a71dd8402580f7487260803041,2015-12-23 21:32:20 UTC+0000,806234adf0ea4b338ea624edbcd245d6,3fe712ac70d249cb816f70c7be40872e,0,1,1,0,2
378,63e7a9ece6874546a68c6d19a7e9ac43,2017-04-18 09:44:33 UTC+0000,1ce2147286e34974b3223d5c86867833,8c5ea269b4dc4b60832832a3755ecfff,0,1,1,0,2
58,63ea01e5106d407b940eea48ceed32dc,2018-03-18 23:30:49 UTC+0000,7e56420daf384a0b801334e9c6e890e7,be5d23056fcb4f1287c823beec5291e1,0,1,1,0,2
1374,64107b5c40fe4fc0886242230906a20f,2017-05-10 18:48:08 UTC+0000,7c84ccbe567a48b2972fbb5166dc1dfe,652d95ba96764818ae6d943df4c1b904,0,1,1,0,2
1927,6412c0eadcc7491f820e5503e16a5bf9,2018-07-16 23:06:36 UTC+0000,1ac87ddca028455d8f5312cca5154bf6,e3e0ef78006d440c892e26cfca963dd0,0,1,1,0,2
6441,641dcac85499460999c635008e3e4415,2012-02-15 23:24:03 UTC+0000,5ad1524b55b644bd8a860bfecdc9e03e,5f77e0a2c3a144dda336df2294a64530,4,1,1,1,3
841,643169737a0844e1b85f1a3811cb4903,2016-12-09 20:54:49 UTC+0000,5fbc3687b2d44d4ca802e44d25a55be6,36ff3b3666df400f956f8335cf53e09e,1,2,1,1,4
6415,64422a367aea407681e72dde61e69e27,2017-02-09 20:31:03 UTC+0000,92686d0a3e3c4d8d9f06827df02ee7ac,3192d2a03f9b4d929e519be8fdb853f9,1,1,1,1,3
3704,6449322928f440bc91d33b63821f59db,2015-11-06 23:08:42 UTC+0000,8ed60fad549f489eb04545ca435fbd27,69bc891d18f94347b202823b3cdca59d,1,1,1,1,3
2874,644d9ef3247147a7ae152c9ba0f73b10,2015-10-23 20:11:59 UTC+0000,4946e4dad72540b69ed1dafe49bb8d8c,a511df5378da447e99de53ac92a76e7b,1,2,0,1,3
7856,645627171a7045bcb805ec921a002a04,2015-10-12 21:05:08 UTC+0000,bc3eda86281843cd94b113f841960793,a1006e6a58a0447592e2435caa230f78,0,1,1,0,2
5925,6470e20c24a749bba9e0478673af0a78,2016-05-10 23:39:59 UTC+0000,7b5c9890308b412d8fbf2b9f969100b4,fafeba89ca764bd891862fb8440a2962,0,1,1,0,2
459,6471574e2abd40f5bb1778a3ad9b87d0,2017-10-17 21:51:12 UTC+0000,5c6f53aa25db498694012e5974260be9,b25b37b931f84c588c38d7225ec31dd5,1,1,1,1,3
7225,6478217c0c054feca7d9ea49012d5e2e,2018-03-20 14:21:45 UTC+0000,59c848c6ba17412d8c906b75c4300164,d491ab83153c4ec3a75d659d5c8987d8,1,1,1,1,3
892,647e5e1f14ba47e6b8a434b8cc61e3bd,2016-06-23 23:25:53 UTC+0000,bf3fdaac49864344939fce1d55899029,a5d53a25174e4b8a822ff13bc5aaaa2a,0,1,1,0,2
7813,648645c66dd54652b55ddf58b047b3fc,2012-01-17 07:46:05 UTC+0000,0f5ac5255fba4228929a45e3a1ecfe04,e18337fd36cf4dffb589f2d548e8270c,4,3,1,1,5
4431,64a370d729c94c4e91982f3180b210f9,2013-03-28 17:39:51 UTC+0000,46bf3c8e603143449706d4344b1315a4,db2b89ef7f7f48ceabdb8855ae81e0ab,4,1,1,1,3
7709,64aa1fa4016a4e929e0cd89179f7479b,2012-10-11 20:07:36 UTC+0000,edcf21214e78423496172906aae814a3,3a27f0a7707741feabfc96d27cfb7feb,1,1,1,1,3
3317,64ab27a9c22a4418bbaad1878990d242,2015-01-29 22:06:21 UTC+0000,e6b17b92b5754de7b4400d90e845a579,a0445ef256b142b89418e211fc00675b,0,1,1,0,2
1240,64b9405415a84d0981494eee9fe323f8,2018-02-08 13:45:30 UTC+0000,9caaae302d1749f5bc22b90b42671630,826e706f2e564d52856aa71abff6a00e,0,5,1,0,6
2722,64d5e04e8697437bb5fad1da6fb3ae8b,2018-06-09 17:55:45 UTC+0000,8362b80bc6e64eeebe9b6e53129542d9,be5d23056fcb4f1287c823beec5291e1,0,1,1,0,2
3948,64ed0f5f2f664385a696477231e8f7c2,2016-04-27 21:06:41 UTC+0000,7ec4f577c64b4b9dbcfa2cb3cb230b9f,cdc6e88ab36c4cb798d7aaa7f956a0b6,1,3,1,1,5
3621,64f599126c244a4aadfffd3161ec27ff,2016-06-09 11:21:09 UTC+0000,be01a08172794c8f8d8483fde2362149,de51e745b6354185a0ca5d02dc628416,0,1,1,0,2
1637,64fa1d5ceb534783a3fc3bff51464427,2016-10-05 14:27:54 UTC+0000,bd573fd6cf7e4e0fb9c0321e4edf9c9c,369f1c8646b649f6997eae7809696bd5,1,1,1,1,3
4109,65291b16d97540aba1bf0a1414d52350,2016-03-01 21:01:29 UTC+0000,abfa08efa8004d849a2caa80b7e3b826,3ba830433bb0445f945b006d51f42a59,2,2,1,1,4
1967,6531327c237544ce8352936b359d0963,2016-01-04 23:23:14 UTC+0000,ee610e2d4e0444aa96efe46af002d8da,36ff3b3666df400f956f8335cf53e09e,0,2,1,0,3
1811,6533b8f8b21343bf96c45a47e385205c,2017-03-07 16:49:40 UTC+0000,b57ba38c8ea94f9e9d83e3273eba6b19,a1006e6a58a0447592e2435caa230f78,2,1,1,1,3
1384,653b79631212494e9145b6d3813194c7,2016-06-30 17:24:27 UTC+0000,2c2f356cc1a8442bbcfa77649ed86cee,1f52a53f782c46298b933a5f70d28f67,2,4,1,1,6
1671,653dc8b85df7464091485acbe958e7a0,2014-04-22 21:35:34 UTC+0000,90f9ad1dc5704cc38b7ac2be979fedca,7b42f25e2ca5406da36fb5a80f613a1e,1,7,0,1,8
2295,654954e2fcd94c328288928a3a1a1d4e,2016-01-11 20:04:16 UTC+0000,f5777dad94084d63b28106110c09552a,cc653598a23d40d587333768d9896850,2,5,1,1,7
5092,65591ef7678e447dba455a53e943a2d4,2018-02-22 06:38:42 UTC+0000,d40adc9b098d4de293b6f57ead3763fb,5a360ca371e149048f6cedab908b140f,1,1,1,1,3
5477,6565f09ae5ef4c729da98894506cd688,2014-03-17 03:39:35 UTC+0000,151d008d65254534b74970fc43344c6e,23b6df4d73fb4d9bab3eafb6dd8bfb86,1,3,1,1,5
6924,65662deb73b84125bb2fc5795d57a579,2016-04-12 23:57:01 UTC+0000,1ef9ca3b9dba49529ab608a243c58bd1,1f29954e507c4df38db0ed1931695ef1,0,1,1,0,2
856,65803d30c9c04bbdbb248231178230a3,2016-06-24 02:28:43 UTC+0000,d33f553dc29844ff9f5a8042dc802f2c,79136c9bd2964e30b32944eb6c4cc95c,0,2,1,0,3
646,658b1323424841209d21c38f41b1bae8,2015-11-20 20:46:59 UTC+0000,145d8eb4a5d54c0d952a6319dd4fb0ca,a1006e6a58a0447592e2435caa230f78,1,1,1,1,3
6868,6595eb1a9f604c67b9f7fcd9aef6ab68,2014-04-07 21:28:08 UTC+0000,c2e23a9b81af41cfb3651754aee89183,0dc4c381bda94701a967703ccec5c676,0,2,1,0,3
268,659808ad0e5e4f06a8e49f9234e7dea0,2015-10-09 04:29:04 UTC+0000,fd529cbeacbf414e9d70672158b86d9e,53939a491acb42a4815463845a638186,2,3,1,1,5
5587,659d6e2ab8ec4c23ab951e87cba5d18f,2018-02-28 00:53:17 UTC+0000,a5478a452a0a459e81efb00a61c9a129,de9e867b8eaf4264b5d09b2eb63bfa42,2,1,1,1,3
2457,659f87a225884a3dad6f383f6dac3058,2015-09-03 18:05:54 UTC+0000,f455369019864654b2cf7bad5152ea02,d1f04208de3643c088f4a25e57f1cb2d,0,1,1,0,2
3236,659ff95088f240f19ae143bd1e6382b7,2017-03-07 15:46:18 UTC+0000,726275a07a1944c98ec1e1d15e0931a1,bc4fb0276fea48288a4bf89f8d9a6c1f,1,1,1,1,3
2846,65a36e97ac2545c3a4e73483ad5b6ab0,2017-01-13 03:04:25 UTC+0000,4b1b4d25f3864bbdba684c9f2ec150f2,a72bde6ac9e349d195a6d356444c9578,0,1,1,0,2
808,65b109208bc7445c822509c665d7bbe3,2018-06-14 10:51:40 UTC+0000,6dc93003e0624f75aa0ac4f0892084c0,36ff3b3666df400f956f8335cf53e09e,0,1,1,0,2
4667,65bbb8efa69040aeb487d4521833d47c,2017-02-04 13:25:31 UTC+0000,6bed8d6d71f44cae8caf44ce5cb420ec,bbde489586b34ad09ebc8e7c7c24aa1d,0,1,1,0,2
3510,65d9179ba608426d873b9c25b601a87f,2015-06-18 18:29:47 UTC+0000,eab7972278d64ba483980939256dcf01,a1006e6a58a0447592e2435caa230f78,0,1,1,0,2
7306,65e0b788f16043b18986aec531020e73,2017-03-19 00:40:43 UTC+0000,9b72becb97544dcb990ee1ed247b1105,f4759af9b17f44c9865b041a0469dc45,0,1,1,0,2
7615,65fa70874f8e433b8af664ab00ca3bdc,2016-06-23 10:51:21 UTC+0000,2ef9cba692cf4f31aec0d9f2773e9ca2,58fa5e95fe9e480a9349bbb1d7faaddb,1,4,1,1,6
2030,65fc1d0c828140d98dec36a4f61e24e1,2012-02-03 19:12:44 UTC+0000,c5ea531aa2bf482b93fc07464f6bb19c,9c5803ae43ca4cf6b27ea85871625116,5,1,1,1,3
5871,65fd01ab181b4a8ea37aad0b79697081,2016-06-29 06:46:18 UTC+0000,c9ca547bd4dd403bac3dcf935dfc81b6,0d4cd29c55c64547b0488a9cdcb218ce,0,2,1,0,3
5654,65ffa0d712474ec5bd43d8ab0aad6015,2015-01-13 19:50:33 UTC+0000,330035eebde34ea8ba62f6faf5a1d6e8,53939a491acb42a4815463845a638186,0,2,1,0,3
842,660035b322424ff7aa8a8f8d60c33d39,2016-05-19 13:20:39 UTC+0000,1234157841f04539bdccf6a14195d6a7,7667c23d26ab409ca3e49758f5367925,1,1,1,1,3
2309,660fa715ccdc47c3a0f70730a159708a,2016-09-28 23:11:38 UTC+0000,eff1fd4cb168434aac466c14604eccc5,f4b9aa952f8b447898def2503bc540f3,0,1,1,0,2
5788,661160f1fd004b368ebc73b6f5af94ad,2014-09-30 13:51:48 UTC+0000,f24fc3e194324d10a18438d790f751ef,17001ea532b044b08a006a989924e2e9,5,3,1,1,5
4554,66250f267f874c8d902250058b84fc56,2017-02-22 17:12:21 UTC+0000,8a3a98dd66034b348b3d1b0d1d605811,9e0cb2a2914c4d05be76c85e7ca356a7,2,1,1,1,3
2587,662a34fda1934abaa159dd92d80e3ad4,2013-10-01 17:14:26 UTC+0000,49348905b9084649b7220bab85834a34,c1014a1846bd46e0ac35716dc20c58f2,8,4,1,1,6
4495,662e230c4f9247f4b43cc80d64f69f29,2016-05-08 04:57:02 UTC+0000,9a28b6b288e64fba97ebc3c3cc090439,6fb29c037f7b4a49acdf685d02ae0352,1,1,1,1,3
1567,6636adc371314485adab7bb3bf7b10bc,2015-10-20 19:39:12 UTC+0000,1914faac289942b68213ad64e94474f0,369f1c8646b649f6997eae7809696bd5,1,1,1,1,3
6831,66399e325c4642f89797c5e6cc9f5d12,2016-10-20 00:06:26 UTC+0000,9605f308848446619ebcfa67ca8dab40,88fba04fb7bc42e6ab416599067f6440,1,1,1,1,3
1181,66448cd1d588462eba20326cf01572db,2014-04-10 03:12:19 UTC+0000,99e40b06262240ffbcc5cec22f196b95,6774ee9e8f9247728dbbe896726e911a,0,1,1,0,2
4537,664851ae19bf4a98856c3343de6daedd,2016-08-07 03:47:29 UTC+0000,133f0d652d8344dd9e869722b12b9d84,36ddb593ca5742f29ed9b5ac66cf24a3,1,2,1,1,4
4555,664ba7749f504015826c1b461b301bda,2016-08-13 22:48:55 UTC+0000,9f74e3e8cd094c96891d57c9cd6eddda,58fa5e95fe9e480a9349bbb1d7faaddb,0,1,1,0,2
4541,6650e1709e8c4e8fbec8033b455343a6,2014-02-21 20:25:39 UTC+0000,6f8ee0bfedd948538edad60c36e1b191,c97710a6164a49a2af0b75473c47d3b6,2,7,0,1,8
1011,665213557cb94711ac53d0a66c3a7248,2015-07-27 14:33:47 UTC+0000,fa489e34c72244e1987d82f7be8dbbbe,369f1c8646b649f6997eae7809696bd5,0,1,1,0,2
2617,666572a6779a406abad9f433b9ccd4e1,2016-05-18 16:42:29 UTC+0000,f8be9de57e3748988a9a22e3a9735021,e4a413230c9f4504aaeeb5ec27378dd6,2,1,1,1,3
829,668abc6257ce4c90a8020c88f8fe7bd6,2016-04-17 02:40:31 UTC+0000,bbb8d00c7472429897d64a1bb2fd9ba5,58fa5e95fe9e480a9349bbb1d7faaddb,0,1,1,0,2
1624,66955b417ff94ab4a293622f6b6124bc,2016-10-20 03:47:12 UTC+0000,322ef68dac404e438bdd1f1ff49e031e,96f3d50b316048249af8b9d91662ae22,0,1,1,0,2
5475,66e67701e5514d56b5f0ae934506ce99,2016-07-22 15:37:46 UTC+0000,361ffc9c093e4ec89892b510a7175a6c,1f509237fdeb4f33bcd72cc0aa73ff02,1,1,1,1,3
4149,66f90e3022a34437ab962660c7dc5637,2016-02-16 04:04:14 UTC+0000,fe9415fb03c64099aa080b857634f795,88e569f825ed4f52a24648d5f96a1f2f,3,4,0,1,5
5792,670c302f99494017b945a2e1160de39a,2016-05-28 16:14:32 UTC+0000,a1173653cd074ce8ac9302252fcd26cb,4b4e9216e7d24e72935eff91a33aa934,1,1,1,1,3
6733,67180ee15ed44daf98f8c1dda8c200ac,2016-05-27 19:48:11 UTC+0000,80f13ebdda7342c1a8c5b61ac00d548f,0b17f4e9d93c40eb9a5d087865084ce6,0,1,1,0,2
4251,67222fb567ec450caeb756cb7e0db407,2018-03-16 04:57:09 UTC+0000,06aab2574dc148c1b81e665ddfea3d6a,8a5d6741876f47099912f7cf529c0bab,0,1,1,0,2
7580,6733464246a949aea5275acd1371716e,2016-12-18 21:16:58 UTC+0000,37dbf03aeed54059ac44fcde7d6d7a78,8ab0a14843c945d3ab60d2141e2db6e5,1,1,1,1,3
6658,6736ae9fb39340279d2cdd29ea4fbe17,2016-07-29 21:09:26 UTC+0000,f6e11c93a0664dc3a969518148ebea2a,986a00b486d9421c872bb527f015cf42,2,1,1,1,3
1874,6736d860bd1845a0a032a089a03fdb82,2018-04-18 20:17:24 UTC+0000,8b01430d65b04249af9eb81e5ed156b2,4e60256f0662439b93a003e682e236c7,0,1,1,0,2
3108,6736e5469a1d42cda1fb6c66bf432bd1,2016-04-25 13:45:00 UTC+0000,e407b8ad348c4be099b2e32092d09fe7,3b7e352267da403695a5c0f50f28da8b,3,2,1,1,4
7688,67578db26e6440e49714c06ec0d0a78f,2015-12-04 17:27:15 UTC+0000,f837b3ed582342b7a6815232f1f92e53,a1006e6a58a0447592e2435caa230f78,2,1,1,1,3
326,675b42f8038242e38b77c2f3bd86ea71,2018-05-14 23:04:24 UTC+0000,0e15d2eb84184a31bd715e6c781535c9,a6d33c38902546849c36ea7e9e9f0870,1,1,1,1,3
2184,67618e4a073945afb5a9876c2a7e2bac,2016-05-25 21:25:20 UTC+0000,47cd249512a74547a4a1ff22fd447612,ff506465780c44b8a1a662517ca7b04f,0,1,1,0,2
6367,6764b45604ba4e0b91f182524eb1320c,2016-06-22 03:57:07 UTC+0000,95bad0d8a2e74f849a3e474327c91794,f4759af9b17f44c9865b041a0469dc45,5,2,1,1,4
3455,676f88aa1d544ea7a9727c6a0cefdea0,2017-08-31 01:50:07 UTC+0000,38dec3973ffe4ee085906bb5695281df,bd614cc078064258b14ed0a08b65a957,0,1,1,0,2
3197,677137b28aa24b718a7b8039e75640e9,2015-05-26 14:08:37 UTC+0000,3c9328ff4c5145f08da3984ade3f0e1d,0895796423534563adcec1c208e9e0bf,0,1,1,0,2
1641,6773609f008949b18f2e7aa674202824,2015-10-26 03:20:06 UTC+0000,1a93bbab95684ca89954f8427c58e69a,15d1a3af6f554bc5b8785855ab58927e,0,2,1,0,3
5151,678b133a651c49cab3c22bb594c27572,2017-04-02 00:21:12 UTC+0000,936cc5ea222348e69683b1d26a7bdb2f,36ff3b3666df400f956f8335cf53e09e,1,2,1,1,4
4130,6799e86e2cbe4c2aa8b5f71ac46e428e,2016-08-26 15:28:54 UTC+0000,5217600666b74526b27bf4f5457dab92,369f1c8646b649f6997eae7809696bd5,0,1,1,0,2
2455,67c961cbf03c47009bb3f129ffab6725,2016-01-05 05:22:01 UTC+0000,1afbb7f88d7e4733bedf287d4a61867a,42b04c15a191473bbd3fc97ed24ff146,3,2,0,1,3
4418,67d4127c3b834febb337fe7f2d057ef9,2015-06-05 03:09:44 UTC+0000,160a6b8fae894f54b955f5e7d89707fb,f1ca9370286248aba5aae737f92a07dd,2,1,1,1,3
2638,67d41a55419e40ee9154bbfeb27c11a3,2017-02-09 23:04:10 UTC+0000,0a8b6cd7427d445187adc374f982a3d2,95d2f1e7be1e4bbc98042d283e73bab8,1,1,1,1,3
474,67d6c49ae3d34a199420cfece230a11e,2014-11-24 18:38:30 UTC+0000,281c5c433d8d4a459a9defe636159fa0,564ef581bed64addb3cf0ff0ab652ffd,2,2,1,1,4
5845,67d6d3deb0e34e5eb92453961c06c2ba,2015-09-04 17:20:26 UTC+0000,dc681e1067bf44ba9ee927222ffc060c,369f1c8646b649f6997eae7809696bd5,0,1,1,0,2
623,67ee751f606f4e698cc2d47c3803b45f,2018-04-08 15:17:33 UTC+0000,5ee4572a479e49a995266dd511450e91,f989480323ff4fd29f10b33b59bf1b21,0,1,1,0,2
4073,68051dee1b234c14beb63326011a20fa,2017-02-14 22:24:05 UTC+0000,9a3631a2aecf4053be1520e66b75d76b,2a3644c6f5d140ffbae97dc57f9ce2f3,2,1,1,1,3
6781,6806815e743b4c04a8778cf87185489a,2016-06-27 03:41:14 UTC+0000,34fa02ffef504c89b370903f7cb58bc3,30b1ef88592643dba57c33e4626684c8,0,2,1,0,3
2694,680babe0f8454e16b943ab9b4bcfb3ad,2014-04-09 05:56:58 UTC+0000,cf608ed8f4c14d3395f7ecd8234caa11,fe4543418c0846e5a65fa22b4ad9a304,0,1,1,0,2
5382,680c5aba196f459baa5d334a626690b8,2016-12-22 01:17:23 UTC+0000,e10e757619ec4f018edb88a064f68f7c,fafeba89ca764bd891862fb8440a2962,0,1,1,0,2
855,680f8b6ec37d4da49539c0b4672f3bfd,2018-02-22 01:32:36 UTC+0000,08ba256ce0474d84a617c6e6e7c516cd,a6d33c38902546849c36ea7e9e9f0870,1,2,1,1,4
6625,6816189142c74082832f1527855cdcf9,2016-03-31 18:38:22 UTC+0000,761816bbef954bbcb8c727d86bfe46c1,4eba857335b541239158113b6515ce09,4,1,1,1,3
7589,68362cf0c21a472bb35fef274d7f157c,2017-01-04 23:17:17 UTC+0000,5b98cb1128df4d83b39b531a20f2966d,a1006e6a58a0447592e2435caa230f78,1,1,1,1,3
2060,684389ebb1f94ee7b9d9d6bb1fd8c20a,2018-07-12 22:36:16 UTC+0000,b76158270884430a8489ffd4f103386f,be5d23056fcb4f1287c823beec5291e1,0,1,1,0,2
1371,6843b133f74f453aa6f6ad49f8c4d3ad,2016-05-17 16:07:03 UTC+0000,eea72c02da714aebbc59441951f5fe66,6febf841fdbb461284ed1d30223a1366,0,1,1,0,2
7496,6848660368d647bf897f56af1f1424dd,2014-12-03 18:47:46 UTC+0000,2ed17df09fe0485da977018e588e266e,bc46e3699d92477ba8c7aa723e54a151,2,1,1,1,3
746,684e52bb187a4c7db62128d9ffde358d,2017-02-22 23:24:13 UTC+0000,7da30c1250ec4e73b46b52a0579495a1,27635b0b3d00420e8cb8c10f8ad9507e,1,3,1,1,5
3743,6855a687ea814e81b087f4efa9514784,2018-02-18 16:20:20 UTC+0000,3424f5b25a0440f2a4f9dbb646d0e6d2,e03667f92b8e495986cd851999c0d77a,1,1,1,1,3
1123,685e9859c8e54bc0842a18406bcffbb2,2016-04-13 23:18:09 UTC+0000,62f11c3040b94bddb9de7ad6d912d202,be5d23056fcb4f1287c823beec5291e1,1,4,0,1,5
1103,685fcea58fc8473296c8a41d7760c633,2018-07-21 07:16:50 UTC+0000,ee3e93bd9082495eb3deecbfbe3f561f,fd544d775c4444ae92782900b3197e46,0,1,1,0,2
124,685fef3a67054985bc1c7eb0ac29e5e3,2012-01-19 18:25:51 UTC+0000,558f13d2230a4f6190918a917b29a45c,0c9a2748560541be9fe2df0d7be88282,3,1,1,1,3
4235,687743515e024a9cb3823ca2fe6645b4,2016-07-09 22:05:39 UTC+0000,5e3f0e5c52ff4c3abed4c9b1e2e32389,58fa5e95fe9e480a9349bbb1d7faaddb,1,2,1,1,4
1200,68868dfb8cd44c99b29f32b506ec9c2f,2016-05-23 23:55:46 UTC+0000,03064e42573240ccb13aa7ea3a6d8b6e,5b85a1dee8b74d79a87d53e758d897c4,1,2,1,1,4
6096,68891f95f896470ca9642863f6c88375,2016-12-02 16:15:18 UTC+0000,05cb9568b1f841e49d10800257f29203,f64df9b489864952917cb631be1ddac7,1,1,1,1,3
6591,689f9a2babc5417693806213263ffd25,2016-08-16 11:15:42 UTC+0000,490aee85350e455483f70c3a4023d1b3,373809641ef04ce68113c70f3d50ef98,1,1,1,1,3
39,68b24a7733ef4e429d0d408547238a16,2018-09-10 00:07:39 UTC+0000,8fac579498c7469c96d2a8e94997ddc3,36ff3b3666df400f956f8335cf53e09e,1,1,1,1,3
7141,68b3f406034842afbde750ca30efa954,2016-04-16 09:21:21 UTC+0000,ec8496207bff4f21a5c7570a29a2b4df,735b73c476d64303aea0d18ea39e27ec,2,1,1,1,3
2069,68b41f21a6594ef3895b197ffb2f8fde,2015-10-29 15:14:52 UTC+0000,7477fc6e70744c41b11a9c8d3a44848c,a1006e6a58a0447592e2435caa230f78,0,1,1,0,2
4806,68c22280aa024e8aa9624c7911771683,2016-10-19 03:20:28 UTC+0000,0abdb569c6814bd4aefb0a922276d4e7,91a66853dd164250b6df8a22115e9f88,1,1,1,1,3
1231,68c2d14e5e6e45cbbfdd0378688ece87,2016-07-27 19:05:04 UTC+0000,98951a4ae1d2458db09b16052f274f73,1c0f24379d2b46a0aa102ce29d7f84df,0,1,1,0,2
7822,68e568f3d66645e5b267ed4a6ec99cef,2015-12-16 14:13:47 UTC+0000,59567fa97c6044ca9555c8554fabacd3,c08cc2f020184396b92df97ecfb50d65,1,1,1,1,3
1653,68ecb1fd384a4057ae0d2e26a89fc783,2015-06-09 17:15:37 UTC+0000,f726a9287fa74d3a9e61f027ca387056,e0c3c9fc3634444ca0474c231b2f5959,1,1,1,1,3
4527,68f84477ff994b29b3131d07de3cdb65,2016-04-23 23:48:05 UTC+0000,425cfae7e9014af0a8e8e6ebeafb4c9f,58fa5e95fe9e480a9349bbb1d7faaddb,0,4,1,0,5
4411,690342b4467f4adda2a4142b73bd80ff,2015-10-28 19:26:34 UTC+0000,2db140cc146b47759be6935da795d6b2,36ff3b3666df400f956f8335cf53e09e,1,4,1,1,6
4944,6908daa4b4d54a2a9580399f16f2f19c,2017-09-29 16:02:53 UTC+0000,df91d272d32144dbaea082eb4851d925,32ae1fd679c94e549ed7a78ac5d208ae,1,1,1,1,3
2249,6909b4e5a62e4e98b6ee83772c1aafae,2016-09-20 23:22:59 UTC+0000,5cdb98b2075e4eafbed1ad133079924f,e3529e64e70643b6889353db79eeea3e,1,1,1,1,3
982,6909b91a6a3c4169a9d5f05d25b14877,2014-04-07 13:34:43 UTC+0000,c16e089b61514b19934092590157ec3c,f0905ffdddf249769d9358a0d868dfeb,1,1,1,1,3
3000,690aa88ec5b64a40812bc582f4475726,2014-03-27 22:56:19 UTC+0000,92679d51ce9e47dc8dd72de70fee13a1,13b55ed4834e4814bb33a4c87001063d,1,1,1,1,3
5030,6930f0ffcce645e7997cc70b76cdee5a,2018-01-08 15:38:37 UTC+0000,91ada0f8cd9047e3a208d7db60b93913,cb5efdb6742143169de54ee11b9eb314,1,4,1,1,6
2570,693832182da443b584dfb79d0be50bd6,2017-02-04 01:59:20 UTC+0000,1655661e0fdd4ae58b2d1714055699dc,36ff3b3666df400f956f8335cf53e09e,1,4,1,1,6
5705,69398c1709f84921853dc8c241315c83,2015-06-18 17:58:04 UTC+0000,12fa38d3cc1b49ac8f41763383a1ac01,89fdcd2a7a944b1cb08b3ac8c1b8a855,2,2,1,1,4
1901,694561edf6ab4a2e9645c239c84ec9a8,2014-01-09 02:29:40 UTC+0000,3157e2f519f640dc9a4475479057fbaf,05444a2f42454327b2ac4b463c0adbe0,0,1,1,0,2
6617,6947ca1bd61348ab8c146c6ba8f30278,2015-09-22 19:40:58 UTC+0000,44501693f7284c0b8eb1fad37a2d2b0b,a1006e6a58a0447592e2435caa230f78,0,1,1,0,2
3863,695ee4deddc74613b8a76c9faae9d190,2016-06-20 20:30:57 UTC+0000,df140701759d4c2899f28a57c6a98113,369f1c8646b649f6997eae7809696bd5,1,1,1,1,3
6616,69693d5f9d534c8a9fcec282facecb60,2015-07-28 19:48:50 UTC+0000,8f0e6223db64434f910725484cbc37dc,0355aaad83704ad98e6d71b79db85849,0,1,1,0,2
6267,6976a60f2ff94ef7a27ac3f2d4bc357b,2014-05-15 20:25:29 UTC+0000,2a4634a7247743ffa0b276bf8df80899,6713f4a70dc441ea9a22597a144b797c,2,1,1,1,3
1314,6979c082b46b4d71803c98681ccd50a8,2016-10-29 03:22:19 UTC+0000,a4b6c943a0a340f0823215ad1dcb9465,ac83901fad384461ad33630aa2d823d7,0,1,1,0,2
3725,697c3fbd3e134b49845ca0f281056467,2017-02-13 16:26:20 UTC+0000,79138694947849bba35d0f86ad7006e7,dd804175760142f0a7248ea8462802b1,1,1,1,1,3
1687,6987054f5e044d04a28b538a77b932ab,2016-05-05 23:04:04 UTC+0000,c897b38ca4dc463987f006ae08a74ccb,fafeba89ca764bd891862fb8440a2962,3,1,1,1,3
3614,698e9f2986634af3932393d7634ff824,2018-03-21 16:52:42 UTC+0000,ebca5193f7f44c10b2ca59b61d0d69c7,2184b3982393494f9dd787b6ec0e18f8,0,1,1,0,2
6940,699575a42cd54c9da524cc60af711d43,2013-09-29 04:48:42 UTC+0000,dc18ae1fecb5424e894036b32884abaa,fba0925c233d4f8093de3bb6cbcd9641,5,2,1,1,4
4226,69a0288e75d84aed99c2bb51b35874ec,2016-06-23 20:37:37 UTC+0000,d5b81f00de2b4a52818f9675368dbf15,89ffc7c3266344b68c2dbce832d102f6,2,1,1,1,3
5005,69a27ac86f9f4758ac75be17569fb1e6,2018-03-02 13:52:28 UTC+0000,e7e1753cb3434f4cafd29b11516ddc53,862ca12eb24244b392f76e9604b79a63,1,1,1,1,3
3435,69abd79a5bdc4780a562943eefed153b,2018-02-20 01:41:34 UTC+0000,149ecdb842e24dc297958f81afac9f02,8a8284a6ac4e4482bab295cfc681ebbe,4,3,1,1,5
6498,69acdd249d7847a189e885192869c31e,2016-05-04 16:42:23 UTC+0000,3c37459c10d7461288156ae3dd484217,934ad4bc354047a08aa24c70449302a7,1,1,1,1,3
4580,69bed0d8298348df803c9f96908083fb,2016-05-13 23:25:38 UTC+0000,a6d7b1bc6ebd4b50bb97d98cf7002ad4,e719c3b6acc64682872a1ab413b851b6,1,1,1,1,3
6493,69d3d35c80314956b2a0ce118f44b0c0,2016-03-09 21:52:43 UTC+0000,1a5e909862ff4ebf9d33e411c95a5ca5,96bbbdd06a334805a0501034d9df1aa4,0,1,1,0,2
5623,69e5c1ac2fe442c49cf8f9a78b7e41d5,2016-08-31 17:19:46 UTC+0000,5da828d1e6a84f62af2e17cf6da7837f,e558151137504b15b92b1433257bcffe,1,4,1,1,6
2142,6a14a85dedaa4e0991bdd9990091ed3f,2018-01-19 18:48:22 UTC+0000,2cc05f31621a4ef6abf15a32553bae8b,574a61faba5a4160a2591819004100a9,1,1,1,1,3
7309,6a19e3101f7342d2b3dc3ce0dab4a5d0,2017-02-21 05:14:57 UTC+0000,6d5f824a14b245e2ba8eddb2363def81,41d28ab2ad464f2b996625af681afe7c,0,1,1,0,2
7666,6a1fa862b7a1416bb88251fb6675934c,2017-04-19 23:48:48 UTC+0000,cd196dc9cc254fe9985bfb5aab315a43,daaef4a2b91a41abbbfb0411733ec084,1,1,1,1,3
5968,6a247b4ef756418a826bb2b3a973e1cc,2017-02-18 17:37:05 UTC+0000,4ae52f07382a45e59a875c42bfc0b287,d3ba15fee0584d72971b06fb5cff6fae,1,1,1,1,3
2258,6a2ab264c44e4d1a9f8075277cb3a224,2018-04-30 08:28:19 UTC+0000,98763312052c44f0876516fb98024235,c34d17b9958f401586f3ee72ee01382c,0,1,1,0,2
405,6a338527f0b44832bfd9fbd936b747bf,2016-06-20 19:30:23 UTC+0000,82f0f491008741748a6447a81792b626,369f1c8646b649f6997eae7809696bd5,0,1,1,0,2
5398,6a350619bd404baaa3d2db547a966bed,2017-01-04 20:57:17 UTC+0000,5906bfb59c074cce927c0d3240d9d3e8,36ff3b3666df400f956f8335cf53e09e,1,2,1,1,4
4611,6a440260db87408ca36debd8e5a2e12c,2014-04-29 17:26:20 UTC+0000,8aafbf867cd34ca1bd28fa892a1ef0c5,1f05b78c26884eb7821345484d4e4b7a,2,13,1,1,15
4576,6a46958e38f445aab68478030c422b00,2018-01-17 01:20:54 UTC+0000,a675c844d7ea4e7aa7f2b8ed7e3a7ccf,49ad078f92f74c5ea4892fdc9337b926,0,2,1,0,3
752,6a4ae8ed97f54113b52fce9e24914dd1,2016-12-07 10:39:40 UTC+0000,033d1ab9aa204087906fff67b9206be8,ea76f7c1aec747848d86d9990d9d0713,1,1,1,1,3
1175,6a99739aefa14a9e986953dff9f9322c,2016-10-01 19:43:51 UTC+0000,21217a2a1610499d9f5d0a2e0f0d0815,b433f2c2a5fd4e41a6086e9cbdf9f36a,2,2,1,1,4
5411,6a9fa91afdba472486b6bb9f74cf1051,2018-02-08 01:37:37 UTC+0000,38922c55bfba45a78faffc339238dc5c,bee65000a6df4618bad437b807cbfcd7,1,1,1,1,3
1633,6ab336c358144c82834ad56ae5ceaca4,2018-02-08 21:36:09 UTC+0000,24cb896ac59a44d2a92193f0b257f9d8,ba397091911a48f5995db4d86581e9e5,0,1,1,0,2
1126,6ac0820d48f348208668f08243a4af2e,2016-03-22 16:15:11 UTC+0000,3f0b9b977ab14ac7aef63875c415fd1c,35c069bb365643049d70b5c2d60caf2a,1,1,1,1,3
7357,6ac7927090904ec09f9dead758aa40f7,2016-04-26 12:38:58 UTC+0000,e5f6b2676c18436789d425285cfcf0a7,a511df5378da447e99de53ac92a76e7b,2,5,0,1,6
4886,6ad9ff73d45d4fbbb59083d813c9e870,2016-05-29 21:03:33 UTC+0000,ca7f459c27c34007bd244791b1ce8591,36ff3b3666df400f956f8335cf53e09e,1,2,1,1,4
5171,6af231950412414fbfa30dc4cd6fd4df,2017-11-30 21:48:25 UTC+0000,d388b336a58746318828322cf96fb6f2,8e7137fafc1d44cdbe075e4f07b79e39,0,1,1,0,2
1257,6af317d996d24e6788154c312f38afb3,2016-08-10 14:37:46 UTC+0000,3b1bec68151840e18c168c13602b6396,ddb1e777c735451b8220d504bf3a307c,1,1,1,1,3
4280,6af8b3c1c82e482d80023639ea7fad2f,2018-06-13 21:35:24 UTC+0000,112542e8944a458784756d9ede7b9ade,05444a2f42454327b2ac4b463c0adbe0,0,2,1,0,3
767,6b0168cfcd8c4cb88f4b69a811607ebe,2016-05-09 10:59:41 UTC+0000,67a34aad037243aab807d82738e3e7ef,e773d6ccade64f38b1b960c6b64f0a2a,0,1,1,0,2
3046,6b323cb62dcf4488b1d30fde14a29afb,2018-10-24 18:16:06 UTC+0000,1684007b297e4706a39be48538d755e4,96bfdd914c284f2dbea85ea1fbee6367,0,1,1,0,2
6423,6b33839d98aa4feda981e11d5a11b274,2016-04-29 13:43:43 UTC+0000,54053f5dd9f24797b2bd70393e026f87,36ff3b3666df400f956f8335cf53e09e,0,2,1,0,3
83,6b4ee1d9f7d34280a58047e5d844cd39,2018-08-15 17:10:57 UTC+0000,5854792dd32a47b5a1f0db13688fab89,b56e79f4a4dc47b08d16620fe7760ae0,0,1,1,0,2
5101,6b68ca63228147808983d7a2e4f77e05,2017-05-03 20:56:38 UTC+0000,6b6763e82dc4463699e0150920002a63,e5482466b7fb48cf95dbe26ddd4620b9,0,1,1,0,2
658,6b73f7ed70a14ccc99b465ab4cd6cc4d,2014-04-10 16:48:30 UTC+0000,7c3d0004784645838cc074768b801feb,fe4543418c0846e5a65fa22b4ad9a304,2,10,1,1,12
3388,6b921a135a094769ab8cf6f1914f78f6,2016-08-28 21:30:12 UTC+0000,444540fc33714c69a796840412a7cbfc,863da3dcf174448c8b045e72577ce5ae,1,1,1,1,3
2321,6b957916341d4154918a5f43afbbe5c7,2018-01-24 20:55:01 UTC+0000,e23c99e0a6334b2f993f6b36ac779b04,aa916ae133d04bfdb7cdf610f7e7a745,0,1,1,0,2
1902,6ba14e744d0740359dae4c85082ef6de,2018-05-07 15:26:12 UTC+0000,2437111ca7a04ce0a08269feb44689b6,338635b17df248b3959ab4d5423cc6f3,0,1,1,0,2
3850,6bb0626a219f4166b037b7bb07b6d695,2016-03-21 17:25:56 UTC+0000,1f149d1c4e3541ce86eab493db1119a6,0355aaad83704ad98e6d71b79db85849,0,1,1,0,2
5334,6bb9760301394a3a94d6da32795643e2,2017-11-17 21:34:46 UTC+0000,ec532e83ec9848748872b9787d2f9c96,a32044c459624e15ac2f0aac1acdbc95,0,1,1,0,2
4444,6bce25977ff94ba9a133a0134f1cd213,2017-05-17 23:23:02 UTC+0000,2850840db32c42b99403c580ac85c453,c7bf019f041c4f2cae8f8ed89d16ae85,1,1,1,1,3
6632,6bd0385c2ab940dba69a8967a287ec77,2016-05-26 01:22:18 UTC+0000,c776f33f133344c1b8e6f6335b1e4c69,58fa5e95fe9e480a9349bbb1d7faaddb,1,2,1,1,4
7109,6bd6a89d7fdd4039b537f85d97e9fe0b,2013-04-12 03:54:12 UTC+0000,7d0d05a025b544c48ae7a245d55777e2,f05b33a454c048f3bbc73f5f3f7f5127,1,1,1,1,3
1313,6bece2cd18464773926d90ac48bf3dfa,2016-05-24 23:32:51 UTC+0000,ca997cf9bf7344a7ba016097cd05ae35,2694d61072bc46be9d657652403c3fb3,1,1,1,1,3
6301,6bfb73c5bf87473895ed4ecf476537f0,2014-07-18 10:03:24 UTC+0000,15bd259c9dce4c5da4e081b97881f7aa,50cf3d2dd2044152845aceed66b48c65,1,1,1,1,3
5616,6c168b17d24c490299c5055d29fa0b24,2015-12-29 22:37:01 UTC+0000,9eae59629b594be79083ba7e67a81b2b,62e145e292c64c1584ad2a95769ce846,1,2,1,1,4
135,6c1deb9eaa2d4e0cb4d01b8e079b60b6,2018-05-27 20:19:07 UTC+0000,060a3ea1ff104602953f8e81a7fa5203,d1dc7e671e05451bb4b4c19db0e9d48e,0,1,1,0,2
7947,6c28c0bf512a446ab534cf58271f7d5c,2016-07-27 17:35:05 UTC+0000,26f05202d3104549bfe37ffd30a1b87a,05444a2f42454327b2ac4b463c0adbe0,6,6,0,1,7
4032,6c3a3ceef9d8423db4d297396d9ec35d,2018-02-13 17:37:04 UTC+0000,09008d5a48db456195f97c28c38bf01f,a6d33c38902546849c36ea7e9e9f0870,3,4,1,1,6
294,6c4535c16a864f6892d3845e258eca6a,2016-01-08 17:13:23 UTC+0000,d3ff0846ebc847d68916a5063b9665c0,a1006e6a58a0447592e2435caa230f78,1,1,1,1,3
3915,6c4a96166aaf4e15b4ed5c9a07fdddaf,2018-02-21 17:11:02 UTC+0000,e8653d6de2a4459faa4a2ec04b9686c1,c3b4e11154f74a858779be7ba9b6f00c,1,1,1,1,3
2848,6c7c2444638d4edcbf578bfbff3f041b,2016-05-14 20:57:00 UTC+0000,4cf391452e7443c880a0cf763942423a,58fa5e95fe9e480a9349bbb1d7faaddb,0,3,1,0,4
87,6c98bbce49714e53a488a27e95ca4132,2016-04-29 19:46:40 UTC+0000,4eba8f72b1f24604963916773d0997b6,36ff3b3666df400f956f8335cf53e09e,0,3,1,0,4
4773,6c997cb4ee2f4ebc8be49846565819f3,2017-03-08 18:53:45 UTC+0000,17dba0da973049a68af26a9a780e20c6,96bbbdd06a334805a0501034d9df1aa4,1,1,1,1,3
6511,6ca16ca2b36b40739dd1238190362e97,2014-12-16 18:23:14 UTC+0000,6ed9e2b467a44c779cce8e04fe7b0633,564ef581bed64addb3cf0ff0ab652ffd,3,2,1,1,4
2327,6caf111aa5644a43bdca9cd0cb8eb4ac,2014-01-30 06:21:10 UTC+0000,20d011c0676545dd8b4bf88e4c8f2214,4bce59e2537b4228adb73b856d2c6102,2,4,1,1,6
4921,6cb94993e3f849cd8a60e826bfaa255f,2016-10-29 06:11:54 UTC+0000,6cb8a42e8f9d4461aa159632982e76b5,9610ba7903e84a04b25b38515609643f,2,1,1,1,3
2672,6cbc4dd60f2741ddac3f094d9e624367,2018-04-27 17:41:57 UTC+0000,b3259ae2759b44958d961b8a715612f3,5d4afc2c986944878d3a14c52400ac8b,0,1,1,0,2
5978,6ce6795c3f2c49a08a7f04328030f727,2018-01-24 18:28:04 UTC+0000,0c2abcaabb864d1eac05d1f96ef4fa7e,d76a64e53aa242bea01e3c51310745d4,0,1,1,0,2
5209,6ce9d227bf6f4db2bbe6efa6876229d3,2018-01-24 20:52:47 UTC+0000,906bcb4c568f4fcdb8841993955821dd,15bb606f85c8415b98eb68a4ac0aa4a3,1,1,1,1,3
7559,6cfbd9f82ce6468494ef4ccc633ea6d3,2014-04-08 15:48:49 UTC+0000,a1dbdb4abee1486c90e78af6e26bcd84,0eebb6c7f960452fa457747129577f85,3,5,1,1,7
937,6cff9535439b44818bb78a552d512514,2016-10-25 23:52:29 UTC+0000,b61142fe50074650a5fec94f5cdcf7a2,86f210a12c2546519e0b1cb0880e4a89,1,1,1,1,3
4006,6d041a0a41a94f2983de57ef98ff33c8,2016-08-18 14:11:40 UTC+0000,afb731457598438693858dab34406881,8e8bdc9e013942029523cd32daab22f7,0,1,1,0,2
751,6d056147113b45a48097d590ac724a2c,2018-10-17 13:00:03 UTC+0000,8b8ab641c6744c8b8834c0208618e7f6,1c1f74e611eb428e9edb87881f6e48d7,0,2,1,0,3
1066,6d2a162b6d0b4829953bd7d1c62c60d0,2016-11-22 23:15:18 UTC+0000,96048634989143d09302168a70bf61aa,ab0b1c1190a64715b0433885d5c88df1,1,1,1,1,3
5054,6d2e0681192d4cef96d4d1259f5c18f9,2016-05-02 16:05:53 UTC+0000,cb000f2f448e46679cdcad8bf8fe6aa1,a9861227544b455e8a15f5fd1cbffd7a,1,1,1,1,3
5840,6d34a87431c8439e8067ad7b4553a06e,2016-05-20 18:51:43 UTC+0000,a4cbb8a9046a45a8b27c5687f19405b7,f96f59f78b4c4c4dafff870b194d8794,0,1,1,0,2
3493,6d505da14b074f6fa3e3fd1df3a1bdf8,2014-04-30 15:54:29 UTC+0000,397c63e807014b45b64ab5bdf7531398,a5806385db1845cc996f66a99cc19dab,1,3,1,1,5
1086,6d6aa98b7d3541e9b99b916753dcc6f4,2014-10-02 15:38:58 UTC+0000,9b6b4d44ed2943438a585efe8a1cc839,d24d688749ca4eca9a14452b539f576d,2,3,1,1,5
5615,6d7f279d33934e26a56db4bdd00cf589,2018-04-13 22:57:37 UTC+0000,f10734e90eb44413a1d47b9909231cd4,cff9a9679be1434f93afd0caadea94bd,2,3,1,1,5
7322,6d89bb8d01944413884cbbfb462309ff,2018-02-15 22:41:33 UTC+0000,c31e223261bd4afebb64f493e1da5c28,b1e09e11d4e44cbeab270910c019ba34,0,1,1,0,2
5127,6d905e07824f4d9db09c343ef500e4d0,2016-05-13 12:32:30 UTC+0000,a26a6fd13fb548edba1905c658831f2c,de043e5d7ec64049ae3bec3ec29f2338,0,2,1,0,3
2155,6d97890805bb45f6a8c99cfc55ce0d63,2017-09-18 17:52:44 UTC+0000,0815be023f374d828a51e524c4831cc2,d01ea5301aca4fe38a8e023cd25bc219,0,2,1,0,3
7917,6daa41d5cc7b474886470903c5316538,2015-11-07 20:56:33 UTC+0000,1b76089cb46d4e0d96a5cf834728811b,a1006e6a58a0447592e2435caa230f78,0,1,1,0,2
5243,6db56a63323046ea81f85723e6f27a5a,2017-05-12 18:58:41 UTC+0000,cbe99e6ac9f54a2a94fe686af4049a33,5424ee250804424f8b98d1a5f2832390,1,2,1,1,4
1176,6dbae8464d5041b192eb51adab78357a,2016-04-15 19:10:41 UTC+0000,863821885ba246beb4aa483057e17ee6,44877e586062498c9ef5aea539fc34a4,2,2,1,1,4
1025,6dbd7f41f8b745e98340b5bde45b415f,2018-01-24 14:56:16 UTC+0000,be22817d40ed43b59e1dfd22cbceb0a5,4e9fe7ffb54c42eba0987c6119da9975,0,2,1,0,3
5911,6dbdb438343d4a54afdec757a8792db2,2015-02-09 16:11:06 UTC+0000,c9a69683a0d94f8bb9c809812f339c50,369f1c8646b649f6997eae7809696bd5,4,7,1,1,9
5981,6dc925734dc247129dec06da6b5a9cbd,2018-04-01 03:21:59 UTC+0000,cf031b15f505427792509ccb29474072,be5d23056fcb4f1287c823beec5291e1,1,3,1,1,5
5501,6dcbb8a290aa4a2e8ca8bf6e93467297,2017-03-19 20:45:37 UTC+0000,fc164e2cbf344b7aa638665dd06507fb,a1006e6a58a0447592e2435caa230f78,1,1,1,1,3
5675,6dd1c107936542c4bfdb30c66b8bc599,2016-07-31 16:22:57 UTC+0000,5e89764f89824eaf879558c58706555a,42deada7c50c4859a34615d70193317e,1,1,1,1,3
3699,6dd3bd7f193c445c8f57f77c8589b28e,2017-03-01 04:03:53 UTC+0000,c1fb26074abc47cd9563216672c5a0fb,dc28056163a8447686e5691f4c1475b0,0,1,1,0,2
7483,6de459abbc614771939fdf450ed791fe,2017-02-06 14:26:11 UTC+0000,ac0e6e0a59f54e03a917d6b53ab41a04,ebb75620ca404303ac2cafd61fdce9de,0,1,1,0,2
142,6df66d9a054a4306af63f3e26df3d6cf,2016-05-26 23:39:16 UTC+0000,6870df9e152b450498b66c41dced1648,cb3dd86ffe4345a1b855e08c04dad3d5,0,2,1,0,3
220,6dfe39e9ccbf4d4f9358f3c3399650db,2018-05-18 15:45:43 UTC+0000,31397f49638a452a812dff085d4341da,b457f47daea84a6ab9eb334d0b7e79c3,0,1,1,0,2
7882,6e06b134d43c419ba67e599de7507fab,2018-03-03 18:19:39 UTC+0000,acd211acaf4e42578044b3b07210a71b,05ab77d4c6a141b999044ebbf5415b0d,0,1,1,0,2
2205,6e1129a253c5489cbb381908fb16ea34,2018-04-13 18:06:22 UTC+0000,fb2f2079329746b79fe8e3e882e78611,5ff70ce7368446bd9f7ec691806b49e8,2,1,1,1,3
3859,6e118812b3e946a795df170f20f2e973,2016-06-24 07:51:41 UTC+0000,a563e533601748ce8ff199669bc08066,614ba4c0aa534b759b73e8473fd5ec88,1,1,1,1,3
1348,6e1a9bdc76f34c6fa8d84d2e30b4f65d,2014-11-06 15:18:17 UTC+0000,e190c4120e354ecda7be57c03123fbef,ce77b73a684a45088a3736eda7a57c41,9,3,0,1,4
6694,6e26bb88c5194f6eb419ff5974b77d41,2016-12-21 14:55:50 UTC+0000,7ededffcf6674dc99982669b8d2f49aa,0355aaad83704ad98e6d71b79db85849,0,1,1,0,2
5173,6e2b16f992e1449e948c3ad156de9732,2016-07-02 18:27:13 UTC+0000,30b387744ff84bbf86db799263a62016,58fa5e95fe9e480a9349bbb1d7faaddb,1,1,1,1,3
131,6e41045f5fd1472e9dc572f4e8cc0fa4,2016-05-20 04:51:08 UTC+0000,6c6febb159174895a89f32d1ea8dd03d,7873744371da478f8d24242468aa1b3a,2,2,1,1,4
7401,6e438b51820a43b881dd90b6b1188498,2014-05-27 18:28:11 UTC+0000,3b0b827de97e4f65ab0d06394c80c5cb,78240bcd03e04ba4af564a155fc8a028,0,1,1,0,2
6372,6e62433c73b54afe9acf88571a649024,2018-07-27 13:45:26 UTC+0000,b10f7915235940d8abf7fb2890c0cad6,cb7141606c7b4a00ab42547b55091978,1,1,1,1,3
2976,6e646841d318427d9b1491ea3ffdc234,2018-01-26 00:10:28 UTC+0000,4638540cd6664df0be5517b2b8cae7f6,887c5a142b42466fb74740d72989fc74,0,1,1,0,2
7841,6e6e5b21860442f1bfe4c3ebb9b275f0,2016-02-14 03:21:14 UTC+0000,db43a0ead25347c2a1e2a3875af4a962,0334dfd55c574601ba8e56b4c6e2e4f0,1,1,1,1,3
5751,6e7273cf46124c7f959b32aac56501e1,2016-05-11 23:17:27 UTC+0000,fcc6359c25ce4547a62e0003b2b23ed0,0634828387ca4db7b8106df1028cb608,1,1,1,1,3
6724,6e766715d9a64a7cbe029e561918d390,2014-12-16 18:29:09 UTC+0000,fec8666573da46d498f2b99cadb1b6be,482d08039f0542cab32f53ddfb18db9e,2,1,1,1,3
6676,6e85693608974adda821a2647930b049,2017-04-05 23:02:00 UTC+0000,a1f6a87d50dc4e009928293bf659e557,5361e4e6be2d40729ec52dfbd5d5ecd4,2,1,1,1,3
5123,6e995872213a4e959edfb38ad7878c29,2018-03-01 01:25:49 UTC+0000,b0a891c9cf164821a1742506c74e32c1,ff83e44e406d4e4cb7029dff964d7bdc,1,1,1,1,3
108,6ea8d5b5f7444aecaf011b34038dbc93,2018-09-28 23:05:27 UTC+0000,b170243e3a5642d6a168aa8398618088,4c1333590d234f9bb0f4cf0eac4c6efd,2,1,1,1,3
3272,6eb3c035948c4612961a0882adf2fc23,2018-01-24 21:54:38 UTC+0000,3e3935d98faa4b05bc7cfcd7f2e93fe1,cbba630e12004d6bae4fc7305c7b7eef,1,1,1,1,3
852,6ec08061a81048c893044543533f587f,2012-02-16 18:24:56 UTC+0000,9088783a8b4441aea1e81a88d4d0f04d,9c5803ae43ca4cf6b27ea85871625116,1,1,1,1,3
4513,6edfcdcaf3844146874cc3723caa4e3c,2016-05-12 19:28:12 UTC+0000,a3679eaf13f94da386f7d8ef6bc24ea3,2d7affe08cea433e9e3344ab72247381,1,1,1,1,3
37,6eeabcf49fb94f5eae61a9febb21307e,2018-01-25 04:40:50 UTC+0000,6cc5e0737f914f86a615a2fca001d022,914aaa31bada4f3b878ba78e0a76ccc2,0,1,1,0,2
5203,6ef5f7eb8d4c4c4598b6f21b1116519c,2016-06-09 10:35:29 UTC+0000,bc6a5a70f4d347d39896972f3cb08fa3,de51e745b6354185a0ca5d02dc628416,1,2,1,1,4
4673,6f090cd107c343cc8e05c6512412457d,2016-10-20 13:50:39 UTC+0000,e85d1698d3cb42cdb91270d1c95074e8,16865d04064c49c0aa436b36fd43475d,0,1,1,0,2
5564,6f0e6cc57dbf414ebe6f4f776f2c9c22,2018-01-30 15:12:31 UTC+0000,bd5f6f55613647bb9efd46aa40d4c697,e6b29607f1504bc9bdb81783016df845,1,1,1,1,3
6348,6f2bc4345a1546919c6431dde7eb7783,2014-04-04 20:39:27 UTC+0000,fc414001da394110be4d79903e8d00fc,fe4543418c0846e5a65fa22b4ad9a304,2,4,1,1,6
4847,6f2fa869d1904c949126818b33756ffa,2014-12-03 15:11:54 UTC+0000,c5b4c1b30a124b25a492056148ee4a2c,7d425e8d7cfb4fe7b0702fff4d6d84e7,2,2,1,1,4
7403,6f3946f970f94e01a0816054baa17ad7,2016-04-04 14:16:12 UTC+0000,ef4f2615627741208e02f68fb238afed,a1006e6a58a0447592e2435caa230f78,2,2,1,1,4
6573,6f4ec54c793545c28c4aa7d1bebb3968,2017-03-22 21:26:46 UTC+0000,5dc23697e4d245d1a5db244d58e04b6d,fba595034c5a4f3aa27c3607b19eea39,2,6,1,1,8
1781,6f59a8e46b73444ebb3c330adf398297,2016-05-07 22:43:01 UTC+0000,8a4c07b0d63e4562bc916b8803b3e54d,36ff3b3666df400f956f8335cf53e09e,1,4,1,1,6
5447,6fa2fe94f7f94e27b4b03abe353122ac,2018-04-22 07:36:10 UTC+0000,f3c1cd7e431f4a94acc2a36ad9f18805,a57b872432684559923fd75838fc2f1b,0,1,1,0,2
1413,6fa5425266114981b774d2ab5e94c5f3,2016-07-11 15:59:45 UTC+0000,e4f565a0c1fc45fe904777f0c32f04dc,369f1c8646b649f6997eae7809696bd5,1,1,1,1,3
1579,6faadd318a4145f997d53eea5e92b9ac,2016-05-06 02:36:06 UTC+0000,546db90b97ee4195b864d6bf26d15754,58fa5e95fe9e480a9349bbb1d7faaddb,0,2,1,0,3
7441,6faf93b4c36b44a881e386e799ced03d,2016-05-18 12:41:46 UTC+0000,3bc2abe49a9b424ca478b935b6be84bb,c429ef15207c4930b97396066ffad72f,1,1,1,1,3
5041,6fb5b744906347978465f0805e78076e,2017-05-08 03:21:52 UTC+0000,4d24d246fde743e8ae2f8eb16ba29f8a,e51e05583b994cb39a2b8c78c07260b0,3,1,1,1,3
233,6fc26f0fa013438ab471c28d048e3cb1,2014-12-03 17:16:06 UTC+0000,1eded59ed81a477f9841308d4b750c81,4520f122d31241f6b83e3606ae3a1922,0,1,1,0,2
924,6fe12c70c8f34d5795c5a1bcb2bcb57f,2016-11-29 15:22:52 UTC+0000,9510fd6a91bf4d368728fa1af68ef5f4,4d9079c15bd94726b57d4ebdb63cc0f0,1,1,1,1,3
7522,6fe604f0ec464a79b24ba24ff64c0bde,2016-05-19 22:39:26 UTC+0000,0b4ca4ec892c403a8ee7370acd48a0be,8526230b44c94173b69d71d5d2faa161,1,1,1,1,3
1350,6ff53fbbb5c74d42aa7392a62cd3aa02,2016-05-04 19:02:19 UTC+0000,bc02055e70684586ad90afa6f92156e8,2f152a99afa744e08f24a389ee3f9566,1,1,1,1,3
5376,7003ceffea6246bb9d01d321cd027206,2016-05-07 21:32:19 UTC+0000,84b5847dde844239ac73e33aa0e477fe,36ff3b3666df400f956f8335cf53e09e,1,4,1,1,6
866,7005b4c40ffe4411b4eeac4a72e5b56d,2018-01-24 23:00:34 UTC+0000,6d7f8c906c844b879102cbc6e383c669,62d2f8f17b09408c8d3a034fdf1d03f8,0,1,1,0,2
1499,70061453178f42c2a8f95f7859caa691,2017-01-12 14:45:22 UTC+0000,c940ede5c04e4545b059de32d177f4cb,369f1c8646b649f6997eae7809696bd5,1,1,1,1,3
962,7014e068e6ab4d148edd454a3922938b,2018-03-14 08:11:42 UTC+0000,74e30874c06f4a3da5e09b9790c7de71,5d918248a80844659ed34efbafe4fdc3,2,2,1,1,4
4038,70204dbdd03e48acae1b693104f5e506,2016-07-19 16:30:41 UTC+0000,22b1ff44a6c5470b9257de0ec2434da2,b037355697ed40e687368bb233060e50,1,1,1,1,3
7099,702dc3c3b3e44b0894c3335209cd3180,2016-04-03 18:50:41 UTC+0000,609b897353bf410183813b438c0125fd,93d0c6046a4f456896d9b0057369ec78,3,2,1,1,4
8013,7033a1f2974544c28aff9132617ba978,2016-06-29 01:12:14 UTC+0000,3adbdd851f2a40c5a150c8a7452714ae,25f5e94c4cb14e569aeff7cb2c98222f,3,3,1,1,5
1300,703c5321300f461191ec79b33eefba8d,2015-08-13 02:43:33 UTC+0000,f46e12472d294a2b8463009e6ee70577,9a0f09620c6640718c1792a74f3b8438,0,1,1,0,2
2629,70495b94d4414aa18208c2942de113f7,2015-03-19 16:15:36 UTC+0000,51d87e15a43d4f80b2199d28cefcbd81,24e8fdd2e4694913b2f5965608207dc6,4,2,1,1,4
3039,70496866613046f98b385fe2bfa60533,2016-11-02 23:53:00 UTC+0000,353cfd5082bf483cb064fc1483610b23,f440d21deb594b43a7b8b9051212fb2c,2,1,1,1,3
6853,704d18482671459db8a99eee2be19e93,2016-05-12 16:15:54 UTC+0000,cd0773bb4b0147eb95a469a1a9902bdc,8bc981f4fdff4a0cbd1473ded184ce5f,0,1,1,0,2
2190,70549f3422d8499ca4f043b272ea8a61,2015-11-15 17:11:44 UTC+0000,559b3ad63201426582d86a2a800d253f,a1006e6a58a0447592e2435caa230f78,1,1,1,1,3
4582,706ccacc60704d57be20ed4bf2160ed8,2017-09-20 17:46:04 UTC+0000,714dc4982430440980b18e16ebe0a5f6,85d29548f8ab4f4da9f383ffac05023e,1,1,1,1,3
4176,70778ab39b0f4d5a8cb0e99242fc95a1,2016-03-01 18:47:57 UTC+0000,eb99cdef7aac42a2934950a523608843,1d09798911c444ddb76641aa590f6100,0,1,1,0,2
2705,7077ea7cedf0491b9f3511249c568efe,2016-05-13 01:52:58 UTC+0000,ea46131711dd4bf38f47c41d491eb087,9376455dd0d24323bdfc5397406ceb2e,0,2,1,0,3
33,707f08d629b942e08003d0188041983d,2018-02-21 19:32:24 UTC+0000,4f2d89a0ce6b458783abbcca0498e44e,ad4031fc394a4b59874964c23d791f0a,3,2,1,1,4
3411,7081d54d9ee2405ca4a0e05bd90f0af3,2016-05-13 01:39:54 UTC+0000,304bba82d61c49f3b5c27a876ba3fd46,47b0e0eb62da4ef3ad95e1ffbf0d72fd,1,1,1,1,3
4059,70890d8362004c029efffd693a98f159,2016-05-25 09:57:07 UTC+0000,96c40edb1c3c430d9a2f0497c5774fa8,683097dc03c4440aa163593a628e0f3a,1,1,1,1,3
2732,70a2b4cdd5ad4dcb91edd6c3bc793193,2014-03-26 21:18:42 UTC+0000,5ba05c340ab74e429fadd22b0c318d9f,5f4c8c5868cd442e8e0bc218b9a10e03,1,1,1,1,3
1070,70b0579c6ffa4806b00f1b3849344af9,2016-06-07 16:56:02 UTC+0000,8d1000c2cad14718b70a4523d3c309a0,de51e745b6354185a0ca5d02dc628416,1,2,1,1,4
5405,70b265f47b5d4e118c826393458fa3bc,2015-03-19 11:48:14 UTC+0000,f3b22594ed864030b66ce1e8378bab23,d2d56c36d61e457689c449bdd59c1d36,1,1,1,1,3
4598,70b954fa59814a2d94c5583eccb2d442,2016-07-12 16:02:05 UTC+0000,e05d1ee4690e4859b8030f58199a006a,502b34058b0945629688f665a11ff821,0,1,1,0,2
3801,70babf8892414c5da1e236e6336f7eff,2014-02-21 21:07:04 UTC+0000,87a2b258296e48f7b2185a334dc93194,4510051bb5c243dba36c381313398e3c,0,1,1,0,2
5756,70bb41bfcc174bd8ace3ec0d79459d9c,2014-03-06 01:15:46 UTC+0000,931472ce96ca4b129517beb225b8b47e,77a65aed859f4b11983cd07399f1e3b1,0,1,1,0,2
7438,70ca4e27f9c646eea52386302f4c16fc,2018-01-25 04:24:51 UTC+0000,42d1581ab49e453d9ffcac211955a3e9,36389a004e3d4ff3ae4992341e132449,0,1,1,0,2
6193,70d35cb7f02f431d811a5d592e88302d,2018-02-11 14:51:17 UTC+0000,04c6d984dc5e4901a44ff1edf0eb659f,8d63cf34213f45189a5a8eabd9d71529,3,3,0,1,4
163,70e4815e57d34944b3427e81e66a1c72,2017-04-25 21:55:53 UTC+0000,4f801e52cbbd495dbe58cdc240da702b,de8aabf2869a4104a028efbb10cfdcf3,1,3,1,1,5
7567,70e881dbe6f44bbda5dbcbe0e6b33f31,2016-10-09 02:42:35 UTC+0000,598f8d663ce048af91109ebe46d24781,f440d21deb594b43a7b8b9051212fb2c,0,1,1,0,2
7088,70feca022e724233a158ed70b7668f59,2015-03-26 19:17:55 UTC+0000,2735baa7df944cbc98016f997b410257,a1006e6a58a0447592e2435caa230f78,0,4,1,0,5
6824,711272fcbdc04edeb6b97fad9cd73f44,2015-11-05 18:42:18 UTC+0000,e3a40005e7a14d06a2eb4a340c029da8,a1006e6a58a0447592e2435caa230f78,5,3,1,1,5
5795,711731938585456781393cce736d66e2,2016-05-04 14:33:56 UTC+0000,b521ebbe222942f7a13437b0248449c6,96bbbdd06a334805a0501034d9df1aa4,0,1,1,0,2
4768,711bad17e7594b0b87df6190c982946d,2017-06-08 12:28:16 UTC+0000,7aad58012f2246649bafabc41f249fe6,81a594b683d54e6dbb4b04ea00a5e25b,4,3,1,1,5
3515,714ae692353f445b8ffafc2444d98d0c,2015-10-24 15:15:15 UTC+0000,1b73ed50ca3c4b4296d69c6d4b9e92ae,c1a24b8f746b47488da02a0e5044a7a9,1,1,1,1,3
3030,7177c4fb56e34192b310ad86a3b61ff0,2018-05-21 18:19:20 UTC+0000,bc84195749854d589f5e2f2268b2ab46,900f43d005714c0c93605b7a7684936e,0,1,1,0,2
1636,717e1a4e88804085966cf67256800c44,2015-06-04 19:20:11 UTC+0000,758b3486305d407e9ef89a0adc8528c1,d5f8623333fe47a98a8dcd4a8d9d606d,0,1,1,0,2
2114,718567ba2f144e29a73850899e4b31b3,2018-03-21 02:54:40 UTC+0000,24ede81fe3c34137b6ca40a479a50749,913368c5e86d420e958d89e794e74bf5,0,1,1,0,2
3695,71ba77b77a6d46648c33c9149d76a1ed,2015-12-08 22:55:10 UTC+0000,3e3f41718f5f4942a945e9f6d011a276,a1006e6a58a0447592e2435caa230f78,1,1,1,1,3
6125,71bc17db7fd14ec48f84c6ece329290a,2016-01-27 00:54:14 UTC+0000,f16eda0cd2cd48e2b1fdad86d76651b6,0166e174028843dca3a392053f9732c8,0,1,1,0,2
5417,71bd249b8b4844189f7395f92a735e8d,2017-01-31 20:14:03 UTC+0000,d0c6a33316634db09321b5a43bdd49b3,6dd29d5757d343eba6eae82e719835ee,0,1,1,0,2
7274,71c1804d413c4e538ba64fa7041538a6,2017-02-17 01:57:29 UTC+0000,9fc01e7092dd4c819aa81f502d11475f,be5d23056fcb4f1287c823beec5291e1,1,1,1,1,3
5963,71d471022dd741a38474498588a4b6f3,2017-02-10 14:57:02 UTC+0000,0fd3f1acc0dd4290adfaf85a284d1575,f11131c35a9f41288d63ffb1c7cfbd41,0,1,1,0,2
2263,71dc7364cb7043069abb7b20c05ad2ab,2014-04-11 01:54:37 UTC+0000,ad15070e6da64414a4b6f9e95f72d194,5881512e42294342af89a177946e1d63,1,1,1,1,3
1147,71dcbd016696400fabc3ee00da06d7f8,2014-05-04 21:44:21 UTC+0000,f99da2c6ceb54c4ebbc073559f721598,3d8847ddc8d04185976a9e78b190ebdb,2,2,1,1,4
4522,71ecf562b3af4de09463ff31716d58f8,2018-12-20 18:39:42 UTC+0000,9ae74819536b426aa77e27a44cdcf410,189899a38539480290b06b234cbb9136,1,1,1,1,3
1344,71f63edbb1334abdad3f4940d3c9b933,2017-02-10 15:06:25 UTC+0000,0b900f4de8104cd6a638b8ba638cb396,f11131c35a9f41288d63ffb1c7cfbd41,2,1,1,1,3
3596,7209ab31925a4ddfa4a9d9eb01a31dda,2017-05-17 19:48:30 UTC+0000,336dbc1fbbcc4dbcb5b6a1426bc6eed0,7a8c218574a14993863641bc5900a9c1,0,1,1,0,2
72,721067375ba24775bb7b64d9d2c3ebdd,2018-01-24 18:21:19 UTC+0000,d6d3c4f93f8541799c3c7f68393824ba,d76a64e53aa242bea01e3c51310745d4,3,1,1,1,3
1404,7220efeef16e4372b97044c70748cbbe,2015-10-23 15:40:25 UTC+0000,12fe5e6946c64dc0969172748f0fa537,a511df5378da447e99de53ac92a76e7b,1,3,1,1,5
7581,7222b06238de4bc2b29baefbb844052a,2016-05-06 18:16:48 UTC+0000,415582b06def43af94821ca9815025e4,422412a0f6154a4ebf8f7dd026d66a5b,0,1,1,0,2
2983,72276bf2e1de423e9191871fa697a1df,2014-09-07 17:36:21 UTC+0000,4d19e488176f464aa11065eaca5fca53,fe4543418c0846e5a65fa22b4ad9a304,1,5,1,1,7
1911,722d54b475484b3987d3c889c1d0905a,2017-07-10 23:00:47 UTC+0000,642387d7c50b43b69b17be4ba9ede400,a1006e6a58a0447592e2435caa230f78,0,1,1,0,2
3199,722dfe8db0344fc5ad202ca3c965c6ce,2017-06-06 05:49:21 UTC+0000,0fb5617dea98472fa2a35ba9b17e7f6b,dbfc21fbff414832beed41c7a5966096,1,2,1,1,4
6860,72343698e1704f4d8777eda4aa190b5c,2016-06-27 03:36:36 UTC+0000,42c80b795ccf49d7975309a8d4acb155,30b1ef88592643dba57c33e4626684c8,5,6,1,1,8
5995,723ce3dd206443e68c2807095fdac912,2014-10-30 16:45:41 UTC+0000,b8a71ffe0e5e4f47b454e0bf716097ce,9a0f09620c6640718c1792a74f3b8438,1,5,1,1,7
3053,723d6e0ed152405a8733f76635f0c623,2017-09-23 22:37:14 UTC+0000,c2bf639dc80946489e6484d77426ee24,93acc65fba694fb5a4a9e590dcd81c68,0,1,1,0,2
669,723e5b438ac84161a02d95bf38dd8667,2016-05-21 16:46:20 UTC+0000,13d1a969d46d4cadbf24c8d1efa1241f,58fa5e95fe9e480a9349bbb1d7faaddb,1,1,1,1,3
3406,72454fafede344a0af1a1ebd999581d7,2016-05-19 15:01:27 UTC+0000,405b9ef23227483fafa76df5cf2643f1,cd76be283bf24fc4975b6e94418f6e20,1,1,1,1,3
1043,7246fa23f70647f18fd2434b5e86905a,2014-11-11 14:49:17 UTC+0000,bbc5d22ff87746e1b09f234885d57dcd,0355aaad83704ad98e6d71b79db85849,2,2,1,1,4
7586,724a5f66ffe54500a7ac02af678cb2e0,2016-08-15 16:26:08 UTC+0000,36391dcb47024154996aa92eb4798cb5,373809641ef04ce68113c70f3d50ef98,2,2,1,1,4
5821,7276af49bc2047e88ea9f2e039009772,2016-08-31 23:59:14 UTC+0000,a09049ab8f8e402cb8d22f9d7d4f9179,e1d39b665987455fbcfbec3fc6df6056,1,1,1,1,3
7957,729e1488dc724782b865dd80d4da8df6,2016-09-22 12:00:17 UTC+0000,2bc8b2c9f017498e87e1e04ad413f53a,be5d23056fcb4f1287c823beec5291e1,2,1,1,1,3
2519,72a0f6e6ae044ba686f20d8d7ef81f1a,2014-10-16 20:01:53 UTC+0000,8710dc34915a4dc88cf89ca0dc18650c,05444a2f42454327b2ac4b463c0adbe0,2,3,0,1,4
7372,72c03306d5704ec69ef672af2f5ce9d3,2016-03-16 14:27:06 UTC+0000,5c5db312e1134ad6a46bc6386f4c74d9,bb4fe08bb5424f08972927d90bad9642,1,1,1,1,3
3832,72dd729b75194a11a61d18f98deeb064,2016-12-21 15:07:14 UTC+0000,6397fcc88e06408da15daa04433e78b1,0355aaad83704ad98e6d71b79db85849,0,1,1,0,2
4096,72e34682fcf448c2a480062816459411,2018-10-26 17:06:52 UTC+0000,75fd9cbed5464968acb1d85d4a9f8464,e2b4c84bf1ca4aea9b108869692d8017,2,2,1,1,4
1229,72e6a16a25eb478eb904bcc507f30d39,2017-12-19 22:26:11 UTC+0000,c58560a7c285479ea1007a5e213351e3,f2cf4f06be6b4795aff6258dcbbfad37,0,1,1,0,2
6504,72eb9e8a713d4401ae19f1865a44e2fb,2016-05-03 18:44:32 UTC+0000,d8c17ffd5c4f49e794fc0d841be122fe,8f44237ddad84f2184cfe4182fbf1105,0,1,1,0,2
6920,72edc78927a04522986d8425a4da9997,2014-04-15 06:55:25 UTC+0000,cf31d8eea5b142718d1580bae2e3f4bb,564ef581bed64addb3cf0ff0ab652ffd,2,2,1,1,4
5061,73001de983794e1d95800db444620669,2016-07-28 18:58:32 UTC+0000,2bd997cdafb744d9ad43337ea0c75806,a3f6d682096743b2b88e7d3540f3dcff,2,1,1,1,3
2047,730d9bb53afa4b88b12fb91771120299,2014-06-11 04:11:01 UTC+0000,840bbbd7b61e4094abe6142493157abb,ed441d70b5a1437686e89b459101d8a4,0,1,1,0,2
4683,7319e3dd3e71433a80c1bc272cc34c39,2015-08-05 19:24:53 UTC+0000,6d14e112e70644b4ae1d7646e780c58e,7874f177d101481a9920bece1156b6f1,0,1,1,0,2
2127,7324e448db6f4a2bb74b1ca6bfc4155a,2017-05-27 07:22:29 UTC+0000,76ce2f532e5a4ec0890b253621bf091d,4dc7d9040592416f98c0bef1ad2c31f5,1,1,1,1,3
6525,732876155b3b459ebe9bdc5606c4a531,2014-12-01 19:38:39 UTC+0000,96196cd577dd4ebda658823b2eb92ab0,3e0f8b09451c4a8b9ddce027951685f4,3,4,1,1,6
4601,732e4080c67e4c81a4c41ffc63a72415,2016-05-17 16:41:13 UTC+0000,049a4cd2b2b64dd190f3c522eea6580b,7dddebbf1cba4a1f8a2c3cddd0e5746b,1,1,1,1,3
5761,73354c16a9cf4a51a0758d68a0c206e5,2015-05-10 17:11:30 UTC+0000,5fb1b3a874ab454db60d173a3d7bb85b,cd42134fadc7495da910d5c60c21b44f,5,3,1,1,5
2702,733e424934054f49bb03dcefbb189307,2016-02-26 18:01:56 UTC+0000,54e67b671fdc4d7f920abbe267e54028,80b31cfb551749e7939c6790f5521b7d,0,1,1,0,2
520,7342793de47b4a989425d1f16b2e19c8,2015-05-05 16:53:21 UTC+0000,b0db497180fe43c1b6a4cee7d2f207d9,b3f92f529343401bb3fa8db4c27de73d,1,1,1,1,3
1686,7348694e56034281a70f55ef159c0013,2018-02-10 23:53:37 UTC+0000,8909ee227eed4a73bd68bce19f2e228e,a6d33c38902546849c36ea7e9e9f0870,1,1,1,1,3
4471,7363d855a736438bba910d322ad4cdb8,2016-05-18 14:35:34 UTC+0000,3fe72308e6db4deaa27988e7a2ca5e7e,7bffa1792d474359b922e5de700d7a82,0,3,1,0,4
7603,7384c90a1282443ba74e39208349b45f,2018-02-24 19:30:42 UTC+0000,34d1209d8ac94ac9b347f42408c0c6c9,d1f04208de3643c088f4a25e57f1cb2d,1,1,1,1,3
6422,738a8aad00024db99ae11b31782edc29,2017-09-12 22:43:15 UTC+0000,bff1539923a742ebb32376b684521725,c285b983f2bd4893ab9c5b25930a82c9,0,1,1,0,2
722,7397d72ad1974031ac953ed4534ed94e,2013-09-12 01:17:08 UTC+0000,fd782d2fa3d74c148407dc80983477d0,9d2599d9131d46889d164a61924ffb2b,2,1,1,1,3
3624,739d1ab3dd5b47a292a9002364399bb4,2015-10-08 18:16:47 UTC+0000,8b58e3c1b9e646fe96563725eeb4edfc,a1006e6a58a0447592e2435caa230f78,0,1,1,0,2
1410,73a95905530845a6bbf9feb9a44046f8,2014-12-01 19:48:30 UTC+0000,5b9b0ab3de23472caf424ba538ccca73,ec97070fe75544e0bc5888f9f6120822,1,2,1,1,4
130,73cad4bd760f466ba5764406690cadb3,2018-03-02 20:34:21 UTC+0000,29b22e1c54944c52bd21f845d83d1ad5,89a24bd4dc934298999e77640158b690,1,1,1,1,3
2840,73d43b7affa14b99aa1e8439e2d8bce8,2015-10-20 20:04:06 UTC+0000,9c4ad076b63c4dd2ad26d27739281320,369f1c8646b649f6997eae7809696bd5,1,1,1,1,3
1715,73e5b1bee95e4ab4baceb36f2fc45d00,2016-05-14 04:24:32 UTC+0000,53a482bd671c4cc7aeb84b64833a5804,736dac92aaad4f9ab1cd1175655aff59,1,1,1,1,3
6448,73f1d7edaa9a4187bb45f3b83234b702,2015-02-19 17:11:14 UTC+0000,706cc794a7f64f53bde663e66f2d2e8f,369f1c8646b649f6997eae7809696bd5,1,2,1,1,4
6677,73f3f00bb0ae444dae669435e7426c47,2018-02-21 16:52:35 UTC+0000,68368f9ef28848518524accfece31861,ad4031fc394a4b59874964c23d791f0a,1,1,1,1,3
1367,740c7c37d32a4b3e9fb0a396aeab821e,2016-03-09 20:37:22 UTC+0000,54516a3e101145a3b8cb4ddc41c91685,bc9c30e01f53434e849b7582fecd5843,0,1,1,0,2
6556,740c9b87b4564a3398326b7d87cb8e07,2014-03-18 07:37:33 UTC+0000,8839232d13094d08b1e6609cd82bf05b,d90f99de84174be081195314d627117b,8,2,1,1,4
1477,741591f10509498f91d08cba62882482,2016-12-16 19:53:08 UTC+0000,f2570c68c40e4148973c393a84af7886,de51e745b6354185a0ca5d02dc628416,1,1,1,1,3
1958,74179bfc73a14731b0d885bb6d091edf,2018-02-08 15:34:04 UTC+0000,fa608393519043c8b471a8838baa2dee,fe49d48526dd4c92977224777b25aee2,1,1,1,1,3
664,742d9eda3ff643c09387422f867229d9,2017-07-10 14:20:19 UTC+0000,ddb32dcee4d6449da0f6d6e54cba4d86,73f8740bd68b4c02b1ddafffdfb0c37a,0,5,1,0,6
4662,742f0831e9ac4598b2e85deb006f81d8,2016-04-26 22:05:00 UTC+0000,de1128479124417696eb3f8eed0b1525,e773d6ccade64f38b1b960c6b64f0a2a,0,1,1,0,2
1507,743d33d00ee24c698efbc9d688640d03,2018-06-18 20:59:59 UTC+0000,6c4e1657886542878350a66d85ad4a13,6ab3589015664012acdcb9024f25d213,0,1,1,0,2
7647,744ef8e80d7444889ab19a5495e8fb48,2016-05-17 03:04:31 UTC+0000,a3cbf2e30af64660ad974a29239ab679,58fa5e95fe9e480a9349bbb1d7faaddb,0,1,1,0,2
1255,745659e790094192bde6c6ef81e3ce1d,2012-01-26 03:06:07 UTC+0000,9ba6da4dec704328b750aba9f962a366,8442ddfd38bc422fb4677785db0630e6,2,1,1,1,3
3826,746012d3abb24b8d8e8cffa42ac21399,2015-06-08 12:35:04 UTC+0000,30bd16aea1f447e5aff56856748477f8,2271b881415b4eaab39150b7d3332fd2,0,3,1,0,4
3314,7469c2da142d43569b8605ee4882b7cf,2018-09-21 12:50:41 UTC+0000,665194e6ec5244d1ab18313c986a29a3,36ff3b3666df400f956f8335cf53e09e,1,3,1,1,5
3693,747011181cf049cd98f55c817f5b682b,2017-02-12 00:16:33 UTC+0000,3ae956cf972c45578fe324e06d93d68c,b3e351718f484ffdb7e5c46c7f5877e4,0,1,1,0,2
6932,747f8be276ec4b3bb8ee19382fa50891,2017-05-15 20:46:07 UTC+0000,99260ea9096b44a39adbe4e0421176b9,a9cb4a0b667742dc8f3a243f9dd530cc,0,1,1,0,2
3798,7486a740f467456b8b612c810f5fb868,2018-03-03 19:30:17 UTC+0000,3b4628b3a72943498d7dbb1a8173a6ac,05ab77d4c6a141b999044ebbf5415b0d,1,1,1,1,3
5624,748de802c05e4417881ee47d579657a3,2016-08-29 18:48:58 UTC+0000,5a02a197b5574417b80a4495e910a265,36ff3b3666df400f956f8335cf53e09e,1,2,1,1,4
1905,748df3d2ad664926aec93b4badec705b,2015-09-05 03:33:46 UTC+0000,b914b2bc37774c9a90540220ccda020b,a1006e6a58a0447592e2435caa230f78,0,5,1,0,6
1090,7496983a8ab64c02a3b8e0dbd3be14b7,2018-09-05 02:50:07 UTC+0000,fce71b470aed45238d79f1cb9ddf06f3,4d9079c15bd94726b57d4ebdb63cc0f0,1,1,1,1,3
1853,7497b0d0817d4986ac7a02afe472816a,2016-04-01 15:06:53 UTC+0000,f913461ccdb1433db3ea52f295517832,e9bdcc9c532348c6b90a3372794834d0,1,2,1,1,4
6183,749c63739f7a4d70b7f9a048c80f1fa4,2017-05-31 10:43:31 UTC+0000,fc215d8d6ab249938226735bf620ffa5,3b0d687829024e34a666a19daf42d5fa,0,1,1,0,2
5306,749c82cf88c54254ae67896dc2370cec,2014-03-18 01:41:29 UTC+0000,b2d8cd9ea98c48f385477ea54aac6d78,77a65aed859f4b11983cd07399f1e3b1,1,1,1,1,3
7424,74a2ca0b2e04413a998539c0d3601d23,2016-05-17 04:29:19 UTC+0000,765805a0a751439f9416ce8512782b7d,6624dab5dbd441b3b2bd61dec51a09f3,4,2,1,1,4
416,74b08b782e7648c6bb55e2c520dbbe25,2016-06-25 01:31:07 UTC+0000,85e5c4a5bf5649dda8eac53fd07dda33,5b85a1dee8b74d79a87d53e758d897c4,2,1,1,1,3
7915,74bc4e6caf3a4937bce9a1e78821dcfe,2016-06-21 06:46:50 UTC+0000,b54da5f6716844589b2413e92fdc3635,f4759af9b17f44c9865b041a0469dc45,0,1,1,0,2
195,74bf76ea9db24f858f79c9f16c3653ae,2016-05-06 14:26:14 UTC+0000,9647d30ad50c422abf3c7a6f931098a0,ee5c7a460ee14f6380b2b3e292b4aa30,1,3,1,1,5
2539,74cff929b53948d898c9f068bc6b7934,2017-02-12 19:05:34 UTC+0000,be1f7c381b2b4dfe81a32fd126b95be1,6764761f177e43879c232ec50fd9bbe9,2,1,1,1,3
7660,74dfbac099d14709beb8a8d8b2435a2b,2016-11-07 18:44:31 UTC+0000,fec17b8965e84566be1144e73d1732b2,a1006e6a58a0447592e2435caa230f78,1,1,1,1,3
7703,74e25be4728e40aa89d058b5a01a50b1,2016-05-08 22:23:55 UTC+0000,eb4c81e20bd24037a8bb075b3b2ebb7b,36ff3b3666df400f956f8335cf53e09e,1,3,1,1,5
5472,74e26c907f3e4fad8f77e3d23aaff840,2016-04-29 23:54:23 UTC+0000,3d951605b2b040d7a2589b9a6f473df5,fe40a0bcb4ad4f819d308bb1c91ec221,1,10,1,1,12
5126,74f5775b2bcd491196fc2d699d999d4d,2015-02-19 00:17:58 UTC+0000,565497cd122e4265911173eb1cf7bf1a,af14e8a1ac1340c99b75865d40a5f913,3,1,1,1,3
7861,751dfac1d1974cf788f51008250c120e,2016-03-03 17:56:38 UTC+0000,e87eceafcda14f6895802bec63872b04,a1006e6a58a0447592e2435caa230f78,0,1,1,0,2
5077,75205a32db774237a3ffdf495c3f0b20,2017-06-05 16:12:32 UTC+0000,b6005a3632234861b366ff8793f87219,e01867e26f0f427ca453560d1be4ea15,0,1,1,0,2
7803,753115cdd60c4f50b427157ff4f48d9c,2014-07-02 05:23:13 UTC+0000,c744a94fe940487ab2b019bcb5309c53,461f92b955924604832a92b6bc14ac1d,1,1,1,1,3
2294,75360870a28c47e89efffd37290ca622,2018-11-27 22:59:28 UTC+0000,48faf19c5c6a4eee99cb6064d21cf798,8c06c8e1863d4cc6905cee6c487a1e28,1,1,1,1,3
7071,75395bb3bf1846a0b15e6f52306c9b64,2014-07-18 07:53:58 UTC+0000,2ee22f44001f4c8a92e5ecafef1d2d96,9f914e94a7c34e7399066e1724b3466a,1,1,1,1,3
5893,75456263a9ec41288512537d92403020,2015-05-11 12:32:52 UTC+0000,e031792767f04b338370ff57b9b57b26,7aab6fb9a4ae4d0197fd2bc05960ba56,0,1,1,0,2
3491,755326e4e6a94951aa5b5ae51d8e9f10,2016-05-20 01:54:49 UTC+0000,9097db62f05648639466919b8d90105d,ce4132b1842e41edb9a830f591f2bc39,1,2,1,1,4
192,7561394a2c6b48168124184b2317a028,2012-01-19 18:05:03 UTC+0000,a56fa162e7fb4626bb459a966f30cab2,fc993910544c483bb1d8cea5e7120377,6,4,1,1,6
782,758361531a53436b8ad8f9658c562b59,2014-08-29 15:22:11 UTC+0000,4b8a35c4a2384dcbb60862d71b279d5c,5178c34b57d847d483d4fbd70607c73a,3,1,1,1,3
2601,75c405c54cd44167b454f1c701730101,2017-01-02 22:24:29 UTC+0000,c135a3e2662543fd9e251f8dfa71da44,e558151137504b15b92b1433257bcffe,1,2,1,1,4
7393,75ca51e473d64187b971ec61c18ff149,2017-02-12 23:40:48 UTC+0000,fa10ec169b98408f8c2ee48d556eb5a3,391afd6b35e141df9764753bb5a4896a,1,1,1,1,3
4230,75d495c589f74a26a9c7e9cb781549cf,2015-04-08 21:11:12 UTC+0000,3f484ac6452047a0b43188480269879a,2b4bbd8088ea43018c1b9e32c2c3bf9e,1,2,1,1,4
6065,760a6762e44b4428a79e6d9a4f9268c1,2015-04-07 03:12:26 UTC+0000,3be0ccf835f24e3fa321fa1931bf314a,05444a2f42454327b2ac4b463c0adbe0,0,1,1,0,2
5834,760e6945acb24139a89b431c36b41df9,2015-01-25 02:53:12 UTC+0000,c12dc32c553849dd8f18feb5aa102910,fba0925c233d4f8093de3bb6cbcd9641,1,5,1,1,7
4653,76139f36fd47459bbb8de42b914f79e3,2014-11-25 19:37:39 UTC+0000,ad705d161e2f48f7b8d5e90c3d6dce7c,4c12084bb3d7494e9ca78f55b1432db3,2,1,1,1,3
3300,7614fa32a6894938ac7b517974fba57f,2011-12-30 03:54:10 UTC+0000,53514a947a5c47f6bea05153fd6e78ab,57bf55fab9b549d3a2d9afbe5a6ed7dd,9,2,1,1,4
528,7620c2a757e64840971ed2bd9b9a22f8,2018-03-28 11:49:24 UTC+0000,6f103adf14114ac1881b87db37db32b9,36ff3b3666df400f956f8335cf53e09e,0,1,1,0,2
3586,763336f0c7c5497eb41bf26174e3b005,2018-02-08 01:33:53 UTC+0000,daf99be6d9744cc2b1b55c1e569f5f35,325cb16789f84a2db8486519a13b59b6,1,1,1,1,3
1875,7641b7db6e384a609d0472698e6b29b6,2017-05-05 17:21:59 UTC+0000,85f5eba12bdb4f7a97f48f645dfd3e6e,0e177df9e4ff466ea11d4d7ca01606eb,0,1,1,0,2
977,7645870b331849af8414cf07bf034649,2016-07-28 18:44:44 UTC+0000,405230f13a50464d99d7c03a0cf2bc20,a3f6d682096743b2b88e7d3540f3dcff,1,2,1,1,4
1697,764add34779a424bad9ebbbff5a5b34a,2016-03-03 15:03:54 UTC+0000,148ee393ac38471290608f09c2583b9d,05b927c254c3415da549bc7780c9e43a,1,1,1,1,3
190,764f668ca87f499a8b685c9aab1861ff,2014-03-04 23:43:13 UTC+0000,f6048e8308e2416093db4d764f58d93a,eaa70397304642dabb1cbfd928520458,2,4,1,1,6
2887,76652bca4ed04eafa3a4e59b217c17a5,2014-12-16 18:09:07 UTC+0000,ba9511a60e22483bb92b8a99dff8c4dc,7b23d6e64a9c4b9682d9bc6109249c61,1,1,1,1,3
2499,7667a9789cfa42b0974657139f2c4fc3,2016-04-29 15:34:32 UTC+0000,54d932558c794f77818586c5246db5a1,677f47d4daf5467f9ce9b5a0611d3ffc,1,2,1,1,4
5219,766a521b59de4cb9b975e6ae3d259776,2016-06-06 00:12:28 UTC+0000,4eb84f3a8bb3494989409722d13308f3,58fa5e95fe9e480a9349bbb1d7faaddb,0,4,1,0,5
1120,766c398a6c90485b8ad8de153b79bf65,2016-05-30 23:12:06 UTC+0000,cd4c1a3ffb024dec9761825a9e3af4ef,83cfc4f44b9d4fef8cb95530319d8b53,0,1,1,0,2
2872,766ee4ccabe1414784fcec0c1ca4cca0,2018-03-16 19:29:32 UTC+0000,4f39c6cee9c94e57a0791653e1736883,92c7c06457344ae2a736ac7d2babcaa0,0,1,1,0,2
7075,7677ac277da54afa92a131511f909b56,2016-05-28 10:12:42 UTC+0000,889228f600dc4f598368c49941bbda5e,8d63cf34213f45189a5a8eabd9d71529,1,1,1,1,3
728,767fb59f19c246d4951cc89b72e86f0a,2014-01-24 14:24:38 UTC+0000,c32eb60e89474aff9c8ea743b991edc6,55b3a1d9aef146a08b6b696c20aa639c,2,2,1,1,4
6387,7685332d1bf14b838b20cb76e707a5c7,2015-06-24 17:23:06 UTC+0000,8ad7f351125a462cb05d8fade44e1431,a1006e6a58a0447592e2435caa230f78,1,1,1,1,3
4291,76961d254b02496488cead16dfa08531,2018-03-05 00:36:30 UTC+0000,7b05255525ee498c9472c3d31510cdad,046616de94c4464e88cb11f81ee63305,1,1,1,1,3
440,76a19d52c8b9435f9a7b3fe7d50b9928,2018-06-10 19:51:26 UTC+0000,6fe0be547856494bad9321d2e7d46d6a,62d7966a329c4da0a30808ef0e2f40ca,0,2,1,0,3
4908,76a97b2113d24d5f8c6b21d86d74ef96,2016-05-19 15:19:32 UTC+0000,eedce56bea914ad8ac151ff0bcba0c23,20e96c85343545ef923d11b7038920dc,2,1,1,1,3
6329,76b1b0a8345d43388e2804c81bebe03a,2016-05-25 20:39:03 UTC+0000,7b842d9de7a24f57aaaf499e4b6ff3e9,48c71474c467401f8ec43b5f5522f6c4,1,1,1,1,3
4394,76b2639e4c87439a802b24cc8248f571,2016-07-02 18:57:47 UTC+0000,7924a15f62af414682dd06de8f9085f1,58fa5e95fe9e480a9349bbb1d7faaddb,0,2,1,0,3
4693,76c91a4e967c4326b267f2e1d862ad62,2017-03-13 02:58:13 UTC+0000,2577b541f0164ebd9a1950efc41ad2f0,b120c0de30e64b74affbb1ce128077e7,1,1,1,1,3
5903,76d2f7dd3ce04c70a2281008b1f03ae6,2012-07-09 18:49:11 UTC+0000,b5cf031eca134289a5691691c2e8097f,05444a2f42454327b2ac4b463c0adbe0,2,1,1,1,3
1540,76d475711d9f4e9fbaa4e13034ef8eaf,2016-05-06 02:58:17 UTC+0000,6bd12a6f7ea04074966a2d11f9818cc2,58fa5e95fe9e480a9349bbb1d7faaddb,0,1,1,0,2
3649,76d9bd6d7c49480fa8502c8844976ac4,2016-07-12 17:30:11 UTC+0000,eedcb4342bf947e5b0da8e77f05d26f5,ad741868a4494cf4852e40afb02d7956,1,1,1,1,3
5607,76dbd6a16ac1483cadf5c04917a89f9e,2016-08-26 19:40:32 UTC+0000,680a70b9e3ef4c97a773245c1da1cdd5,f28c1e97917545a48c55f9c5848e9682,1,1,1,1,3
749,76f34e6c2eff49b98ae28bedac51a940,2017-05-10 17:26:10 UTC+0000,fbcee1a7112748f5b3eb65368d55e10a,fca11d66a360458d835905893ab52d2a,2,1,1,1,3
5270,76f5d383168d441c88f1fe8fa0472492,2013-09-30 11:23:29 UTC+0000,b7fbdb8296d842b4992cbd05b7f8cdd3,e95dd549a9624dcb941cd371b50d0660,3,1,1,1,3
105,76fdc1c366aa41bd95ad4c8d357de90f,2016-01-22 16:19:49 UTC+0000,cb2d55bdf6934da0b90d6ad04a6ce54e,215b430910074aeaaf24538cee33e35a,0,1,1,0,2
7602,76fde7ee5e9644c19776a4583a1894cd,2018-02-21 15:24:11 UTC+0000,3dd580aeb33c460c84085f47b1ff3a3b,cde233671d1c4b54b5855ac481ae2a2b,1,1,1,1,3
711,770c37050b0245a481886379f4464d75,2014-05-15 23:38:37 UTC+0000,73aaa9ac9bd147e289b19c21c8dcc5ed,0ae1d01bbdd141c6bdea66ccc21f525f,2,4,1,1,6
5701,770d764c63d64eaea5fb012e54fdf2a6,2017-01-30 16:25:39 UTC+0000,38f25112d103450a89ad2e9658aa048b,da256714ec984a42a37a3549947461f5,0,1,1,0,2
3362,7714d67901744631b519486ea9d04d74,2017-09-05 15:46:42 UTC+0000,bccfbdfc380e44778e8abb938a085bca,0a2b63e4624e4fdaac0a4127b6cbe85d,0,2,1,0,3
774,7717911d1d4946aabcc34b9d1ff3cf62,2019-01-08 19:56:58 UTC+0000,8e47b4a7154b4dcaa83e4ae811471852,6a0a1c85d70e4add894b7f3d796b91eb,0,1,1,0,2
5352,7728fe1c42db4d50a46a8af5262364f5,2016-08-16 23:45:48 UTC+0000,a82d7dad4c2e42b588276c14a2b119f8,c514f221a164413badf98c157cd5c627,1,1,1,1,3
7036,773018dd24c44588bb12481325a62b59,2016-06-26 00:18:49 UTC+0000,79494271f2624da4a46bcc3acad0d92c,36ff3b3666df400f956f8335cf53e09e,0,1,1,0,2
3448,77315cca751c49568c57250fc7401cbb,2015-10-23 19:47:32 UTC+0000,9c7d8a6b95db43aeb22231f40ff964aa,369f1c8646b649f6997eae7809696bd5,0,1,1,0,2
6318,7732308165a64bb9843634c6699b2237,2016-10-31 13:45:58 UTC+0000,3fe90a4223874f8ab8c6b0262d470ad6,e4874ee17afb4237ac242f7d4acd7765,1,1,1,1,3
1879,773295f23e1c45b7813aef03b84d1862,2015-10-16 14:38:20 UTC+0000,17b103840ece43b09a1ac28867b2d4eb,a1006e6a58a0447592e2435caa230f78,0,1,1,0,2
2419,773beff979fb4a079dae343766eccb6c,2016-06-25 23:21:56 UTC+0000,562dcca0fd1744ab969fe00ee9a8a2d5,4dc7d9040592416f98c0bef1ad2c31f5,0,1,1,0,2
4710,774204587036455293681c7eab329aea,2014-03-28 15:07:30 UTC+0000,94054a50290143cb80d5aa4c25190ee0,c39f90cc551648c48b757c81975d82af,1,1,1,1,3
4335,774687d3065a4c59bad5eaa28c606fdd,2014-04-16 08:02:57 UTC+0000,c340e8eeec4643f583e8b396e1ee1924,fe4543418c0846e5a65fa22b4ad9a304,1,1,1,1,3
981,776ce499b5374d0994e430ba2b0cdc5a,2016-05-18 16:06:20 UTC+0000,7a0a5ec1088d48fea7355bf4db4475a6,e3605142dffb4d87a0f8b950da727f73,0,1,1,0,2
2366,7788dd4ec27743b1b97b7d5b9333b9d3,2015-05-08 13:02:55 UTC+0000,ca1cb994ccf44a87aac404039a75d874,369f1c8646b649f6997eae7809696bd5,0,2,1,0,3
605,7796056773e44f84b76e071b3587f041,2016-05-26 08:35:50 UTC+0000,70a4b7adcf07486ba6f61dd79e10081b,deef0c58c565413a994f7376312b974a,1,1,1,1,3
6510,779e62d3492d4de6b0c893a9c5dd7575,2016-05-08 19:06:36 UTC+0000,5ecb86db93f34b4e8c24571dc95523ff,58fa5e95fe9e480a9349bbb1d7faaddb,0,1,1,0,2
6672,77cab652738b4e2bbc5e739d6625ec03,2016-03-25 23:18:28 UTC+0000,2528c2c168bc45b1af9401ad54c0cf99,fafeba89ca764bd891862fb8440a2962,1,1,1,1,3
7702,77ccb0cde0d046a5a72caa252df2a6e0,2016-05-25 15:23:34 UTC+0000,bee2c3afe9ef4f72b464587a24aedbb0,a6f1102a68d44675bbf20835e288915a,0,1,1,0,2
775,77d37d4a3900497aafdde570b4ea93c1,2016-07-14 21:13:01 UTC+0000,a539a237388243b4bb0a1c18c7e81fba,7fe2d60a2a5a4914b228af891170f653,1,1,1,1,3
740,77da900b2f214c5494ca3965c9fef0e3,2016-03-03 15:49:55 UTC+0000,7b83f33834b849778d3c66bd28d6b7d7,a1006e6a58a0447592e2435caa230f78,0,1,1,0,2
3580,77deed405b954aaca8da8b72728c6cbf,2017-03-14 03:12:48 UTC+0000,3b1897c5d6344d25a9f61e0190fb0e24,ac83901fad384461ad33630aa2d823d7,2,1,1,1,3
6295,77ebaab645be4d71a7f59dca35451f15,2016-05-11 21:40:40 UTC+0000,f32f6b5f3d9847a2a7c16999cc495b53,13b55ed4834e4814bb33a4c87001063d,2,4,1,1,6
7067,77f3e8d41dd74806a2b42840ebf2cc87,2016-10-25 01:16:20 UTC+0000,1da7df07661740e8a74cdd3a50b1d5e3,d65841158cf14e62bb26f7dcbc218a30,1,2,1,1,4
7826,77f47ed31ff54b4f97b03e05d4b81693,2016-09-23 18:00:52 UTC+0000,08c0f30993e0457eb2516c4ae8dbb9f4,58fa5e95fe9e480a9349bbb1d7faaddb,0,4,1,0,5
3133,78058fe21b3346869dea23ae7d5b99d9,2016-04-29 11:06:20 UTC+0000,2c3f813de5174afbb3a86681c9a61f16,90275e799320405bbd2521b88a580ee9,1,2,1,1,4
5989,7809845790a24be4a58f85c550ae70f1,2016-12-06 16:16:22 UTC+0000,3627e80a32674d3c8167af7ae30c46d8,8cdeec41de5d4893925deb57220a6d2a,1,1,1,1,3
7062,782eb1e8995a46bfba7ef5b6c03d7b49,2016-06-19 23:53:36 UTC+0000,249339cc2cc54bdd95c4ca3f756c6855,58fa5e95fe9e480a9349bbb1d7faaddb,1,2,1,1,4
6351,7833a81e6d1a4d1881af629bc3723d64,2012-09-09 12:42:19 UTC+0000,b33a45898a434e88a7436f0cc4aeabc0,b1776598991649088c0a00a6e0a2c766,2,8,1,1,10
4730,7833db2e7b484c6eb7b65417eafc5d49,2016-02-15 06:16:58 UTC+0000,7b1642f9f29244eb8ac858c55ccc4750,c6c20011ea42416481279087a847750b,0,1,1,0,2
3391,7839032a2eab4f68a7f6941d3571576a,2016-04-08 20:42:58 UTC+0000,938b946012414c439f722e90b2ff6c52,97b06576926641838472728d198cefea,0,1,1,0,2
578,78404726a99947998e51fbfc057713b5,2012-03-31 15:08:39 UTC+0000,3fef2754c9004a258823db50a333409b,5309d294514e4064a27469e4f84f58e4,0,1,1,0,2
6421,785847e02f0e4ed4a38c198673feaec3,2014-04-30 01:45:49 UTC+0000,f0ba4502718146fcab37fddec75b3a1c,c1bda2764ee642b3859b1ca6839fa16c,2,3,1,1,5
7782,786072ecf5924651a277059c2e027013,2015-08-13 12:36:37 UTC+0000,30cef7ffdc56462c82541120c7d3c72e,d1f04208de3643c088f4a25e57f1cb2d,2,1,1,1,3
6327,7863f56047de4cbc8049840516feb3ea,2016-10-24 03:55:35 UTC+0000,3635adb6905140b5b27e5acdfc0623fe,752b7fa8c0924273b1c87c4950b52f10,2,1,1,1,3
4529,786c5bb15fc64ed296009133421956bf,2012-09-15 04:47:34 UTC+0000,f643448b6334415697696da3af21307e,05444a2f42454327b2ac4b463c0adbe0,1,1,1,1,3
2920,7871724a850b4a88aee53c8657a7075a,2018-06-07 19:44:56 UTC+0000,d93e0ba3cb22428dab67263c47070fca,a9c8d4fd474048f083703b6811710684,1,1,1,1,3
7308,7872641db02e4e52bc1658d7a5dd940a,2016-03-01 14:05:41 UTC+0000,af19bdbd80f9419c9657b562adc3d1ab,a1006e6a58a0447592e2435caa230f78,0,1,1,0,2
4274,78739f3c0598455db7e1e6306d853bd6,2018-02-14 17:53:32 UTC+0000,a323ecafa2834cf88297e86de4663115,42deada7c50c4859a34615d70193317e,1,1,1,1,3
53,7886ce513f104d4888e53ce909636a84,2011-12-30 04:02:20 UTC+0000,e392fd43c3d04b65be45b1be2441834e,01b3e033848b41f6b7a55cefc59ba61a,9,5,1,1,7
5533,788859e770944ac29d73368ef189b08f,2016-12-28 19:50:20 UTC+0000,41a0959b1a2c475384b179addf4e3b2b,94d3103877654dcda44b8b494a4162a3,1,1,1,1,3
402,7889f36681ed438787db9b7fbee17407,2013-10-01 17:01:18 UTC+0000,7385a0a3c7d2411e8ef4c81951b7008c,986a00b486d9421c872bb527f015cf42,4,3,1,1,5
4003,78b144362d134fe0851af9801108e01b,2016-05-04 14:45:11 UTC+0000,679002ad758b4f2c8e31d81292a91114,96bbbdd06a334805a0501034d9df1aa4,0,1,1,0,2
923,78c2e387716a4064ba50af4033d47332,2016-04-28 16:24:10 UTC+0000,3844040db8b74f1fb9efa4c685f700b6,e963b61ee35c47c49551d0b3eee97782,1,1,1,1,3
5159,78c9605e52d54999b33cffe4a7e1afca,2018-02-15 21:48:11 UTC+0000,42cc6afbd45142b6aa6b40bcc9d792c5,7e721be7613246dd9f1aee1fb31271b2,1,2,1,1,4
4363,78d53149dee84b3eba7396b7fc3d8a4d,2014-03-30 19:15:54 UTC+0000,ca13f364b36741e9b4d21138d881060f,031c50365c1145c3a435627a74732fe1,3,4,1,1,6
2284,78e598d677884612bdfde6e15a6ad849,2018-09-17 12:26:28 UTC+0000,2c6580ebdbcf436d93bf9407683057fb,36ff3b3666df400f956f8335cf53e09e,0,1,1,0,2
2389,78ecf2ed2f3c4d8186caa11d17cf786c,2015-11-25 05:49:09 UTC+0000,4bfeb355a3c14850a2ff018ea5412d1b,615cdd5c43864c17b832ad5378ba4641,5,3,1,1,5
385,78eec1dcdf66442ab5bf96c8e2a049b2,2016-05-16 17:12:16 UTC+0000,adfd2ea858ba4653861946915d826bf9,1cce71b5eeff4656b9fe371118557f1e,2,1,1,1,3
3689,78fe02ded48b41a6a0e230a2bc06935b,2013-12-05 21:50:22 UTC+0000,bbba1c5433c64d23a4d3895095843d1c,3610651286574769b899efd7204265f9,1,1,1,1,3
3613,790293b5a13a4d41b70dbfa323a58e63,2015-05-04 13:17:59 UTC+0000,f41ecd5ad57c4745992eae2c2c807fdd,369f1c8646b649f6997eae7809696bd5,1,1,1,1,3
5280,791622347c694d309c48d1ce8d928ac3,2016-05-14 04:02:31 UTC+0000,7d96981e8bfa4639bc43593a108e9156,58fa5e95fe9e480a9349bbb1d7faaddb,1,2,1,1,4
2323,7921d27d2444483aabb3061380d7fdf4,2016-05-27 20:45:23 UTC+0000,6f049b54098542cbb50305745a9da63a,12e8dea2f3534f6dbc31701cf64f9a4f,1,1,1,1,3
7762,793fc49bf0894b3eb7115b661ff6b866,2015-03-17 17:05:01 UTC+0000,f2c4cc202d2e48e58c5c6682e5e502de,a16b38259e324ca69dbe01e23376a395,1,2,1,1,4
7591,7944a06352f64a6ab6ea0e185ac8eef4,2016-02-23 03:56:42 UTC+0000,60090fb7add64a35b475365834e0a6a0,96bbbdd06a334805a0501034d9df1aa4,1,1,1,1,3
940,794dc30bd27d4606ad06891633b37704,2018-07-14 02:05:07 UTC+0000,fe51a2b722f4492aac56ba434ccd9377,e06eced9a3ca420da404f75caa2d1ad8,1,1,1,1,3
4695,795db4db003f4aa8b38e32f17f495c00,2013-04-15 18:15:28 UTC+0000,266dccfed0e44a91b84f3e8736757a5e,ff9b24dcebc744bebc50f2472502efb9,4,1,1,1,3
3098,795fe5926f1c40cf95917ec2f4ed7266,2014-03-26 19:42:55 UTC+0000,7d735422662d422fbe5d1fb49a18cf8c,c9d16317cc454afaa2833bdd14e0e67b,2,1,1,1,3
6720,79630fa5e5f049ebb4c25fd7a05f533f,2018-02-23 21:15:12 UTC+0000,cccc0d8aceca4d29ac442666d770b933,a6d33c38902546849c36ea7e9e9f0870,1,2,1,1,4
4928,7968ee578931470fbdcf46fb4f106332,2016-04-24 00:10:22 UTC+0000,e8d47188739845bf81889e9d6e2b99cc,58fa5e95fe9e480a9349bbb1d7faaddb,2,5,1,1,7
3823,796eb2c9973f4684b594e3e35d737d9e,2016-10-25 01:25:54 UTC+0000,b358044ec16e47ef86ac9dbd9992892c,88f5d05dfc014444ba4b0617483eb4b0,0,1,1,0,2
6571,7975647c4ffa4e0cb59f4c040ee2d6df,2016-04-28 23:14:00 UTC+0000,7ef2f8891d4b409d83ef47c46fd07501,10005df177a444198e4a6052d8ac7502,2,1,1,1,3
6914,797a0e34fcd44ca78ff8fa11647b7194,2017-11-27 01:42:14 UTC+0000,cfd3a7e182554867a49f2940f86526db,8b30413febb749f582781486ea22f40b,0,1,1,0,2
4586,7988e28309604867b2e7551686ba50fc,2014-04-09 04:39:50 UTC+0000,186fd32612384efbb9f60c12a926e1f7,6774ee9e8f9247728dbbe896726e911a,0,1,1,0,2
3093,79a2371dd97c4c029a27d356676e120d,2018-05-16 11:45:01 UTC+0000,ac5e0db99392435ebda0592a13534318,be5d23056fcb4f1287c823beec5291e1,1,1,1,1,3
2853,79a7f73c25d8495195e8900587a61513,2016-11-10 00:15:42 UTC+0000,0f0b65f383c04c058510c990b29047dd,77fbf1608de84052bca5b42a28360a72,0,1,1,0,2
6,79acffec2c84405984d059f27079f7fd,2018-03-13 03:15:06 UTC+0000,db560eaf375c48df9afd35b36e7058a7,be5d23056fcb4f1287c823beec5291e1,1,2,1,1,4
2444,79c7eba3513744069971306e08643e89,2018-05-31 22:00:06 UTC+0000,c1ec94d5820248f5b8c6fce3beac6359,05ab77d4c6a141b999044ebbf5415b0d,1,1,1,1,3
4594,79d9e834106b4c00840f0692ef623b14,2016-05-19 20:27:55 UTC+0000,c8fb8065da4b495fb0604299b1c0afb0,25f5e94c4cb14e569aeff7cb2c98222f,1,1,1,1,3
1472,79db1f06f09e48f082a059bad0e562f5,2018-09-21 00:14:43 UTC+0000,c0f7fa63e2984ba39aae8ead727409bc,36ff3b3666df400f956f8335cf53e09e,0,1,1,0,2
5290,79dc2f2a1a464f75b3aac74a6b2d800a,2017-03-20 02:05:43 UTC+0000,e72f4154aa2c4a469563d4703b66f42e,6624dab5dbd441b3b2bd61dec51a09f3,2,1,1,1,3
4951,79df0e11ac7949479f2c8249158a7cfc,2016-05-03 00:07:13 UTC+0000,6c2431fe75bf4c44b09c690ac80a4dda,07b56b87a4774d758abfb9d64e57a4c6,2,1,1,1,3
1397,79df4fda0d004a8283cfdf58977d38e3,2015-05-19 17:08:55 UTC+0000,1d8910ff81a346a597424544e6200fb5,b403493d43fe434c98ee997ab23de7f3,0,1,1,0,2
1765,79f70d58f71b44fc81d6c7e09861e689,2015-10-25 00:47:36 UTC+0000,4c782f040a9546948830f924ffbfdf5f,1731d1ea92604b7ebc5fbf15a221cabb,0,2,1,0,3
126,79f89431640a43f09a268a9ed5aaa48c,2016-03-10 01:02:05 UTC+0000,ca4fc80827bf47979b7e9d2e73b9a014,c3b4e11154f74a858779be7ba9b6f00c,3,6,1,1,8
4844,79fc8d5805634cf8a632ba8413d4848c,2015-02-26 18:55:00 UTC+0000,d231cba3b5b14bffbb733e1f4a9acef7,a1006e6a58a0447592e2435caa230f78,0,1,1,0,2
5117,7a079e84e1b44a23a0461bafe7453445,2017-01-30 16:03:26 UTC+0000,db9933b6e3d94b939c09798305580831,6dd29d5757d343eba6eae82e719835ee,1,1,1,1,3
1095,7a08be6263824196b60029e800e0cbb4,2015-11-02 20:14:33 UTC+0000,5fd0e7a81a4443f8aa3f5d6aa0393509,a0243e7c750e4c878fd47fe9cfb56f6f,0,1,1,0,2
7053,7a0e89faabec4171a85fa6914e2ac932,2016-09-09 13:56:49 UTC+0000,b02d38797b4743a9b65cb6e706dfc9b1,f221bf19f433493b8666e093c2365e54,2,1,1,1,3
1193,7a168db453d94a0a9b79e2d5550a9568,2017-01-04 00:11:59 UTC+0000,9422ff72b150420cb3f72ef7c9e32443,36ff3b3666df400f956f8335cf53e09e,1,2,1,1,4
5859,7a18cb437ad448c7a92970959e3220f5,2016-08-29 18:53:34 UTC+0000,cb71e2b61ac249d4a3fb13a0ad916ec2,36ff3b3666df400f956f8335cf53e09e,1,2,1,1,4
3405,7a2407eaca7343bd809833894611cbe3,2018-12-05 18:14:16 UTC+0000,e1fd89b63c964760ad2c2f924d1c9f8d,9c624c0ee41240c69a40ccfdd0e4f63a,1,1,1,1,3
4883,7a2e3de187f944a28f6015deeb1f7c2d,2018-03-01 16:08:56 UTC+0000,201899863b85404d8cd7ce84eaa59f05,5a131e4400d244da9f97309bef0915ae,1,1,1,1,3
4646,7a4b4046f92d4b7dae555562ab650111,2017-02-22 01:53:58 UTC+0000,7680918c66e748329179f6dd301dd55f,a1006e6a58a0447592e2435caa230f78,0,1,1,0,2
2169,7a5663b382724f2a95a62668d1597d71,2016-09-20 07:00:46 UTC+0000,ebdda39663034408822d960ed962e840,9d3ad4a464a64e99925341d617ce647c,1,1,1,1,3
3598,7a74661f62164ab1b45eedc2bf703dcd,2012-01-23 04:51:58 UTC+0000,c61d10eb935e446caabda80bd05efdf7,68ecc66323b8418092fdd724aaf5be94,6,1,1,1,3
6124,7a7de2dc37914999b804b73a7b369042,2016-05-30 17:10:17 UTC+0000,9fadf8d311af4f208562ec5ab0fe6fb5,36ff3b3666df400f956f8335cf53e09e,1,2,1,1,4
5007,7a8ddb5bece040609f6db52bd079bb25,2016-05-13 11:26:33 UTC+0000,8bc99f8fb51d4b2798a85b5c4de8b73e,7919ea19db274c1fb862f3456cd25ac5,1,1,1,1,3
6874,7a94d565ef27422ebaf25efa4c351b80,2016-05-13 18:40:31 UTC+0000,2c0d5985a1b5475b806fa66a5c7a6890,0ad08aa2336c47c2b86c033a38550cc3,1,1,1,1,3
6799,7a9d52c5db214bfa93fc8973d3b833c6,2016-11-09 02:06:40 UTC+0000,19468d32aee44fc8af9b9ae41b77f86b,33b218e4d86b49178043907b5e8d4b60,1,1,1,1,3
6943,7aa137ad02e14863b26ac562ef25d5c7,2015-02-27 00:00:22 UTC+0000,b1462f53d29c478781be60a28f3bc21d,04b72521eb474b8bb79f7bd95e8b637a,3,1,1,1,3
2412,7aaac0d039d9436896958474799c0792,2016-05-13 18:15:34 UTC+0000,66395f3a554e4cec9c79ab3ddd377be7,3ddfcacb3aec499fad320c2a46651c0a,0,1,1,0,2
5952,7aab5c52021a493cba2ddbf2a5c112cd,2016-05-13 16:34:32 UTC+0000,5b60837060644d43883eca0568c26472,6d15a722012441489d7ddf6c8ad9dbc1,0,1,1,0,2
2347,7abae774f9334095b33b16617fb2bafe,2018-04-20 03:38:57 UTC+0000,d3cbe981a1f74c96aa100ee49f26426a,8b81055e41274e099e6bbc4f20d20703,0,1,1,0,2
7619,7ad6fe1769d14bfc8aba41743dcd4408,2014-02-21 21:41:20 UTC+0000,2207dd8498624a54a4292ea79f2de546,a29675ae05a04c6dae90eddeb9b5a845,6,3,1,1,5
2211,7ae50a86bd1749fbb8ffe3675c7101b3,2016-03-03 14:58:49 UTC+0000,24f9c7d626cb4ad09773e13378dc8af0,67dda43361744abf9b9c0ddfe47c3f8a,1,1,1,1,3
6850,7ae7e8ac1cd84bd69f397022a10628d1,2015-10-22 21:26:56 UTC+0000,5a545cd0d1b9420d827f335a0da49c47,36ff3b3666df400f956f8335cf53e09e,0,3,1,0,4
2877,7af629698427481ba8ba2b9d39000aa9,2018-02-06 00:16:57 UTC+0000,ce3913db358542ed9ff37c326adf9f36,cc834e591bbe41b49e426190a58643e9,1,1,1,1,3
4638,7af76d466ce946c3b8ffd37aa610a06b,2017-03-29 06:05:05 UTC+0000,26ec02bbed2e47eca29fd2b551ef8d8f,7c70cf276b444d7ea40d37aea39289b6,1,1,1,1,3
2836,7b048e59d8ad41b28754e0733c7b0916,2016-06-26 03:46:57 UTC+0000,d4217125691d49f68f00d52a3febc5e6,30b1ef88592643dba57c33e4626684c8,2,2,1,1,4
1183,7b13b7ff476148b4aa7281b3fa8466c7,2016-02-26 20:25:27 UTC+0000,919e34fd955541d0949652b0a6ec6ca0,aa27976302f04c74a36ac18825e490c5,1,1,1,1,3
1802,7b24e64ec80440fe893ba38a66c4b0ea,2015-01-02 23:57:51 UTC+0000,f76981d6ade14afaa8a5066d890a1872,93acc65fba694fb5a4a9e590dcd81c68,2,4,0,1,5
5932,7b25b41dc6b9405d8f433156d4500d2f,2016-05-22 18:21:12 UTC+0000,08a1c4286eec4e7d82dcd3d84d01870b,da256714ec984a42a37a3549947461f5,1,4,1,1,6
3742,7b4415e798ea419fa5549203b0e6c4cf,2016-05-12 17:13:36 UTC+0000,eac28c7a1abf439abdba8a1c98caf90e,e08c6ad14ba24315afc5985dedc71be5,1,1,1,1,3
5295,7b5024bbb827495680ab3194788bfd4e,2016-10-05 22:43:16 UTC+0000,1b81e64d9bd3474f9382647f4299c961,a1006e6a58a0447592e2435caa230f78,1,1,1,1,3
432,7b5fe0c079ec4ba5bd748c9b8d71b47b,2017-02-17 19:09:08 UTC+0000,3ee93cb854c1408a9613995a73b3b602,03cf1fd186ce43229b93f29557216762,0,1,1,0,2
4437,7b66245caf1e4a30ab7108760378f0e8,2014-04-10 03:35:31 UTC+0000,7d4efcdefbb74bffa5964b3f1fee4ce0,6774ee9e8f9247728dbbe896726e911a,2,3,1,1,5
4680,7b686de628c345d0b85d59f231c31e3b,2019-01-29 08:13:32 UTC+0000,7ebb0e5e9b544c1eb0c96ffad1d73dfd,c1297398b70744f9a1a4ba200af28ebe,1,2,1,1,4
5953,7b82d2500f8649ddacb3de385a113560,2015-10-28 19:34:44 UTC+0000,8d8c45c2ee35481b85aebbf39faf55bf,36ff3b3666df400f956f8335cf53e09e,0,3,1,0,4
5140,7b9655ab3e6c4c1aa2cb83bd173f86af,2014-03-27 22:54:14 UTC+0000,bd49391c41b042ca86abbd4a1fb17c15,031c50365c1145c3a435627a74732fe1,1,1,1,1,3
7269,7ba68b0c87994845b90c8dab928a88c5,2016-08-16 20:40:01 UTC+0000,1694c193b07c4f839af680b2a76f3768,dbfc21fbff414832beed41c7a5966096,0,1,1,0,2
5548,7bb19456e1ce446baee31ef23e1da3c8,2016-05-16 05:38:31 UTC+0000,2704a64cac02481db59b9c4fbc8aea5e,c65d7dc685a34a39876da7e45b0a027a,0,1,1,0,2
1076,7be7218a3c564ccba7bf7417f78106e6,2018-02-19 22:41:32 UTC+0000,68fc4d296ac14c9b86b829c51f2278ff,36ff3b3666df400f956f8335cf53e09e,1,1,1,1,3
1962,7be989a647df443fbf406f2495709512,2013-04-11 00:04:08 UTC+0000,0c67f67480d24e6cbaf3a2696366fab9,dece48aff8e84131921b63ebbae64de7,4,4,1,1,6
7845,7bea614844814529bb5336eb4961c049,2013-04-12 00:51:17 UTC+0000,163d3f7cae174898823c47845d052dbb,f05b33a454c048f3bbc73f5f3f7f5127,1,1,1,1,3
611,7bef95f6ad7c4c5e852aeb7b272cdfc9,2015-05-28 21:41:56 UTC+0000,d35c1e2dd1914f7e9f66b9de2d3f7f77,a1006e6a58a0447592e2435caa230f78,1,1,1,1,3
6736,7bf76cb4a7344a1ba0619d46558dc9f5,2014-03-24 19:37:08 UTC+0000,30cf62d9ad144bdbbb017efc246c3888,5f4c8c5868cd442e8e0bc218b9a10e03,1,2,1,1,4
334,7bfd508f591d4d48a4da6fd1e2e18859,2012-05-24 04:31:49 UTC+0000,2d79e5b22b774ea989375155659df500,9c5803ae43ca4cf6b27ea85871625116,2,1,1,1,3
4013,7bfe28009ced442090b95ddb456071c0,2017-06-06 14:01:09 UTC+0000,8da6376092ff490697fbc68f63021a4a,c1bda2764ee642b3859b1ca6839fa16c,3,1,1,1,3
3333,7bff229b53ec49599c6a377ddffb0430,2014-03-27 22:37:25 UTC+0000,451d90e2367b49519588a4322e0ce749,6476f8ea22a5474581fff0a080c57342,2,1,1,1,3
1699,7c097978080b4df3a4ab4277e6ca9946,2017-01-24 00:01:43 UTC+0000,5a49d35563744d6fac734d8d265298dd,b74860355dcb4cd7a24efc7e16427589,0,1,1,0,2
215,7c0a31291d4b40838ac1b1d3ca13b27d,2012-01-10 04:53:05 UTC+0000,4c15563eb39a4c2c8ba09daf870ba212,392a273cb57b42389ec01a8fcdaff3af,3,1,1,1,3
5299,7c114f9167f2445b9da81871c6f582b5,2018-02-28 16:16:01 UTC+0000,896412fcb8a64d21b0a33af68a1e58b9,0182076c27374f37be2d36648c8cade0,1,1,1,1,3
1370,7c65a45c49b94d5bbc0fe701f734ab17,2016-08-17 18:48:02 UTC+0000,6e05e018901643a19208589e624a685a,3cbf8444be93437abb2986b7a903303c,0,1,1,0,2
7562,7c92816ea6434881a1a5ac5160141e69,2018-03-07 15:12:39 UTC+0000,827148e064e74b4ca740df1b4a1e48fc,eeb8555e29c840598cc378ceef7859e3,2,1,1,1,3
3227,7c932c42238b40f4ae656f5f00c3a510,2012-10-11 19:23:58 UTC+0000,b8c30745a99f41eeab5881d72d4e2ca0,8442ddfd38bc422fb4677785db0630e6,1,1,1,1,3
2902,7ca4a2c6224443c0b25ec3712cf178d5,2014-04-04 20:44:19 UTC+0000,effbef74c9454033b42414a948dc4639,6774ee9e8f9247728dbbe896726e911a,7,11,0,1,12
5010,7cb4f0dc02984d8a84c078e711482319,2016-05-09 15:16:32 UTC+0000,3c45eecef0cd472da25d4e836a9bde02,ed29d7ba2f4d469ebc04b038e724e784,2,1,1,1,3
1205,7cd2c0584262423bbb8ba24510d94901,2016-01-18 15:37:56 UTC+0000,3cd9a83ab5114c7d8156c1d42d8176e2,a1006e6a58a0447592e2435caa230f78,0,1,1,0,2
7777,7cdba6f746ee416ca0ccdf7caaecb360,2016-05-03 14:07:42 UTC+0000,ed575a57ab494f4c881c03ce62f3531d,6fe279bb21fc48988528078214b0a8c7,0,3,1,0,4
2727,7ce73236016e441aab1f16a939a43446,2017-11-17 20:43:46 UTC+0000,cdf66df033a94067a839a96944a57252,c0d1470427bd4684a5fb21f793c21b73,0,1,1,0,2
1333,7cf80a0c8b844bbc9d2a101443d08b25,2015-04-16 15:24:56 UTC+0000,d032cff8d4554b39bab373a7b5ff8eb3,369f1c8646b649f6997eae7809696bd5,0,3,1,0,4
6375,7d0532009a254dd5a55b8280acb1b80b,2016-09-16 00:46:09 UTC+0000,6d1bf2bd56b7459e8b827a8a5476a9ae,75a5710369f54bb295035daf3b64d3dd,2,1,1,1,3
2584,7d0a4fdea47743c58cdf67e0c18797bd,2017-04-20 17:35:09 UTC+0000,a5b1d8187eb5430284b5ff1f39b4ffeb,64e014ccc7234f3fa9558dd9969e11d4,5,1,1,1,3
4608,7d165ac466fa4cad9ac30f4182fa49db,2017-01-31 04:07:48 UTC+0000,abe971c0fa7b41ada785477f3038eb77,12e8dea2f3534f6dbc31701cf64f9a4f,0,1,1,0,2
4112,7d22d64a0aaa423e93561e276caf4c3b,2016-05-06 03:52:51 UTC+0000,b6710d726381487eb42d4d242bba4967,58fa5e95fe9e480a9349bbb1d7faaddb,0,2,1,0,3
5964,7d2598509b804903bf46abfc231fa66a,2016-05-10 18:44:29 UTC+0000,094216c5c8af424db0edbb20700944f8,3e03883293e94a8782beb98e18f37d2d,0,1,1,0,2
1487,7d618450efef4c9e92fa8cea5de45d97,2017-01-23 23:17:01 UTC+0000,21da2ee6050b458f99442cb269445f35,7b65444486d94628967a24e76ff9c0d2,2,1,1,1,3
3527,7d6bd754327c45689e6f16093c385450,2018-04-12 19:06:17 UTC+0000,aa858f20d846490fb73d7d4584895bdd,209fcd55fefa4fe29ccedcdc26bd5d89,0,1,1,0,2
5260,7d7c2afdb4714ebab92697c1c994d9cb,2015-11-06 18:55:38 UTC+0000,a0eb67e324284e3f99008b82102abc43,a1006e6a58a0447592e2435caa230f78,2,2,1,1,4
6352,7d8357bc422f4525b4491724e29d22ba,2016-07-29 21:24:06 UTC+0000,e519ad0676174ae1a7b3e0b7a5653619,e62d02a4688845f08c340fa39b4382cc,0,1,1,0,2
4569,7d893e36b6c64ad7a467ca10c6efee69,2018-05-06 16:01:52 UTC+0000,f9484076055842de8ac578e416fc83ef,be5d23056fcb4f1287c823beec5291e1,1,1,1,1,3
1226,7d8c3947fb6e45d4acc49438ce194622,2017-01-24 02:30:57 UTC+0000,2d78237de6e9478896088f51a22a84d4,665a4dc589d94329b7a752ad551830ba,1,1,1,1,3
3645,7d972ef28b2343cfad333f2028c67df4,2016-05-12 02:21:05 UTC+0000,55e8fe3d075f4875b76b055dde91adca,2706ab56034d4ead87747b981d4aa741,0,1,1,0,2
4499,7d9ac8d2bcc140e4af58f3ad26b4477d,2017-09-01 22:10:52 UTC+0000,01bccb9ca2f6493997a39b7063337255,8872e658910a4a5988a8d7d8016a691d,3,1,1,1,3
1722,7dae92ae5607447baa8e5273a52d65b1,2015-04-06 14:24:20 UTC+0000,27687d2af360423394f2758701c0dd59,369f1c8646b649f6997eae7809696bd5,1,10,1,1,12
2053,7db83edfd3fc4af0bfdf104d2beb45b4,2018-03-13 22:53:13 UTC+0000,60a93ca023c34a158a2204d6c8283f38,720e334c824e48fa914ccdd60a8ed706,1,1,1,1,3
7824,7dba54f31d85416db2ec2505f7a89174,2015-04-23 11:15:51 UTC+0000,b086304fc5a74ab3b0d9d37c7cbed4c5,36eba0ea1dad4b7c88115fc70e587efa,0,2,1,0,3
6054,7dc1092171e94d80b541b66909a9ca02,2016-02-06 16:44:34 UTC+0000,4fcb9d4d9f4e4e32ad6c6d9485d36c9c,628ba982dfba43c0b6d692983cf5a3a8,1,2,1,1,4
7221,7dc629e658b843ffa0c1159dc88c664a,2016-03-30 16:20:06 UTC+0000,0226c35010064879a8035c1c61373851,369f1c8646b649f6997eae7809696bd5,0,3,1,0,4
6366,7dd3a7157d68461fb014822169c1860c,2017-02-21 16:33:23 UTC+0000,ef7e2d1315f045789b5b2786eb63efbd,bb4fe08bb5424f08972927d90bad9642,1,1,1,1,3
6434,7de4a436ef3a4d6396e5d6ff180535de,2014-08-23 05:12:57 UTC+0000,da43dd6208744a28a7be86a0b500740c,80b31cfb551749e7939c6790f5521b7d,1,2,1,1,4
8041,7df38c9ded4a4474bb4f9c1f659e1ad1,2015-01-26 21:11:31 UTC+0000,fb05e74dafc94f5ab2d9da627a882349,53939a491acb42a4815463845a638186,2,2,1,1,4
6614,7dfeb9ea00b44f6ba5ede0b4953c5cc0,2015-09-16 18:12:33 UTC+0000,dca42179604c48f8aa34b254b253132d,369f1c8646b649f6997eae7809696bd5,2,1,1,1,3
2843,7dfef2e977204580aac6aa7ceb2113b9,2016-05-21 04:19:19 UTC+0000,e575ed360f2d4985a6a38ea348272f5c,bc46e3699d92477ba8c7aa723e54a151,3,1,1,1,3
157,7e0e1f77175e42d4b215052709681f37,2016-05-17 18:28:17 UTC+0000,306e535154a142ee9f8823ae814fde41,7667c23d26ab409ca3e49758f5367925,1,1,1,1,3
7411,7e3e59c4513f4f24a6a83fc2519c858b,2015-09-07 01:47:44 UTC+0000,521ad566bb4d497cbd097888d3fec588,a1006e6a58a0447592e2435caa230f78,1,2,1,1,4
6711,7e51ed2b4d7e4a0d96e7b9e08d1a8a1f,2012-01-18 19:10:26 UTC+0000,3f742b92ff6748b58640337f7a008ac9,05444a2f42454327b2ac4b463c0adbe0,3,1,1,1,3
7296,7e573f57af554644badf0e8796158099,2015-04-28 20:23:47 UTC+0000,1413d50f9f2a4b4ba585af6c6b594321,bc46e3699d92477ba8c7aa723e54a151,1,1,1,1,3
1742,7e7daad04efe4834ac849ab657016fe2,2016-06-07 17:01:11 UTC+0000,374836e8c40e4ff281015fa1e5bc6ebe,de51e745b6354185a0ca5d02dc628416,1,1,1,1,3
865,7e8dac534a354671b8085dc915443bb6,2017-10-18 02:57:18 UTC+0000,9ab0ea2fc8534f25b77f0fc39948bcff,974093c2911e4700bc188272c7649c01,0,1,1,0,2
4671,7e97abb7cab84051bed1c6f0333390d6,2014-09-10 05:22:42 UTC+0000,687673fdd70d4df79777c71be00a96bb,6c45a5332ff44c09b6c3dfdf53d2bc56,1,1,1,1,3
6320,7e9c77b9385647e183bf0d5dc911a353,2015-10-12 17:54:26 UTC+0000,26d1618289d64c27b2b41f3a95ed0418,c3c345b8e5044054a0544296ac29cb88,1,1,1,1,3
4070,7eae560715394883a5e105008e225ae4,2018-01-02 00:15:36 UTC+0000,ad76d376813c44358355fd1f42c370e0,be5d23056fcb4f1287c823beec5291e1,1,1,1,1,3
4192,7eb245be8c824f05b11a20d2adb5e84a,2017-02-09 21:58:25 UTC+0000,29b77add6753426f9524a772450ebd2a,36ff3b3666df400f956f8335cf53e09e,1,2,1,1,4
7229,7ebc20d0050d443688a89dda1c764aa4,2015-10-25 00:51:39 UTC+0000,4ad1a31b097144e9b44d0fc7052d052c,1731d1ea92604b7ebc5fbf15a221cabb,0,2,1,0,3
525,7ec655df73814558aad27669a023f7e5,2018-01-12 14:23:07 UTC+0000,c0444fa5142747ccae4787114644374c,887c5a142b42466fb74740d72989fc74,1,1,1,1,3
6747,7ed270e0374941b68e916d68a9add481,2016-05-18 01:46:03 UTC+0000,a9ded9728d254054a00fc1c564ddcb1d,a38257a138904986827754f4b7c0821e,0,1,1,0,2
6730,7edd3f5979df4fa48fc58693ddc13d13,2014-12-16 23:01:33 UTC+0000,410b28072e86416b9bd02b58535f0901,655aa4d0ba9c4075b099331c88158ee2,1,2,1,1,4
7187,7edfb05279694afaa4248301834acc05,2018-04-23 03:49:43 UTC+0000,bea677c9c4a64c8396746be71869b387,8b30413febb749f582781486ea22f40b,1,1,1,1,3
1552,7ee11a0e82f84f5a92fafb1956673f32,2016-03-16 14:30:55 UTC+0000,d152abe9fa464c918093b619bb96123a,bb4fe08bb5424f08972927d90bad9642,0,1,1,0,2
2088,7ee35d8c420645368857256d371fc331,2014-05-13 23:25:57 UTC+0000,7a015e12e5474492be9c2873c42df0d1,18237fb03c8d4d368085a5dd67c5307e,2,1,1,1,3
390,7ee40ed9a8714a8e9dce8866f6faca6e,2017-09-01 00:37:09 UTC+0000,2c2839d6fb0b420598a1a907c68c08cd,e441a253d21541249a9d0c32d983c9eb,0,1,1,0,2
2556,7ee9055d23b149fc88925b0e387fd882,2018-01-13 17:56:34 UTC+0000,3eed712f9bd94c9a8b7672d68e5b64d9,48ec7b4620564234a3a3f6e4428f09c8,1,1,1,1,3
7874,7eeb8a4c0e6f4569913589b68c501344,2016-05-25 15:29:39 UTC+0000,c83a560d53ff40da97745d9d393bac3f,c746ad196b0343f69b5005f258110f4b,1,1,1,1,3
1714,7f00ff6f131243c880ced983e171a085,2012-09-09 06:51:03 UTC+0000,9a2997e6ddd94c8b9a2bc00044c434d0,977428d851b24183b223be0eb8619a8c,0,1,1,0,2
5281,7f05971e386b413aae64f6966dd82d27,2016-05-12 16:39:48 UTC+0000,70f6841899504c2f9f3a03ebcad370b4,e08c6ad14ba24315afc5985dedc71be5,1,1,1,1,3
234,7f0d2c1fb2534047bb10c3bc2e52f917,2016-09-18 12:24:11 UTC+0000,cca1ad316bc14ad9b9f87353cd682a67,6aaf70fd593b4f8f9299dc9c18c5f085,1,1,1,1,3
181,7f0e547ad0fa434da78285b5cde85281,2017-05-17 16:51:09 UTC+0000,bf93711036e54b9e9bab56858264a525,e92e9126dcae49d68c1e88f325464f83,0,1,1,0,2
3041,7f355596bd6e4bef8bd437d204e1546c,2016-03-10 03:36:30 UTC+0000,7378c69de8504cbca7f329abc5808334,19adde8973034043ab515842ecc0d038,0,1,1,0,2
3831,7f38d03fbb0745c3a526e4f82b3f674e,2016-05-19 19:33:29 UTC+0000,6b0949f8482f477fb988e0ed94f65440,1ce19b32e24445cf9fefcccc91ebd211,1,1,1,1,3
7331,7f49457c687b4f068585ecf79edeec87,2016-08-31 17:41:00 UTC+0000,109f1504e44a4432ba52509b4e9bccaa,e558151137504b15b92b1433257bcffe,0,1,1,0,2
2181,7f5dae447d634950a33647d069d45271,2016-04-29 20:14:44 UTC+0000,5c89003f37b64746ad6c9d529354f947,1b5c96befd054817a64d4b8d89c0cb38,1,4,1,1,6
7785,7f608faf5f1743db885ac4af6fbcb2a4,2014-03-17 18:32:06 UTC+0000,3bfecd38ad09466e8e8986182b5bd47f,3dbf68e5ac6f45549bba213fcd71c913,4,7,1,1,9
3559,7f69618dcfac42c59bf02ab6ca191be7,2018-01-24 21:26:11 UTC+0000,ce8e2dd84f9a48e6af39c23494749f95,d7f9afe721af42b1a03a993909e0568c,2,3,1,1,5
6562,7f70c35b72314252a4716d6ffa893dce,2017-03-31 00:24:21 UTC+0000,2068808d06474c4a91f7f6b0dcd02308,f9ac19bf19df43caa6a52e5392876452,1,2,1,1,4
6127,7f8ba11898f8400b950e1f7f6823ea6f,2015-10-07 17:00:53 UTC+0000,21add669a7c64b3998afa8ad4d2ba18b,dcc628d262024b6e8f16ed1765f1d227,0,1,1,0,2
4897,7f9ed2063112455facf8a209fdd060da,2016-05-10 02:44:49 UTC+0000,bc2f81eff66542bca02b8ec4c778658e,e6ae38ca62d5423daa34d7088f4295e4,0,1,1,0,2
3136,7fa5eb87437f45bbb57753f40752e273,2017-02-08 16:09:36 UTC+0000,791a165f699a4adaaaa54bf1016f6edf,36ff3b3666df400f956f8335cf53e09e,1,2,1,1,4
7325,7fda84dd784744b88ecdc0cb5da7bce4,2016-06-30 00:25:13 UTC+0000,5a8d0dd4d340431d8ccc9fefb08e660c,d0e69918e24a4931a6f012790700696b,1,1,1,1,3
5386,7fec255938364265b0ab98f0352184b6,2018-06-08 19:29:02 UTC+0000,60bee08c15434615baa6d739e137fb1a,26371b7df903444786398f43e7c262df,0,1,1,0,2
7203,7ff0be9cb3f64fcdb2ae7df5a98ce283,2014-04-29 20:31:03 UTC+0000,7497b701af154edf8929f554c184946b,05444a2f42454327b2ac4b463c0adbe0,2,5,1,1,7
1253,800bbcbecf754160bdebbfab19d9a001,2017-10-25 19:38:57 UTC+0000,2f369baa52b444f1b9d40eb35112e94f,d2db5801127b4e3399610833c3239e3b,1,2,1,1,4
3821,80112c865627418cbd6cecee7f75ccd6,2016-06-13 02:42:16 UTC+0000,a0d4de61111b4f8bb76a887ced4c3ee4,58fa5e95fe9e480a9349bbb1d7faaddb,4,4,1,1,6
743,8012ec8078f74eb69d91ed82309971b7,2015-06-02 17:14:58 UTC+0000,8be714da197246cf8454e464c750bda3,0dc4c381bda94701a967703ccec5c676,0,2,1,0,3
4613,8014d9ed78af4250acc7c0cc46e30d2b,2016-06-26 03:03:59 UTC+0000,7951797715c744a9944a5345de9e05d1,c39329e6c790449f812590c3b897aca8,3,3,1,1,5
1309,8018c636023246b3abaffa5c9a8b2779,2018-08-27 07:36:19 UTC+0000,775669041d294b36837a0a9695aad700,2f724f75638d49178f939844ef3b9e93,0,1,1,0,2
1230,80385e66e5af482a8743faeccc967916,2015-10-28 18:44:27 UTC+0000,727e6e241a994198ac19366a998d5fed,c3c345b8e5044054a0544296ac29cb88,0,1,1,0,2
790,803ddf4740054a7ea60d5315cc689985,2016-03-15 03:01:11 UTC+0000,af6cdf11c9d34b0bbc58256a48d04d6f,e6ae38ca62d5423daa34d7088f4295e4,1,1,1,1,3
5271,80415bcf711343d88844d037916db798,2014-04-29 23:49:19 UTC+0000,db966786ca924e4aa61c21b058ed964e,fe4543418c0846e5a65fa22b4ad9a304,1,1,1,1,3
1096,806918763e0c4c809912685b7f215f47,2016-07-10 23:13:40 UTC+0000,ee3058226a34428ba0846cf2c6a1dbdb,31582be0d99742029e3fcf85f8f83928,1,1,1,1,3
5116,8080c06a4d884885b72892ceb2a36bff,2016-03-01 19:57:33 UTC+0000,821a23add0664f97b94fbb266e8f3ee7,1272964da2504fe8a8a6400539cd8b1f,0,1,1,0,2
7973,808888ce9c1a47abb4b0b63e3d1efcb7,2017-12-13 00:56:42 UTC+0000,78ae76dba696430b9ccc6266f3865824,887c5a142b42466fb74740d72989fc74,1,1,1,1,3
5971,80aee1b0c36e4c8597b4cedba7c31005,2014-03-11 21:59:02 UTC+0000,7c9fee9c14da4c658014f34b2ca896a2,564ef581bed64addb3cf0ff0ab652ffd,3,9,1,1,11
4333,80b299a59bfc44e793b0cacf4d986443,2018-11-20 00:12:21 UTC+0000,949e6b832d2045d09501953ab8f44bf8,4dc61581ec7b409bbd037e483f53ba0a,2,1,1,1,3
1489,80e451a706d14fa7ab14080cc983caee,2014-03-10 21:26:04 UTC+0000,4652178d93524b4d93904c4e49325173,3dbf68e5ac6f45549bba213fcd71c913,5,3,1,1,5
7452,81379e3c64b946a792f9dfc7c79aaed1,2016-10-19 19:59:24 UTC+0000,f98c218d24bf4f85a5533b34cc97d9d6,36ff3b3666df400f956f8335cf53e09e,0,2,1,0,3
6270,81396481ae824cf5a8d6e1bbc97c39c1,2018-01-16 12:50:38 UTC+0000,9e3eaa04c6bc47d9a82be787f9b1d9ad,be5d23056fcb4f1287c823beec5291e1,0,1,1,0,2
3494,8149382ba4b9488ab17876353bf16f52,2016-05-11 15:52:14 UTC+0000,99861f92538749c08ca13d90553a85c8,a11a04feda014b9485d042e321ec17aa,1,2,1,1,4
2241,814b8dd4cf4d49708710af1039496fb8,2017-12-18 02:25:24 UTC+0000,e514ee502af741fd91db3ef2c82d5101,bac93e59ef3841508a9e1543a76f1d70,1,4,1,1,6
1675,814c1e4562ab408a8769f1a64a8351f1,2016-04-16 14:04:26 UTC+0000,8e7c7790a598457facaa5e260dafa6b0,be5d23056fcb4f1287c823beec5291e1,0,1,1,0,2
705,814fdf7e112c422d99a1d022939dfd94,2018-09-09 17:48:51 UTC+0000,9ba5a2db1174460693b2d78e764b27fa,36ff3b3666df400f956f8335cf53e09e,0,1,1,0,2
7316,81553eb3c6224f5a8ca4ea777a4ed018,2016-05-22 21:12:19 UTC+0000,1fe9c4d0cfd546af9c8ae9412132984c,8cdeec41de5d4893925deb57220a6d2a,0,1,1,0,2
435,816507626dbe4f508320296a0a561283,2014-04-07 21:28:21 UTC+0000,dbc0f028f94a4227ba7e6b98e644259e,fe4543418c0846e5a65fa22b4ad9a304,2,5,1,1,7
3802,8165d7905ebd40958b0af2bab977a099,2015-11-04 16:11:59 UTC+0000,e9d142bdb7984e32b44ac0d8ee790195,a1006e6a58a0447592e2435caa230f78,0,1,1,0,2
4916,8172b331f5a84a8d9b1ee30c6082676c,2018-04-04 16:50:35 UTC+0000,109d7c8c8fba4d168bb95904aa6e486a,84bad21569ab43a7aab8e5585c4dfdbe,1,1,1,1,3
5579,817f48caaa3349da8ead9c1e780c1c72,2016-10-26 04:53:57 UTC+0000,f7e7489e0e0c42d1a79e8937d3d80310,91ecb17a61764bdd966d2583237b161f,1,1,1,1,3
4258,818440525584482a8e52ca83fb0ac7d9,2018-10-02 15:48:46 UTC+0000,8590eca21f7043469cd3e1837b643a07,14a88acba0dd41019d745c9402cd1d4e,2,1,1,1,3
5474,818919fbd2db45d4b2d6828b83281279,2017-01-30 22:11:37 UTC+0000,1ae72098cd3447f88a1960fdf5523984,036358eed7044c66a6058d1006fedbad,0,1,1,0,2
4861,818a37c2724e4eed927db2b957b38b46,2017-02-25 13:34:40 UTC+0000,dfb375ae81b0464ea0440bfb244029ec,a72bde6ac9e349d195a6d356444c9578,1,1,1,1,3
7974,819260bddab6421e99784a9ecba09a54,2014-04-22 23:00:34 UTC+0000,85edaf1e34cf4c23ae6f8fee3aaa5f3f,fe4543418c0846e5a65fa22b4ad9a304,3,6,1,1,8
5300,8193a02df25d464f94fdd8fcc4823d03,2016-05-18 18:02:18 UTC+0000,cda267855f1a4a4ca45574fdac52c9f2,a14d2d2cc61d4275a722eeb7204cda90,1,1,1,1,3
404,8195ece9bd3b45ce93a607b7dc820131,2016-05-17 15:06:27 UTC+0000,8d8ac26e59cb46b9a587f91a77b58da8,393da108c1814afca98503ebaee2c99f,0,1,1,0,2
1383,81aea9829e584472998d4fd196ef78b5,2017-11-09 04:31:00 UTC+0000,d00b6d4efbf5473eb832df68e314eea6,974093c2911e4700bc188272c7649c01,0,1,1,0,2
5066,81b963d5072047f3afa4d0ffc0dad333,2014-12-22 18:09:36 UTC+0000,7f97f5d8bb4d450b9cadbdbc92491eea,e0fbfa616ab7409b8263f4afa590fcc1,2,1,1,1,3
7077,81befa4f663843b7a514b79f911ff910,2018-02-16 18:03:01 UTC+0000,789f878f34f846c09811084198e35d84,503167f451a348d1a32c54af5d7d19aa,1,1,1,1,3
2058,81ce0c6857854fd3bea07726d7068337,2018-05-08 11:43:21 UTC+0000,3ff20bd7d07d4fc7a07bc24591cc9af1,8d63cf34213f45189a5a8eabd9d71529,1,1,1,1,3
880,81ef0a62d8284db79618e02f642ae982,2015-09-17 20:29:03 UTC+0000,471fc0f761534eb296cb381d0131fafc,83cfc4f44b9d4fef8cb95530319d8b53,3,2,1,1,4
3381,81f3fb2a25c8427c98f8410e271170f6,2016-07-18 01:05:50 UTC+0000,8f6d8b0a8c0e41c8aa34307673731ad5,2694d61072bc46be9d657652403c3fb3,1,1,1,1,3
300,81fe26c0f4214d70b1c0875f3a4720a0,2019-01-30 22:54:18 UTC+0000,c7a88aa76f5f49b0830bfeb46ba17e4d,d02f6d9faac24997a7003a59e5f34bd3,1,2,1,1,4
6231,822fbb680c054dbf948c27a3b4c35b12,2016-05-19 15:48:38 UTC+0000,1ab9e60459264e139576579fd8c7ac58,bdd28bb878494d4bb10e7ae0afc3ec0d,0,1,1,0,2
7664,8235a90d06724ce680cc7c3a701810fb,2018-03-20 15:28:35 UTC+0000,40ffeb547df64712aaf53df4bc608a35,82d685573e1447b9b4c1d74ad964c3e2,2,1,1,1,3
874,823cde947be348f5bd8b776acb08f04c,2016-12-26 23:55:27 UTC+0000,4577491a30314a6585908b13240db219,7e721be7613246dd9f1aee1fb31271b2,5,2,1,1,4
5999,823f3f58bd7f44008e757c9d624c9bc2,2016-05-19 22:31:53 UTC+0000,9c154eaefe9a4335b912354f26e39e2b,bb629cde3b9141c3b0595de0e801b19b,1,1,1,1,3
1993,8259cdb1ecca449eb7dfa2bf70ebf96c,2018-09-04 15:52:25 UTC+0000,81e2b1e0f2734e8e8b57970cff50ad76,36ff3b3666df400f956f8335cf53e09e,0,1,1,0,2
1164,826ea84b99f947299740ae07d3a4667f,2012-03-30 01:27:26 UTC+0000,fb31be82dc3542aba50a36f154750e1b,db8cd00a3c5441e580cfb5f81de35427,4,4,1,1,6
5651,82731a31a5b541c5b7b48271751110e9,2018-02-01 15:11:01 UTC+0000,dca14408378f475597990cc65daf0621,4a0ee340be2c4355adaed64d4737015f,0,1,1,0,2
7528,827a1425ceb44c50a65ba320c045f887,2018-02-03 05:13:12 UTC+0000,9363be76b7324c4284e069bd245a3b83,ac83901fad384461ad33630aa2d823d7,2,1,1,1,3
4971,8285a2a41e68474fa36b18922b33e519,2016-05-03 16:27:54 UTC+0000,89b290c648234ca09c63c9af998b3428,7873744371da478f8d24242468aa1b3a,2,1,1,1,3
2498,829346239fb74d09b440f513d23ba620,2016-10-31 18:58:53 UTC+0000,3960edddf5054ca2b09206f73b1fa810,13b55ed4834e4814bb33a4c87001063d,0,1,1,0,2
237,82a8cd75358f4df584e040a3033d109d,2016-10-07 18:21:49 UTC+0000,d2619957b8134661ba2c53748b45cfa2,a1006e6a58a0447592e2435caa230f78,0,1,1,0,2
5504,82aa2ddd213544789e07c2fb506435a5,2017-09-30 10:12:52 UTC+0000,05171cfa1984423bab14939a2b0f36d0,6232d3d12c824cbcb3abe1739fa21bd9,1,1,1,1,3
5166,82acf6d8608b4743848d0c8c4e5c610b,2012-10-01 04:29:48 UTC+0000,ae8d6e375f804c698c324def1a3bf4f9,0c673e046d824ec0ad0ebe012a0673e4,2,4,1,1,6
2849,82b2395b3aed4f2fad688e5df2ef7eef,2016-05-16 17:10:27 UTC+0000,03af47093c834c09ad14b590d8401bd9,9637a0f19f8f4d8e900443f4ca040ca4,1,1,1,1,3
6983,82bf2866fb1240ef9df605676c4ca699,2016-12-22 00:13:13 UTC+0000,3569a1180dfa4fe684860bdd218394af,d02f6d9faac24997a7003a59e5f34bd3,3,1,1,1,3
5394,82c064a2292849f1bd1f21f464a1ab86,2017-05-10 17:08:26 UTC+0000,93b3e3f943fa49fab743e685d0f7f6dc,58dd370805414e6ea8fb96aadc69ec8e,4,1,1,1,3
529,82c12b0b169c45ecaa9f3c2abe7b512f,2016-05-18 02:36:55 UTC+0000,c738d420677442c29d0747103cc4aae8,dfbd5a8dce2f4cb58082dd095dbaca05,1,1,1,1,3
4621,82f10eca6ccb42e7923310aeaf3e611f,2018-09-08 00:54:45 UTC+0000,f9c42c29470c4f10b7b6d50b0778c700,36ff3b3666df400f956f8335cf53e09e,1,1,1,1,3
5600,832ff8499f6d4ddcb631b576de9a2b96,2014-03-08 15:13:31 UTC+0000,25ee9dd5be314e108630947196c32bda,05444a2f42454327b2ac4b463c0adbe0,1,3,1,1,5
6508,833650f3a3e84b24acc0cbecd9f92be2,2018-03-16 04:50:14 UTC+0000,893dff2c71984cf08f93f2a66431516c,d0c0700a25c548b9b09273bc127c51c3,1,1,1,1,3
6457,8369b505f8d04d7db60d6225ce4cfa80,2016-05-18 14:40:26 UTC+0000,cbc9756a1f9a46d488c36e3e59f0322e,7bffa1792d474359b922e5de700d7a82,1,2,1,1,4
5824,8384fec5aa2d42109b774fd5ba58b37a,2017-03-31 13:54:09 UTC+0000,b8fb497147984da4b4787fc15bc8d249,f64df9b489864952917cb631be1ddac7,1,1,1,1,3
4177,838d92d7d9124595b4fe58bb6a9ac968,2018-06-08 21:49:40 UTC+0000,c32d57d056a1461e986556ca188b1651,6804f8b34cd9457fb3f1bbd6ee0f4fa9,3,2,1,1,4
6202,8398c40155c841deb98c2f4accbe2ef3,2016-05-05 16:24:48 UTC+0000,c9e71e2e06de40549b2250a56a4a6c6d,7b86ca42543646b2bc1641f8aad4399f,2,1,1,1,3
2636,83a457cbb43f45dc8c1c747d96bce6e4,2015-09-02 23:29:06 UTC+0000,296ca3bd985c472d8555e6863eeaca45,f96f59f78b4c4c4dafff870b194d8794,1,1,1,1,3
3112,83cc27d5a91b428c8c0d5b1da517d501,2018-03-22 18:27:14 UTC+0000,9e5f4f7e12a2422f9d5ba56e0a02bb02,826e706f2e564d52856aa71abff6a00e,1,1,1,1,3
5754,83cfd2c4d09345dd9db187821ada5df7,2016-09-11 21:49:50 UTC+0000,4f2c4d8d49ab427ebcf64a8b270be68a,b0e916f9368640afbf1db030c4ead872,0,1,1,0,2
864,83d63fa6880445a9abaa7fdde6a13dc2,2017-01-20 02:20:06 UTC+0000,ef5c6b411acc487fad68544ba2b44656,3b0d687829024e34a666a19daf42d5fa,1,1,1,1,3
559,83d932cb0aa4411fbdde90fe0a3be22a,2017-02-16 23:46:50 UTC+0000,b5d997da21c34d82b4f88dd9c9f41db1,36ff3b3666df400f956f8335cf53e09e,0,2,1,0,3
3013,83d9671c995846cc888dc0385dfbebac,2016-05-24 00:19:41 UTC+0000,674166cad2ec426981fd2364caa112f2,36ff3b3666df400f956f8335cf53e09e,0,1,1,0,2
1130,83d9703d9afa4792b4ed860afe19d841,2016-09-07 13:28:02 UTC+0000,bb987021490d41d3adeaf45f06c9e038,d1dc7e671e05451bb4b4c19db0e9d48e,1,1,1,1,3
3544,83dc0e810d8342dfaf61a138e96d51c3,2018-11-05 11:41:06 UTC+0000,0d770b8cd9d8439fbc0b4665d89314a9,e2b4c84bf1ca4aea9b108869692d8017,1,1,1,1,3
6339,83e25eab3e8348beaf5bd2d630df561a,2016-05-18 14:34:16 UTC+0000,5cac32579a914fdf86a30f7cba48ccc2,7bffa1792d474359b922e5de700d7a82,0,1,1,0,2
6502,83e3041b3439421fb19b2b989cc7b4e8,2016-05-04 01:12:47 UTC+0000,c4b50052a34f48a4a42526eee1c8e05c,6ee41b99dbdf4840b06981e2f89acd77,1,1,1,1,3
4027,83ee084ef5d546f5b16b66cf2b4acf6c,2015-09-17 20:02:24 UTC+0000,9167664d54aa4434a744ae18f7a62d43,83cfc4f44b9d4fef8cb95530319d8b53,1,1,1,1,3
6540,83f62400652e4a40b2eb52c6d251ece4,2016-11-01 02:22:46 UTC+0000,c62d989edfb64dc2892e1990c4bb594b,ff9b24dcebc744bebc50f2472502efb9,1,4,1,1,6
7220,8401e89ea2d14ff585eee11123e6e610,2018-03-01 19:31:20 UTC+0000,189b66308156434f948cbc3300b77694,4df3db7955fb4052a6cb2ade9009d940,1,1,1,1,3
5413,84030f7abeb442be911119de04de2834,2016-04-28 23:18:37 UTC+0000,29f6a9aecbf0459fae14acf39cf452f2,10005df177a444198e4a6052d8ac7502,1,1,1,1,3
5962,840aa25dc1f343629731705b3b8cb043,2015-04-10 15:49:00 UTC+0000,3d29fafbcd91467b8ed6fec599939150,cd8c06e078d0401db5af1128903ca295,1,1,1,1,3
1972,841ee530b4ac4059b7d39e63e2f84044,2016-05-17 04:43:58 UTC+0000,cb57a0cf065344b1859ad040a06c8450,411dd284619d448284c053949513c6c1,0,1,1,0,2
1704,843048ff75884599b334a808d66bf525,2017-02-22 01:41:09 UTC+0000,39d14650234249408e44d149203fe8e7,a1006e6a58a0447592e2435caa230f78,0,1,1,0,2
2071,84320c213c2a47d99fa7123daf2cf6f2,2018-04-09 15:23:34 UTC+0000,8c38a2e139dc4084be1fc74dd88a6832,36ff3b3666df400f956f8335cf53e09e,0,1,1,0,2
885,843c496617e64f5ea9db1f1fb99b7133,2016-08-23 00:18:25 UTC+0000,c03eb3a1ca264adf9670b78bf236ad69,34a4f297347146698c8bb7ceb15019da,1,1,1,1,3
7435,8440247eff984c9890bfe3b4841db8fd,2016-10-27 14:49:11 UTC+0000,f71247c55ede4906999f32d9029af2c2,7f3b11c0f75b44e39543a21c1e320f12,1,1,1,1,3
5240,847dc709491e43848aecb64c425a3fa9,2018-11-13 00:53:02 UTC+0000,5d3313f8f94a4655866f231152754c84,5dbc7aa1edb94ad08d48d5b4829858ac,1,2,1,1,4
3287,849409c119654255909516a6388f1dd9,2017-11-14 19:20:03 UTC+0000,ad78c9e31e9843ffb12815086ea0d121,e248a06a65c148dbb3f2c166dbdb2148,0,1,1,0,2
660,849c93343804423ab08a2456f2cb33eb,2016-05-14 03:23:57 UTC+0000,172f6abec6624c25a13f0ff764fc1729,58fa5e95fe9e480a9349bbb1d7faaddb,0,2,1,0,3
3251,84a0566105624b6ebe1939f80cca5783,2014-03-23 15:24:51 UTC+0000,53345a2da1aa430d8eed733d20214864,0eebb6c7f960452fa457747129577f85,1,2,1,1,4
6063,84b9130f23ba4d05965aa18111b051a5,2014-03-05 17:47:26 UTC+0000,cdaf052ef9224196b423dd13c4c29150,f0feae11574f4a94a37374f317c06675,1,1,1,1,3
4029,84c2f8db4d8f464696bed6ae68802ee5,2016-06-30 00:54:14 UTC+0000,d85d645386fe41369352669c7c12abab,7919ea19db274c1fb862f3456cd25ac5,1,1,1,1,3
2443,84d517f90e0a49158120343df61e4ee6,2016-12-01 15:51:37 UTC+0000,8f8f170df8b94c9c96155ad177809409,416321b48a634ac8a53602625f0a5d40,3,1,1,1,3
4463,84d9e385aa9b41f5adda2c172cff6eb7,2018-02-16 03:03:30 UTC+0000,2d2701302aaa4664a680acbba1b1bb4e,16ff670578744fee9c135dd03f7eaff5,1,1,1,1,3
2680,84dec14dec3f41ca8bc76a6c75fd4fdb,2015-10-29 17:04:39 UTC+0000,56eca8b5f3c2443bb15be8d95da90e83,a1006e6a58a0447592e2435caa230f78,1,1,1,1,3
3229,84e0b53ce0b94b6d88eb7c0159737b61,2016-06-23 16:15:24 UTC+0000,816c41892ff04df2ba150f8f0ffd755a,3b03482e9df44963b6883b173f656efd,0,1,1,0,2
4926,84edf5ced9fc4b3da4cdf1888605b8c9,2014-03-28 18:01:35 UTC+0000,03cb0917c445468f863ed99555d53457,5f4c8c5868cd442e8e0bc218b9a10e03,0,3,1,0,4
1585,84ef2ec9d2ad4b15a829078892567c25,2017-04-14 00:57:42 UTC+0000,d1fe892a16e7454f9522397ed0fd296b,d97b69151d1f4c22b97582347e5926c1,0,1,1,0,2
5436,84f28e51eae34c97b5061716856e2f94,2015-06-25 01:01:39 UTC+0000,3f0e8d3f4ca44e1c805e7cd88b429555,168b649125b54d6c84f9f5fc1f4033a1,2,1,1,1,3
3357,84f31720800a4d77bfd9fa88657bd0de,2016-07-12 21:12:54 UTC+0000,af8b7c66002c4cad83a0e20ad540e648,a1006e6a58a0447592e2435caa230f78,1,1,1,1,3
2222,85021058d28b494a8a65c7a1fa62fa17,2014-03-21 03:29:50 UTC+0000,16a702414d944ec2bfaacc937343e5e9,13b9f5b7d388458db1e7bd05e4619587,2,5,1,1,7
1274,8506bf11b2294358a80fc24326f7115e,2016-08-15 18:32:15 UTC+0000,5f2cf1c3c517447f93b3ffdc8ec97cb6,e07704ed935144fba1fe8b09cfb567ac,2,1,1,1,3
5976,851e856d559d45cdbbac11e05ea0a87c,2016-07-05 01:08:15 UTC+0000,0b22eac405ae40aaba64ce665992f990,be5d23056fcb4f1287c823beec5291e1,3,2,1,1,4
3603,852503708ca3465590b835b4ebbd483a,2015-10-30 18:52:27 UTC+0000,c3b91a910f374d3c9ef326dd2aaa5396,250a771338344a65a67ea74e4229e62f,1,2,1,1,4
4455,853af46e0c574c698d9b1365a558475c,2017-01-10 23:36:43 UTC+0000,5234d70646144ecab2b1a3968129cecd,dbfc21fbff414832beed41c7a5966096,1,1,1,1,3
491,854ca3f01d584b15b0439947ce026c64,2014-07-18 15:40:44 UTC+0000,9360ba19b25d4beab2b5869b9792be19,1a826aafb40d457ba501913a9e77fe6d,1,1,1,1,3
7127,854e546ac67b4241abded8f06b27fdae,2013-12-05 17:09:47 UTC+0000,f9542057bb78480a838dcaa244226abd,0aa7a2ea5d07420188c459cf9052b336,0,1,1,0,2
6013,854f5cbcf60b4d448b16e01b9b04fe01,2016-06-10 16:40:16 UTC+0000,9f6e7599b4db42f8a5a0bb618c7c74c5,976b9fe0968a4032ad42f2bb2a94d9a4,4,3,1,1,5
6195,8559af6a11b4455eb6b1893684cd46b4,2013-09-24 21:44:59 UTC+0000,25a05f17f0174379b7c977014d92d452,207c8c62bcaa4033885a24a8a5a10d51,2,3,1,1,5
7442,856f55968d184ed29f14f716b1e69e22,2012-09-09 03:41:47 UTC+0000,66542a82e5b44fe8b64ce8e9f4eba802,05444a2f42454327b2ac4b463c0adbe0,2,1,1,1,3
5697,8571da0b5e9f443fa7ba931b0f63fed3,2014-12-02 13:40:12 UTC+0000,edcfd691e5fb4a72a1ee85a120d0e5b7,3b7e352267da403695a5c0f50f28da8b,1,1,1,1,3
3403,857a1655d17646be87f873910f44a9e8,2017-01-01 12:19:31 UTC+0000,c0ea21636424423e91d0bf61fd2d401e,f1375fe8847940b998476ebda44c6449,0,1,1,0,2
5882,8584fb585c2f4a41861ec1580a954ae8,2018-04-06 22:10:50 UTC+0000,9a7a898c71684d89bbc49435ea1d040b,887c5a142b42466fb74740d72989fc74,1,1,1,1,3
3989,858720f5bc3b44a983dee2b56fc5da42,2015-10-24 22:11:14 UTC+0000,415ab76eb4684283bbbf678a1bdfad71,a1006e6a58a0447592e2435caa230f78,0,1,1,0,2
7064,858d3c748ff5434d8166c5a07be43577,2016-06-17 13:39:02 UTC+0000,5d4376aee5e74298af03a4e446bfa72c,58fa5e95fe9e480a9349bbb1d7faaddb,0,2,1,0,3
2925,858fffa19f2d4329aaa1adb0a06a17a9,2016-05-02 23:27:13 UTC+0000,8735fa275ae24dca87084471b1056a1f,0fc95795259f4c96b6a08d3a7bb96823,2,2,1,1,4
3014,859d015f91a14bd19a0ac1ce8f72cf7e,2018-07-16 16:08:58 UTC+0000,d2d7c1c509634f5285a0207616b30ad2,5adef629a19946049d7ba11d6552d57c,0,1,1,0,2
3971,85c5b45117234bf2a2bc12738e5c854e,2018-04-15 21:08:52 UTC+0000,866c5e08dd024776b37ebf7f55f7b5aa,209fcd55fefa4fe29ccedcdc26bd5d89,1,1,1,1,3
6797,85d52173bfb544459c5ea6ab12bf3590,2016-05-19 20:41:18 UTC+0000,a97d3ba2b43a4de49a271b022224479b,62df4121c5d64528a7ed438b9ad86d98,1,1,1,1,3
5257,85e28f2ddc5d4a1eaf51f3715527395c,2015-11-09 00:09:47 UTC+0000,970ded1aa58e4ff0a5f1ba3fa002ed02,059210ca80d44bc9a63b854fd2111d09,1,2,1,1,4
3072,85e2fe0b4e564bb79d3e323936e918aa,2016-06-25 05:02:51 UTC+0000,cdb52d9781134cd6b1bfcee8e2ff8509,327e3aeb0e174b8bb49ab6bc75ca3f89,2,2,1,1,4
7677,85e34fbedec545cf8d884b08e130615d,2017-12-04 19:13:43 UTC+0000,4fd573cf2a6d4e6c9320fcc33ea82623,88fba04fb7bc42e6ab416599067f6440,0,1,1,0,2
3479,85f2162e672c4916957563f2ea5d0c8c,2016-05-07 19:05:59 UTC+0000,0f126009d8d643559a2c84f7ed41ba9c,02a21c26ce44473eb1c98e21918b22c5,0,2,1,0,3
2940,860a63cc31c748f592047c6768e9be88,2017-04-05 12:33:25 UTC+0000,557edd5c9dc6427ea43623a5a6928e6a,d67ce930870945109a7ad86d29ba2035,3,1,1,1,3
6077,860ee44fc32a4bf1bd98c423931250a8,2016-09-14 12:09:45 UTC+0000,459ba78fb78144bb8f09709179c2ed7f,9abaf20a7e4a4e5993fb6b64852e110a,0,1,1,0,2
3012,86168cb35a894d90885b419b81d22d98,2014-04-08 14:09:18 UTC+0000,203a9c5837b04614bb8b466499230eb5,4ee8012894c944eb891b8887df51b3ec,0,3,1,0,4
5633,86248be6614f441fab8c71452a00c123,2018-10-07 13:20:51 UTC+0000,b5e05f4af1d84e8a98acd7120801e882,90a44c8e7a5848998d93a58f4b702a66,1,1,1,1,3
4794,862dd549b8174b5dbccddb060b852d19,2018-06-08 11:44:19 UTC+0000,7c56806ec9304ff09c6985580f052476,36ff3b3666df400f956f8335cf53e09e,0,1,1,0,2
5855,86382ee5568649a7810f61023a5ec4b5,2018-01-24 20:17:16 UTC+0000,e82c8fa4eaba45839a1c157901266d44,3f67413833f543dfadca1bed671249ad,0,1,1,0,2
6112,864145bfe5884069806a55448575ba46,2014-03-12 20:35:08 UTC+0000,d2467f12c43f450fb8d840450966edfd,2adab7916b3747af85b2d82e188c1dc3,8,1,1,1,3
3305,86436fbc90cd4413ad21555d4f66316c,2015-05-22 16:05:43 UTC+0000,185a24aa5c86434b9a7bba4c8b9e64ca,50f4b7e7ee2140fcb66a70e575984328,2,2,1,1,4
804,865a21939b364ba2822a83070f25a17b,2015-03-19 21:07:38 UTC+0000,69e1b87a89444c259400e8098a81a5e5,77e2af08888a4965aad9689d9b9b34a1,2,2,1,1,4
4283,865a7cabd3cb4447b24031a85297cb6d,2014-03-05 21:01:11 UTC+0000,74a2aec6c80f4c93958a6731e82b3c59,2adab7916b3747af85b2d82e188c1dc3,1,1,1,1,3
6388,8665633660014c8ab7baada1aa366109,2012-09-08 14:20:25 UTC+0000,4d4fed18596a494480c6aabd7e69889b,8442ddfd38bc422fb4677785db0630e6,1,1,1,1,3
4657,8668a3e7ea7549488749f7f4865d284a,2016-12-22 05:13:50 UTC+0000,b4b8c91984b04182b897e812b7c40f05,4f3f080d728144d9b57a72f6533101fa,0,1,1,0,2
542,86774572540f48b8ba3c4a646ddda416,2016-05-12 09:48:42 UTC+0000,fcdc1c83456e40aa9d44291f06a7066c,96bbbdd06a334805a0501034d9df1aa4,0,1,1,0,2
3048,868480be2bec49e0a848e622f7515659,2017-06-07 00:59:53 UTC+0000,55f39a69df5d46578aa331dc5d63a648,e3605142dffb4d87a0f8b950da727f73,1,1,1,1,3
3003,869bfcf61adc46c58a374eebf34daf2b,2017-04-11 02:56:07 UTC+0000,ab8a77b569064f35860aa07e70909027,be5d23056fcb4f1287c823beec5291e1,1,3,0,1,4
1511,86b197a56ea6449c906629e80776c762,2018-09-20 23:03:03 UTC+0000,bbbff61ba76b43769c66570d2d568339,4c814eb20a154011b740f94b7436110a,0,1,1,0,2
7594,86e329b605b04650a60798477018b5fc,2017-09-04 01:05:25 UTC+0000,8252233305f74e21bce6b088f0731784,0b17f4e9d93c40eb9a5d087865084ce6,1,1,1,1,3
3155,86e7e9ee9a0644179e0aafaf3c029085,2014-02-10 15:48:58 UTC+0000,d4fb3091015a44428b5acf4e5947232c,5cbd4a64a328414781df8b75e47ffad3,7,5,1,1,7
7209,86e96922c352432998f281b208dcc112,2018-02-02 22:10:51 UTC+0000,97c0ea17c3444d4a9df344b00b316b1f,a209eed08b8846adaf95f352b1325815,0,1,1,0,2
6913,86eb672511bf478eaaadeebc9498b07d,2013-10-04 17:43:57 UTC+0000,223c7f8539e946da9850fe73ed7fa2c3,f9c65e0f8b32445f8b6657825f1f4dfd,1,1,1,1,3
4289,870a77cdd5254013a3561b29d5da5c95,2018-03-20 22:44:35 UTC+0000,b2e697b1aca84ac3b0d5b5f6bc79fd93,5fc76ec033e2422baefbffa8183d0b30,2,1,1,1,3
28,871504ce372340059bb06338857be82f,2018-03-07 18:30:44 UTC+0000,dfa50a5abd4048d9b27df339f7081449,5fc76ec033e2422baefbffa8183d0b30,0,1,1,0,2
5542,871c09f0b6b4450fbdf856babce8c84d,2017-06-05 15:26:03 UTC+0000,d8fc406840b4412396c04eb62a0dd6a1,d9ee4b1f242d4bf2a395b278faa56de4,0,2,1,0,3
5032,8727fc5bbe46494c83b95a1e17095ca9,2015-10-06 13:11:56 UTC+0000,45d4e6a9d5d04f20b5d77ed9c3aecb09,c3668d2d66334063bbeaf07cdb273ad9,0,1,1,0,2
5557,87396c8a2a3d4e11ad67f0466eb798f2,2014-03-26 21:23:13 UTC+0000,7a5a93859a134654bca7cf0a3faead72,3d8847ddc8d04185976a9e78b190ebdb,1,3,1,1,5
6552,873bef3e1cfc4b39a49ec5548ff8fd3c,2016-06-05 21:44:46 UTC+0000,eb26f421c410439d8b8029e213854adf,58fa5e95fe9e480a9349bbb1d7faaddb,0,2,1,0,3
2835,873e449cd4f5451e8678ac3b38968d2c,2013-05-05 03:49:17 UTC+0000,09f500d492664aeb9c8e9de3849c773e,86ae7fc6ed8e4da89fbb1525792fbe62,2,2,1,1,4
1405,87578b1a4ad24f7391dcd8c4d32d267c,2016-05-16 01:00:46 UTC+0000,53cecaf4520343fabae6ad62b20d734c,58fa5e95fe9e480a9349bbb1d7faaddb,1,2,1,1,4
1134,8758ca30d10940ca9147d050d9e5a41a,2016-05-12 10:37:54 UTC+0000,06369f6d3a3b48948e7a40d24fd2aa15,54976f119d3a42d3ae3d85956c1b6338,1,1,1,1,3
6223,875e572257bd4c09ad6b01c8fdd3fb5c,2015-10-22 17:47:21 UTC+0000,9417810ecc9e405fb7c8e623daed5d67,c1a24b8f746b47488da02a0e5044a7a9,1,1,1,1,3
2510,87a45fac82c14b29acf18c980ea88738,2016-03-08 15:13:27 UTC+0000,907f7d6c0866421bb0503bc7a1bad998,c3b4e11154f74a858779be7ba9b6f00c,1,3,0,1,4
729,87cdc687982d440d8e77bf965a0da750,2017-03-26 14:45:51 UTC+0000,83fa4d43d467456a89a47389b9256f63,3b0d687829024e34a666a19daf42d5fa,3,1,1,1,3
1928,87e49a45ea4d472eb01651003767a6a8,2016-05-20 16:05:26 UTC+0000,fe8d89dda4c240b7999c070bdaae5022,f123a7e8ad2345b49378d51b2238c50b,3,1,1,1,3
5657,87e6a2b66c02440f83fffabff677186d,2016-10-31 14:12:37 UTC+0000,0dcf0d5531cc4ed9b1ba3458c4ed65c6,783f6ce6c3cf4553ac215bc1a174a87b,1,1,1,1,3
5674,87ee2ea2b6a24b9fb434e2a426b02d71,2014-04-22 23:15:06 UTC+0000,c65a4c9883cb4f208742cc32e04a1b12,e4e7cc05a0b64cd6b02168d404a45d4f,2,4,1,1,6
7758,8817bdb96a9842c4bf890984a237d1b8,2016-08-15 20:25:24 UTC+0000,4d30a50f562c45b08c1b5f64a0175a7f,369f1c8646b649f6997eae7809696bd5,0,1,1,0,2
4747,881f22494d9040c7af535482aa3313f5,2016-07-21 00:27:51 UTC+0000,606f72b430334e419b880002ba330ea1,436070799f1e4bafb97a3b5c29deefe6,0,1,1,0,2
2056,88242a098c52467f9666cb87c9da0603,2014-03-18 01:55:21 UTC+0000,871c226ffc5542e4b501e3eca4551921,77a65aed859f4b11983cd07399f1e3b1,1,1,1,1,3
2566,8838849a661f4184b666c1299540caca,2018-01-25 01:13:00 UTC+0000,381a6b32a62f4983bd9f8109a596ac64,5a14109840c24b21b81eec989db259f6,0,2,1,0,3
4706,8840394c71164a90bb302b97669297c2,2016-03-22 01:38:42 UTC+0000,de93f4b06d6d45d584071720eef1444b,a34f64cda5054c17b81aebf4b6af77b1,0,1,1,0,2
601,88580dd1356c411aaeb497e475abe935,2016-06-24 19:25:25 UTC+0000,68f7fa2c5a3840ffbf9519cccb6344e7,a72134ca2c9249d49e5d7606d9fbcef5,4,4,1,1,6
2622,889ba6b8c5e24ae69f275eba868a43d5,2014-04-11 02:06:34 UTC+0000,2a81c594df2e45ee8ace511a9e3aeca1,1fbcd8b315de45c29ff87cf912b535fc,5,1,1,1,3
3969,88adf0c8f41a49d7bc4593c6adb2de53,2017-05-21 05:14:56 UTC+0000,2dff11746a434ccc89acaea5fa95a12f,3846e3ac730d4a21863fb175065a1092,1,1,1,1,3
1910,88bde9f203ef4977a35ff5349ec20914,2017-04-13 19:48:13 UTC+0000,b1b08488301c42f4923135f9a72181e9,a2d96fb60de24365bb0c5bd128449e4d,0,1,1,0,2
449,88cc45119e54453ca29712b31a5a2d66,2016-11-03 17:46:31 UTC+0000,f226d96dd8dd46809ef1544c8919923d,ffb0f42469d9455b93bc85071e3030b4,0,1,1,0,2
1897,88d58750fa764dc09e364b44c0f1ef3d,2014-03-24 10:46:03 UTC+0000,9400f4d69c77426693790056c40ecf2a,6877d790e8e04303916865c406ec5202,2,4,1,1,6
2910,88d712313fa44d7f98e29768fb5ac661,2015-04-01 17:19:01 UTC+0000,c274d6242fec4dd4af36dafbba97679c,c1341204dce1463dad3964c3f3f462c3,1,2,1,1,4
1251,88dda4337efd4ea3914619b7ff893ab1,2016-09-25 00:19:45 UTC+0000,de9419014c8c4a6b8aac0c34be127b18,9015cb6141cf4b9781791244ecfbc286,0,2,1,0,3
42,89166020d2384b639e3f688dc5a7eb20,2016-12-08 01:27:17 UTC+0000,292b61d52c2d4939a29f2cfde65f5e82,c24fbf992ffd4346a70502f34696f06a,0,1,1,0,2
358,891855a4bf4748d5b90d5d27c1cbcba6,2015-03-23 20:48:27 UTC+0000,97f187b9a0b644ebb87197f10148455f,369f1c8646b649f6997eae7809696bd5,2,1,1,1,3
585,892ab8c6b779489f8296d2d9e476de60,2016-07-31 03:22:26 UTC+0000,0058d7078546419b84003ea13cffc5fe,2c308b05c3ec41f7953bdff1c9464a60,0,1,1,0,2
3210,893374f6b4ad4533a7f32f932c13fce8,2015-02-19 13:48:03 UTC+0000,8afaeab0e290497fb5147d851d423357,369f1c8646b649f6997eae7809696bd5,1,1,1,1,3
4095,893683cde62849bbbb9de789961171b1,2017-01-06 20:43:21 UTC+0000,9527942e55724acebe57e7f6bbfc7724,a1006e6a58a0447592e2435caa230f78,0,1,1,0,2
1418,893f06aa3700459ba3f1e00b57e3c7b5,2014-08-19 23:08:01 UTC+0000,9d1ff1bb617b43ddbe35976d8cdf99b3,5b4cce100fc64fc18106cb9233ecc6ae,3,3,1,1,5
2186,8940541385e4434f8ca91d279cfb4885,2015-05-22 16:45:27 UTC+0000,c55de334e352438596686e88f2b695b7,83cfc4f44b9d4fef8cb95530319d8b53,0,1,1,0,2
8000,8945af411633452c82a94f729968ab81,2017-04-05 23:04:54 UTC+0000,62c251ac999c4b1d94d7b89cf3457c20,5361e4e6be2d40729ec52dfbd5d5ecd4,0,1,1,0,2
5186,8948c1db87ff415d932603dee8564c8c,2016-05-02 02:55:07 UTC+0000,4db0acbb412f40c18e59249329dbf636,44ecf414c6914a82b2b7bdd03db2f59c,1,3,1,1,5
3326,89538f72f13e45259b0d53e35f17c30f,2017-05-15 20:24:52 UTC+0000,c3b2156dd10a4028af4e2d69fcdd9a41,56d4db39d41f4b508e9e35597fb73e80,0,1,1,0,2
5491,8962f7db73944a84bbad613d5bb0a9ae,2015-10-27 20:16:04 UTC+0000,b81fa405c1784a379eecdecfdd65d71a,a1006e6a58a0447592e2435caa230f78,1,3,1,1,5
4797,89762149d99f4fc68f7494aeab3f2955,2018-02-28 12:49:44 UTC+0000,bb478f86b6054bc1a552432acc56b398,ad867a83ba3d4e6c91faa398a37a699b,1,1,1,1,3
4748,897af6d0cd2046239b29d2471fc64aee,2014-11-19 11:54:00 UTC+0000,d3aa33fd6a664410914a5e4cd7ffffe7,f3f77cdaafed4729b0fe95decacea3df,1,1,1,1,3
6459,898ee154dd0e4e4b8ea2a0c2d9e1ba38,2016-05-20 22:14:33 UTC+0000,5e9b766217ca44f8b052dddbe646e449,2c9a3b312d13455bb55fadf3c8d4b199,1,1,1,1,3
5851,89a2b82247f844778de70af84074dcfb,2016-02-16 17:37:09 UTC+0000,81a6f92c2edc4fac920dcf23beb9c838,96bbbdd06a334805a0501034d9df1aa4,3,1,1,1,3
3173,89a3afb3ed934dd6844110be29a40e65,2017-02-11 00:40:08 UTC+0000,01e74d953d064e919834434721d5e0db,e773d6ccade64f38b1b960c6b64f0a2a,0,1,1,0,2
4644,89be0a295e444888942452ae87b1950c,2016-10-11 20:43:25 UTC+0000,9bd3ee99c551411cb4b7b2fd96210cd9,b8b77df14ad94e7bb64f14eeffb72d9b,2,1,1,1,3
1649,89bf77792c414bb293e17dfb904ace36,2017-02-14 23:05:38 UTC+0000,46440a28fdd845798ac8f59d3f0e892a,6380a901e12f40f2abe9b3d6eef4baa6,1,1,1,1,3
5610,89c9afb4ab334aebbaf94fb750b92cb1,2014-04-08 18:18:50 UTC+0000,663d73cbd8c14ac995b87c27493a71a0,c84b7719b1e14c80a5ad3ab52dddad3b,0,2,1,0,3
1009,89db93efc5334b46b08507c69d927ae7,2016-06-26 15:23:35 UTC+0000,8cb839e76d2645a8bf33fac9e211ad7a,58fa5e95fe9e480a9349bbb1d7faaddb,5,6,1,1,8
5686,89f7581ca5fd4e7885184d1fa0f4e6dd,2015-03-23 14:47:16 UTC+0000,dcd97b426a094c6293a6979b64e1a82d,369f1c8646b649f6997eae7809696bd5,0,2,1,0,3
1089,8a0b92f702e444509f5bc9a95695663f,2018-10-06 01:35:46 UTC+0000,f3fcb1d52856469eb1db06a5c7c4df9e,5dbc7aa1edb94ad08d48d5b4829858ac,0,1,1,0,2
4380,8a1dec54753a461b8e511254db4ed23b,2016-05-14 21:47:07 UTC+0000,fe53b15a55264fe8a2bee3c0f88bede6,564ef581bed64addb3cf0ff0ab652ffd,1,1,1,1,3
3102,8a287121c55945d3aa92fb55a1d694a2,2018-01-08 02:51:42 UTC+0000,bc4234e833e94a5cb507f8ce4736ee6f,581a61b90c414ed1bf2ab2efdf1e049f,1,1,1,1,3
3207,8a3df1efb22a40a6a30867141ca3ebdc,2016-06-07 23:47:48 UTC+0000,967ab41c51ce452cbc20f80c7d747c5e,9733c59ca28e4aa8b9eb6fe39eeaa7f7,2,1,1,1,3
4679,8a53a9a132744cb2895e1200f6dad8a4,2017-08-30 01:18:43 UTC+0000,57b3188f77e5406d8f2d00e480a642a1,27cf1ef867d44df18ea3601056ba2b17,1,1,1,1,3
5418,8a5cb61cee9d400abd0546d9268ab813,2016-06-22 14:10:16 UTC+0000,ca8d897e1002443bae98f701e2310518,c9dcc1c3a5ab4c81afbb1de418c9510b,1,1,1,1,3
702,8a5fbcfe13ca4ec69f9a4cf90af36f61,2016-06-10 23:17:31 UTC+0000,df0713774f16408bb5d1ce144c6d472c,9f3d3e94b16e4ee7802faa98f91e8715,2,1,1,1,3
2476,8a6c0db3d8fc421993bd0611339906d6,2016-04-28 22:27:49 UTC+0000,9e3484912a424ef1b5163bf57607e60d,500156c3bc7147b987ed97001f45853a,1,2,1,1,4
1185,8a6de345ab8f41d2801e13cb35a04113,2018-01-25 13:59:42 UTC+0000,98c4aab0ba884656aecbb08ff79796c2,f233ed346bbb4888ac9135ae67b191f7,0,1,1,0,2
2678,8a769abbc219438dade9d6f7de6c13fb,2016-05-31 23:16:35 UTC+0000,da6f33efe1c5452f9c5dd7357dcd6e8b,13b55ed4834e4814bb33a4c87001063d,0,1,1,0,2
446,8a86f03f05304b56acc512299a513f10,2016-04-26 23:33:07 UTC+0000,1bf292cbb0944ddfb298444b9241039d,58fa5e95fe9e480a9349bbb1d7faaddb,2,10,1,1,12
6871,8a932da26a7c4813b2f4e3fc20425f37,2017-02-16 07:32:36 UTC+0000,686a9d5870c24606bccdcd022809b81f,7754a0bcad374344a119671de672e29a,1,1,1,1,3
1290,8a94d91aaf09425ea048bb9469781315,2015-10-29 15:29:50 UTC+0000,befc9e08f4854a5ebcd50ac1ca36e762,7907ca29169846c6b5b65c74c57e33b1,2,13,1,1,15
2147,8a9aa7cdda9f42a2a88b9547928c2076,2018-05-18 15:36:41 UTC+0000,31317b48e40d416ba095a63258825e15,1e2f9a23b1ab4ca391fd282a01b6b721,0,1,1,0,2
1160,8aadb3f92a7a434ba18d6bf9bba95629,2015-10-22 18:07:00 UTC+0000,6a92b91ef0ca446ab88062265e51c93b,369f1c8646b649f6997eae7809696bd5,1,7,1,1,9
6278,8acdd33c153344b9ae69a1b88711779d,2015-04-06 14:45:53 UTC+0000,a96741dfd06747df92cb78b4143af549,369f1c8646b649f6997eae7809696bd5,1,3,1,1,5
7397,8ad9985cb6d64bf9a2eb69787dac2730,2014-03-18 01:49:12 UTC+0000,db981a5d487042b983422d24de31c6a3,77a65aed859f4b11983cd07399f1e3b1,1,1,1,1,3
4842,8ade896989004a0899d9ffa671c0704d,2018-10-29 21:09:30 UTC+0000,32c94ef3869e4fe6b3505dda481d4ff2,96bfdd914c284f2dbea85ea1fbee6367,0,1,1,0,2
78,8adfe5c27b5a46d6b9bb6d9f45518061,2018-03-21 00:08:41 UTC+0000,ac36a92b31054e839780aaa3eac289e7,a5e02276d2dd45999a7ac87efc4309ef,1,1,1,1,3
6048,8ae47330bec04099bc135278fa945061,2015-04-30 14:04:47 UTC+0000,862b80a64e9e4ef6b22fc32edda0ad46,d74c2aa30b0348a5a616738e131de76e,3,3,1,1,5
4652,8aff9244dff9474a91e53f21fd881156,2016-03-17 19:39:12 UTC+0000,348f26549c704f28b0a3b044d00dd82c,a082cb6441ce48f6bf9abe0f8e55d5fe,1,1,1,1,3
7708,8b00891e3f8e46219c42a5df30552ce6,2015-02-25 19:16:07 UTC+0000,b035d73c540f46fca36e4cca5ba636b4,90c520d644094b30b4b4fc13513f71a6,2,1,1,1,3
6729,8b033cfb0bae474aae1e3243044ae928,2016-12-05 08:14:28 UTC+0000,4fdfc5ffb1654fb6b8ed7fc66e3a6feb,c416c4824bb04d4faee8bc6f7f2ed6d7,0,1,1,0,2
988,8b1f26ff9612450fa82df502557614fa,2015-02-09 17:20:48 UTC+0000,ac8520fe3ba6435d8ae23417fce214f4,369f1c8646b649f6997eae7809696bd5,0,1,1,0,2
757,8b24f15f088d479c9767994ec5977d1c,2014-03-05 22:42:10 UTC+0000,8d3cf49b16b546ac9164deece8c6eff6,dfffd276cafe415e9ab18a0ad5564a9c,3,2,1,1,4
844,8b28411c33594ce789ef8ef8f6142522,2016-10-24 00:50:17 UTC+0000,c18def6633284c16839b86e0439dc9be,168fc472ff214887bbe076f5ae6eb40a,0,1,1,0,2
1287,8b30fac9227e47c29b193561514abc08,2012-10-01 04:15:38 UTC+0000,5da6f00161524bf699b3714a26d54c26,f05b33a454c048f3bbc73f5f3f7f5127,1,1,1,1,3
6180,8b48db56a1e64237bd9f86d0bb266e21,2017-09-26 11:55:10 UTC+0000,a96af9eb0e7e46b28dbe27fcadd7078e,76b3a0ce57a8440887a9f79d7d97b8b2,0,1,1,0,2
5251,8b53fe2c6d1140339b25ac39a1af70ad,2015-12-09 18:14:23 UTC+0000,302840e738d44775bb93cdd3d8487f58,a1006e6a58a0447592e2435caa230f78,2,2,1,1,4
3501,8b540e08be184be099447b715106a15e,2018-02-13 03:20:41 UTC+0000,12c7a8f03600427890a82a79e8901cb4,6a551fda6a564e0698999e2edf0049dd,1,2,1,1,4
1153,8b5e6b44573b4d44b9e37a14ed38a269,2016-08-25 00:16:46 UTC+0000,2220a22fc20b446e8bd5d5e9d7451a44,e589ea1d909f4eee9c85b936512dc9b2,2,1,1,1,3
2768,8b6ed02da1e744799dd13569e29ea1fd,2018-01-18 14:40:28 UTC+0000,8fa714cbafb94923a098250ea473a275,887c5a142b42466fb74740d72989fc74,0,1,1,0,2
5724,8b7241e3a05c4ccb8cca73d7d8e90ba0,2015-03-30 19:29:54 UTC+0000,10bd799ee4c24bb295cfca353df6245c,369f1c8646b649f6997eae7809696bd5,1,1,1,1,3
2662,8b7784392fdd48118b63d348de61bbd1,2017-03-31 12:55:13 UTC+0000,88a78f065aa64601a1b88b03a75798f2,a1006e6a58a0447592e2435caa230f78,1,3,1,1,5
7038,8b8fa0742eec40a68ceb4a5775d262a0,2017-02-13 22:39:52 UTC+0000,fcc9415c5a8044c89489ab55acba98b7,36ff3b3666df400f956f8335cf53e09e,1,2,1,1,4
501,8b9085048fb94687b153df890c2f9269,2018-03-28 21:26:46 UTC+0000,dcf08a9a9f94470da97cf157b84b47c7,473faadc18eb4aae9dd7723d7d00cb98,0,1,1,0,2
3679,8b936f9ba131488c852ff176f6578892,2014-10-13 15:17:17 UTC+0000,4b8e93cf44064c258233779f0f6833df,6462dd79b7584083beba18a4adcb2cf1,3,1,1,1,3
1485,8b95bcede4fd4b088e4372ea197c6947,2016-08-15 21:53:01 UTC+0000,e6cbd64cebd640848c7f89642a80b78a,372ed21cf8bb4996b1c842ad4f446418,3,3,1,1,5
1570,8ba5ec75ec934ad185c7f18f4ef5d1f0,2016-03-12 17:45:05 UTC+0000,b69803261bd84797bce68fefc807dbc8,c6ff6dd8256c4bd8a42dea6d189c1270,1,1,1,1,3
3497,8bbbcf4b5a6b4ae38a2a3d463ca17f1e,2018-02-27 00:31:33 UTC+0000,fca9624ab3d343df837fca90c25ce87d,a6d33c38902546849c36ea7e9e9f0870,3,2,1,1,4
7272,8bd7a10810b14ee3b5e77dd6ba7ef7a9,2013-09-30 22:24:10 UTC+0000,e3b8de6c7b2c48629995670ebf52d24b,3409d2ee250545558ea03bfdfd8da22e,2,1,1,1,3
5887,8bf85a1c2b224a7aaba8c1199f11ceb1,2012-01-15 17:19:49 UTC+0000,ecbacbb08d8540a8961f7404713c046d,a71fdedfdb8a478cb19f6fdb761da215,3,3,1,1,5
2212,8c076eea735c43efab5423e783db3daa,2016-05-16 16:55:59 UTC+0000,6cefe525b7ef475085b011498ef114f9,6d054692482246e5a3e4ccccfb5cd6be,1,2,1,1,4
4690,8c0bf1c6cde34bf4a281c8c198ad9e5e,2017-02-03 19:31:24 UTC+0000,df8e731f00e44294a5f00675357b9b96,6dd29d5757d343eba6eae82e719835ee,0,1,1,0,2
2535,8c0ccac90df7422bb13f656977141915,2015-04-01 18:36:20 UTC+0000,9b05d793e0cc44f3ab05b35761cfd607,369f1c8646b649f6997eae7809696bd5,1,2,1,1,4
5846,8c200d613582465293ee7d1774bee453,2015-10-26 20:04:11 UTC+0000,ab825da8245949498edfe3d2f09cc135,a1006e6a58a0447592e2435caa230f78,0,1,1,0,2
2061,8c3e637166534aff94ab9fa53e70d6ea,2016-06-25 20:09:44 UTC+0000,c853eccfaaf54f55a969fb992a097f61,4dc7d9040592416f98c0bef1ad2c31f5,2,1,1,1,3
6964,8c4146ee1bc747b39dce8c8655276be2,2015-01-04 20:54:05 UTC+0000,1d68d83d75fa43ada171c65296f24271,fba595034c5a4f3aa27c3607b19eea39,2,4,1,1,6
1626,8c4d0af6b68544d89a4d1df7dc1894f1,2012-09-09 05:19:40 UTC+0000,d081943d0aa6427fbee13a3bc31d4207,624194ea296c49a6a8ef1180787476dc,1,1,1,1,3
7657,8c504e3736914778b9dd518bc2ec1ebf,2016-06-27 21:04:18 UTC+0000,6e6489c7c52b4ebaa227d635a79f9b75,4dc7d9040592416f98c0bef1ad2c31f5,0,2,1,0,3
3195,8c5188f6282647c8972e877da389f18e,2016-01-20 15:36:45 UTC+0000,57633259248b4050a7e5e1e5a983ead9,08d1642855e147d6bd5a702f606f9ff0,1,2,1,1,4
3433,8c7db1cdd0904e36b3e452df094077c9,2016-05-12 10:00:02 UTC+0000,b31e6154c85a4ee38c438abb5bb21789,96bbbdd06a334805a0501034d9df1aa4,1,2,1,1,4
4409,8c8bb94d822b48fe88e1e89a822dfdb4,2017-10-02 14:27:10 UTC+0000,54edd595cf57448a98b4f3069de0872a,eaabc3fb410648e1af6ad19b93e5f430,2,1,1,1,3
7673,8ca9f4e84d7c4151a0c1a42915e7d415,2015-01-02 21:57:00 UTC+0000,8938f524d8bf4106a9cc1507e3e5bd83,b688e766eed04a37b7abc9218aca1ce4,0,1,1,0,2
6006,8cb1fcf268a54552af7ec4e6cfabca39,2016-07-25 01:46:21 UTC+0000,ae072e809e09407db3b64e20b48b9a11,58fa5e95fe9e480a9349bbb1d7faaddb,0,2,1,0,3
2794,8cb2d21e31044c49a1902b1be60560e3,2015-11-18 18:28:27 UTC+0000,35d3ef802bae484d933d42826cff43a5,a1006e6a58a0447592e2435caa230f78,0,1,1,0,2
3652,8ccf1c1f0cd84cbbbb1e6655922f871a,2016-08-20 01:55:42 UTC+0000,cfcb525b17dd450f9c1773a92868aee2,dc28056163a8447686e5691f4c1475b0,1,2,1,1,4
103,8cdb9ee39f2242b2878c97dfe35a3c3e,2018-05-01 13:44:00 UTC+0000,602491413dfc497cbd9553fa82ca9cd9,40578810a56a41c590c6401d96d7d254,0,1,1,0,2
948,8ce41e6fe5da47d4a9625d04f6aa4adc,2017-02-26 01:41:20 UTC+0000,91fe2c88722e4e6a99ec7e22ede3c70e,f88c86f1d4724f0c953bc35bb7a0861f,1,1,1,1,3
7839,8ce7dde9cbe04940bbcdf4577e7296f3,2016-07-14 20:45:10 UTC+0000,323ea8a7607c467bbaff6b0aee5a5212,fd1cead1d5be4cb79ca121066d64fe03,0,1,1,0,2
7577,8cf28808450a418bae3ce97ff0cc1675,2016-05-23 16:34:41 UTC+0000,f70a92019df24342b77bb74739dd46e7,78a63dfd004d4133ac35dfb62fb0141b,3,2,1,1,4
648,8d011d2e57a743a3952d1272df0bcf9c,2017-10-29 14:06:47 UTC+0000,9c96562baa6f48d4b8b4c6cfbdabb4c7,09161c2732d246b5b272f544a41120a1,0,1,1,0,2
7469,8d0c2f3bdf814905b9bd91bc6cadbfdf,2017-02-27 16:31:12 UTC+0000,9383cf3e3ee849e28f5a53153d66186a,9a1d143c7f604d04bafb35117a4d3c84,0,1,1,0,2
3674,8d16a773958a46f08ef1221fcd2e9c9e,2016-05-11 02:51:52 UTC+0000,d7b80fbaa0054abf8ba782ab8ffb03a4,655cb4965f34469897b44a86f516f3cf,0,1,1,0,2
3097,8d1be962379a44e5b1693d2a076e063a,2016-12-12 20:19:25 UTC+0000,49268bc6a3f2473b9c79b0da703e5714,b0c289fe05884b889ac98cea3d47a111,3,1,1,1,3
933,8d22ede766004cd1a31aef052128c3ec,2017-01-23 19:01:02 UTC+0000,2b4689686556490bac613e84e6d00589,665a4dc589d94329b7a752ad551830ba,1,1,1,1,3
2810,8d2844c1ed3147c5b58abafc0b453c5a,2017-03-31 15:17:51 UTC+0000,ab19f639eaa44e7b968b2feaed11a481,416321b48a634ac8a53602625f0a5d40,0,1,1,0,2
3001,8d2a17d92fba46dc9d0ff896a56898d7,2018-01-08 15:41:33 UTC+0000,da2074ed86db471da61b30b872a0eb72,cb5efdb6742143169de54ee11b9eb314,0,2,1,0,3
4044,8d334fd4a1934a3f92f6242e79769356,2017-05-10 19:17:16 UTC+0000,95f47a1a4d8e404da893521f9bd42852,a1006e6a58a0447592e2435caa230f78,0,1,1,0,2
4550,8d416c5ed2e342a8bbe057693741d63f,2018-03-01 02:30:35 UTC+0000,61aebb92f54b499ca32c79fe627b1180,db45e88f146f429194f6ce81b5bb8940,1,1,1,1,3
3281,8d46cc83bd034b9b902fafdc4ab6d95b,2016-05-24 00:48:19 UTC+0000,c9eca888f396412683b013bcc10d82e1,ef359653a8af47328b5a47879590bfdb,2,1,1,1,3
2316,8d4c6c05b38946d883116a1e08bbfcac,2017-03-07 08:44:40 UTC+0000,09c4c0cbc4e14ff8907a691e4a1fa022,211e39ac71694bb5af233b205a0f2057,2,1,1,1,3
3665,8d4d706189434bb4a85e53a758cb8deb,2018-04-05 20:45:59 UTC+0000,8dd04ca4a5b746c09fd986414ef203f4,0df251f3b28c42a0b23628a1f478a3b2,0,1,1,0,2
3722,8d518c7c9b1a43bf9870536bd6a546ad,2017-01-26 10:45:40 UTC+0000,978b62c7ded84597a96c346c06aae4e2,a1006e6a58a0447592e2435caa230f78,1,1,1,1,3
6221,8d6a6686e65d49a0a3b5b2a77da1ad9f,2016-09-17 23:51:03 UTC+0000,31bb041da7f74abbaaf95cc280c57692,36ff3b3666df400f956f8335cf53e09e,1,3,1,1,5
7692,8d6e0359ff1a4e84814d1b3fbebc9cfb,2016-05-18 01:24:41 UTC+0000,49c2ccc6bf2341c18b47bd68f96cfded,a012826fa7334445a232ce054c76d0e5,0,1,1,0,2
2611,8d7a7ecef8584d598b2de7edad4a94a6,2018-08-13 12:24:12 UTC+0000,e81ddcb61b5d4098984f24ac27d9d6cf,36ff3b3666df400f956f8335cf53e09e,0,1,1,0,2
787,8d82a71f4d7847ae8485b0ae432201d9,2016-05-24 00:29:49 UTC+0000,eb7fd42478c54248821a32d0ed097d22,4e0f0fffe8c941ee844e650082267fb9,1,1,1,1,3
6170,8d92768fb9c3416f83c653d9d1ebe8bd,2014-03-10 21:07:21 UTC+0000,c57fac966fee49389e3aea596ca186ac,564ef581bed64addb3cf0ff0ab652ffd,3,2,1,1,4
3076,8d9d576c3418427796c331862c0b7ba4,2017-03-07 23:25:35 UTC+0000,2fab4e45135443a2970a661fbd70e2a4,96bbbdd06a334805a0501034d9df1aa4,1,1,1,1,3
657,8d9fb615c0c74bb2ae7fb0c017b9cb8e,2017-02-26 12:55:16 UTC+0000,a1452db9963b48d793a5079d38f56db1,dc28056163a8447686e5691f4c1475b0,1,1,1,1,3
4194,8dc5718d669a406ea3cc9df0e5b66649,2016-05-13 13:02:09 UTC+0000,c8048f613f8a49dd91a503e9df2ba24d,58fa5e95fe9e480a9349bbb1d7faaddb,3,1,1,1,3
2262,8de4c8d78e2d4f92a05230c2117528a5,2016-04-25 13:13:13 UTC+0000,f793d62fb41448168e2b7f20699fba6e,36ff3b3666df400f956f8335cf53e09e,1,1,1,1,3
3992,8defaa23908c4a1a987beb2c34293fa5,2014-02-21 21:13:54 UTC+0000,3829d460e387448095974b0114f2343d,73be5bc80e0448a98fc90eeefa722255,2,1,1,1,3
5806,8df2a0be2a1a45aab5fd9fd0055209b3,2012-02-15 21:47:36 UTC+0000,708fbff6fea94415a3f95a3c51403e34,560a4bb63dad4df7b9a81efa29c11231,2,2,1,1,4
599,8df35fd19ccb42a59fbb4e91c4abe8dc,2016-05-20 02:19:31 UTC+0000,6142b45e0f014064bdc8f55783876d71,08f4c4808d8e4eb1b9b287cda01beecc,2,2,1,1,4
1365,8e145d86504b4748b1daed9ab3131ea3,2015-10-06 12:54:54 UTC+0000,3b52cffddfb34c55b96b35b9d0184f49,7ab9f00a02b14e3da551244e54e56285,1,2,1,1,4
6136,8e16e6c4eca9400a9734cac0a39d70c6,2012-01-21 11:11:01 UTC+0000,50b6372b3e854d04b8517169c76973aa,2927388bfdb845b8837bd4d1f0d5e46e,1,1,1,1,3
2561,8e174ed5df1a4d2e87ddc6d1c8816f1f,2015-04-11 23:30:55 UTC+0000,3ebd9ada639b4794846e6e429c7a7140,9428eb3c67e540f3a1d3e5f2649656dd,0,2,1,0,3
3828,8e26b57b1f934acbadf99cadfd57a94a,2015-06-01 18:17:40 UTC+0000,47bcfed496784c74ad81b5a3f29c1f9c,a1006e6a58a0447592e2435caa230f78,0,1,1,0,2
3162,8e2d174944c8479ebff45fb09c88e36c,2015-11-17 16:50:14 UTC+0000,c1c737bcdbfe4fb2a78914dfc3b8e8fd,a1006e6a58a0447592e2435caa230f78,0,1,1,0,2
1422,8e2e9f9a03c44b6ab3e51a9b806f7f2c,2016-04-02 00:19:26 UTC+0000,b472dad4bf0c490995c21319cd108421,58fa5e95fe9e480a9349bbb1d7faaddb,2,1,1,1,3
3243,8e3dc3face1b480fa7ab564cad33e767,2018-01-21 13:12:34 UTC+0000,1f8343779168486c91914f59d89e7ba5,cbd8f30613a849bf918aed5c010340be,0,1,1,0,2
7003,8e4182f1001f454cbe49fabc26c36bd5,2015-03-16 19:52:13 UTC+0000,dbacf2deed7149db851004087e909fa2,fea3efb0357c441b832a7d7f207fb3be,0,1,1,0,2
5977,8e51dab89431406d92e4a290fbf8d7e4,2015-04-20 13:31:12 UTC+0000,bd0d238c2cf14a37b1c7899df74395af,53939a491acb42a4815463845a638186,1,1,1,1,3
3045,8e5c7cd7f37f4012a28e198d13110322,2018-08-28 23:28:11 UTC+0000,08e79feb8dd1448cbcdae924c36561a4,864ac974266843e383e3db26744d612c,0,1,1,0,2
6526,8e642f2dd1c246e8b1e2145fbd592795,2015-04-03 14:51:39 UTC+0000,d86e453b0fd84211a515107b6ca654e2,0895796423534563adcec1c208e9e0bf,1,2,1,1,4
3875,8e80594a0a5c47bfa734adac31e21e23,2016-05-14 16:30:08 UTC+0000,50c9dcddbf824452936ed73368a3f1c5,c3b4e11154f74a858779be7ba9b6f00c,1,1,1,1,3
843,8e809a87bd954718939b7eae1116dc91,2014-03-06 00:48:58 UTC+0000,40b847d75e7947d99563f8116dde5b4b,f8c639fbd3dc4ecd8c95bf2265943ce8,1,3,1,1,5
7914,8ea1aee744e04005b22de2aa54ccc598,2016-05-27 01:45:44 UTC+0000,7509dcbbbee14dbaab353698a59b0ceb,8c135c634fc14af2a15eb06303ca1f0b,1,1,1,1,3
4058,8eb2ece1a6d54f8ea9077d572ace556a,2015-02-27 20:10:48 UTC+0000,102e1deefd3249ff8a4d597828c8709b,52878292c36242328763dceaf8002e53,2,1,1,1,3
4525,8eb6ba7af57846acbfec5633e537192a,2017-12-13 14:39:32 UTC+0000,9a03ab0b0ce64067807a397e70b10380,dc76158aa87a4d6fb6bda6d2752216e0,7,1,1,1,3
4585,8ebe2e97ef7b47c9a763aa04a1b7606d,2017-02-03 18:36:08 UTC+0000,13c9e24360ea4eed88dcf98d1d34f060,96bbbdd06a334805a0501034d9df1aa4,1,1,1,1,3
3438,8ec3a3b28f76401d930009f68c8d74e2,2018-01-08 15:34:56 UTC+0000,17b9aad3e76242328cb85fa4f379f68b,cb5efdb6742143169de54ee11b9eb314,1,3,1,1,5
2770,8ec8d1ca4af1414296f8436cac8e8244,2018-03-22 22:28:45 UTC+0000,76876636adee42959d41166d2b3f6688,c24ab619d1a443b3baee9ca2e53f09ea,1,1,1,1,3
4884,8ec9c96928544f1a9a08abd4675057f4,2017-02-22 21:43:43 UTC+0000,e49ac6ea46684aa5962b9858a5b09107,9e0cb2a2914c4d05be76c85e7ca356a7,1,2,1,1,4
7796,8ee7328212ab453fbf07b8be60f3db01,2016-06-04 19:47:38 UTC+0000,df82d5edafa644f4a16f0f52334d8c49,b472644419d141c79fbb3b3745750ed7,0,1,1,0,2
13,8ee7f6c1417a43c19974840fbe753590,2016-04-01 20:09:53 UTC+0000,0b572712b25f4d60bad89786ea29c103,952b0614eb714566afcacadad3fa0e0f,1,1,1,1,3
7639,8ef0facafdb94dfcad13c4c912ed8d68,2015-02-11 18:06:37 UTC+0000,9acafbb44d814aa1b2d45dbae638f1bb,369f1c8646b649f6997eae7809696bd5,0,1,1,0,2
3286,8f046f70f6f6436d86661af5e7d0ee0e,2017-03-28 15:16:53 UTC+0000,92e225a60f18476c8722275883347c71,22bbcc474a9f49f591c5238b8b41dd4e,1,1,1,1,3
6182,8f0cf2e8db514f23a60c805d8d7a7ecd,2018-01-27 18:03:55 UTC+0000,c8fe605e5bed4999843c804804031005,97da3942e54140a5b8fd088267b7482c,0,1,1,0,2
6862,8f1fe1efa45e4b12ae2e3170751122ef,2018-02-16 18:26:09 UTC+0000,f46ce110d6dd45d5a828746ca48bfe12,b1759ef11fcc4fa2ad9a58f4d9d9b52f,1,1,1,1,3
2500,8f2d837aa5414e80a99a731fab8639b1,2016-07-20 05:11:56 UTC+0000,e6dec59fa41a4933a2f667b93e1df53c,469511d445a54bde93e944da3dbd7a9d,1,1,1,1,3
4967,8f3f34c0f0a14837ad7bece7915f55a0,2015-08-26 19:32:30 UTC+0000,cf16b48e7719401ebb99048e5d178010,a1006e6a58a0447592e2435caa230f78,1,1,1,1,3
1051,8f4352f1e3e242ca8c0b8cef21f4ab3f,2016-05-04 21:23:45 UTC+0000,c344e7f99dc94c10b6b3dbeeb6a311ee,c1c9567948464c71a90ad67627c8f070,1,1,1,1,3
1139,8f455f2fcdcc4aac902a4bcb8af6bbed,2015-01-09 20:01:16 UTC+0000,eba2a61309c34cd5b610c978f8146907,fdf1250e86264c9c834f7e78508a7599,1,1,1,1,3
2298,8f4695efc5614a8b9e3f4a19191df711,2016-05-27 13:29:54 UTC+0000,2a65d5d8b71a4ca0a5eaa350d9680d52,a5806385db1845cc996f66a99cc19dab,1,1,1,1,3
4178,8f4abb3ba9f746f1a0ecd9d09deb163e,2016-05-24 19:10:01 UTC+0000,e3a6f8df9dd54ff4b7c4a71932974b38,2cd87f827556435a8e4b903157ce0f77,0,1,1,0,2
3599,8f5023d82af6407b9b0a85734aad4c12,2016-09-08 23:36:24 UTC+0000,5e308766a88843e9b849f9e8720ed733,f3be7176d09a4405ae3efe9b8c38b94e,0,1,1,0,2
1168,8f5afaa6ce7c4b799b6c59b1f55514c8,2017-02-21 20:08:26 UTC+0000,a21cd70de7584e3492c9fe88161cee0a,4d7d5b262fc84b7e9c722d0989471b21,1,1,1,1,3
5461,8f6c116bf3ea42c8bbd929dce7ab6100,2016-01-11 16:56:02 UTC+0000,9f07e0b9bd464f698eea3aaebd9c9954,36ff3b3666df400f956f8335cf53e09e,0,1,1,0,2
5891,8f753a7f845f422eae9aa4eeff1ecd64,2016-10-21 21:57:48 UTC+0000,3f19940476ac46f0a49fd12d2ebb3c5b,58dc8847d1e649878b8bb712ca3134e1,1,1,1,1,3
1451,8f788de62c2f45778a0993a78754dd5d,2015-05-19 15:49:44 UTC+0000,cb4da3d701b543229fc03ef3ad2b3d1f,6458180042064606bda4ba880747ad5b,0,1,1,0,2
3524,8f8d90d88a9d4422abf1a6b15252431e,2015-10-26 19:01:20 UTC+0000,7f63cb45e3c340329491e9ccba8ebd66,6d3aeebadc6a403a814b2ceafd79862b,0,1,1,0,2
2822,8f965355e7e34ce4b65372b0570ad7b1,2018-02-15 15:46:11 UTC+0000,8866e5d349c2484fa2606f1989d901b2,1e88dcbc3c6f4535b1b356b3e21dde07,2,1,1,1,3
2308,8fa1023ffb51488f9f193a2c268ac0f5,2017-10-01 11:47:47 UTC+0000,9beab9c0c0434ad3b89571cadd92a435,75aa2ed8a80443968b6b7b41d6026026,0,1,1,0,2
3407,8fb6e7eddf5d465cb4ff4d5b714bc83c,2015-10-04 19:38:02 UTC+0000,4d89cb598fd84d55adf24e81c2d9885e,a1006e6a58a0447592e2435caa230f78,1,1,1,1,3
3717,8fcffc0cd0c54f24a94cca31e6e92bfe,2015-09-01 17:26:47 UTC+0000,624fbf76aa9e47089921052bf4431085,369f1c8646b649f6997eae7809696bd5,0,1,1,0,2
7213,8fd0616293eb49999b6fabcdc7a0396a,2017-02-09 23:39:18 UTC+0000,04c721ce95074e688937cde98d3869b8,3fe21cc053c54f279a93d933c49bee40,0,1,1,0,2
3231,8feeec1e4f25415aaeab76970141ef0d,2018-09-06 00:18:09 UTC+0000,8fa4cbd555aa4848ac8efd579d3ab2ac,f0717a8271674ff6a28748de7a9b9dab,1,1,1,1,3
1681,8ffd01ba45fc4ef3b7010d7155b90fed,2014-04-04 20:29:32 UTC+0000,33ff407eda03437bb45262e077b66c86,fe4543418c0846e5a65fa22b4ad9a304,4,1,1,1,3
918,9003eb433a434536960a0211561b7e39,2016-05-08 15:53:05 UTC+0000,b7322627733749368429a29c93db7f8d,58fa5e95fe9e480a9349bbb1d7faaddb,0,1,1,0,2
659,900a15588e114241b44621788b09a4aa,2017-03-30 23:57:31 UTC+0000,45e626f88d564c90b1e4d3288369b35c,e1d39b665987455fbcfbec3fc6df6056,1,1,1,1,3
4852,902f861c79044f47b7dd94883e669718,2016-10-24 13:29:08 UTC+0000,8f73da82442b4b6bbea3d792b86984f0,d67ce930870945109a7ad86d29ba2035,1,1,1,1,3
2798,904412208083411e95cb6f6a86e8fe96,2017-09-12 17:42:20 UTC+0000,e101e8ddf60d4e39bd198419df5517ab,1fad1619594b4a9d9367cd1413fd221c,0,4,1,0,5
4984,904cdc205a4145e0aa6302205a12d064,2014-03-17 21:26:50 UTC+0000,b13419a1b4724757b2d9c9df96b3d57e,78ee65a017dc4700a8286c649114137f,1,1,1,1,3
229,905f7efff64f4148b4188a43ae59ffc1,2019-01-07 23:42:55 UTC+0000,607f69c76a0b47f3ad18b1fe98b78ec1,c7393e32ae5e4adcbf965571bb250095,0,1,1,0,2
7544,906488670b4046deb34353a8289f107b,2016-05-19 14:50:18 UTC+0000,816036ed04fd47a1ab8b9e0786c5dcd6,bb629cde3b9141c3b0595de0e801b19b,3,2,1,1,4
582,9065c2b5f9f94357bb968acab3362237,2016-05-07 17:08:08 UTC+0000,6c2299060b4a4a30a42e94b0d1926cb0,58fa5e95fe9e480a9349bbb1d7faaddb,1,2,1,1,4
953,907839ae3ae04df4ad99b02c97f7cce9,2015-04-09 15:17:36 UTC+0000,ad1e9e16587642649af137e36ddf4fe2,369f1c8646b649f6997eae7809696bd5,1,1,1,1,3
7247,9081dbad66ac44f48c41d2c10540cdbe,2018-02-24 19:16:28 UTC+0000,b5e0c3b9c7494c64946dd90451c8417f,e6b29607f1504bc9bdb81783016df845,1,4,1,1,6
5391,9088635cc9444b7889b938ce82c9183f,2015-08-14 12:49:16 UTC+0000,f00e6f6013034c4caf2fd005e784ad81,a1006e6a58a0447592e2435caa230f78,1,1,1,1,3
890,909837af4196486f9e0a4bcba590e6fa,2016-08-21 21:50:59 UTC+0000,4d0b25bd35454295b4437223104e864c,58fa5e95fe9e480a9349bbb1d7faaddb,1,2,1,1,4
266,909f88301f744ff284ab0eb18edb2e47,2018-02-10 12:20:25 UTC+0000,9a6cc4ad50a44970987fe96f8e4541f1,c44a6a7eca4545c6b67cd5450758aaa5,1,1,1,1,3
6191,90b5777589024220a66d86d9cdf579ac,2018-03-20 16:38:56 UTC+0000,7accb1c795224394b4f52c2f5e3b9c18,79fb430fd8964aef80a70167f84726ea,1,1,1,1,3
5760,90c275232762418a97800650a50c96b3,2016-10-23 18:56:50 UTC+0000,865d111a649f4589a22e8ee1bdb7034f,a7a8e9fc6f0849dab3d825c39b22262b,1,1,1,1,3
967,90db4c86ac7a422c8a9a94845ccebdcd,2018-07-09 19:30:14 UTC+0000,1491549750504c9b84871f9b88fed842,fafeba89ca764bd891862fb8440a2962,0,1,1,0,2
3678,90e4522eab04410092ba4039bf979a4d,2015-10-23 19:58:49 UTC+0000,9640e0d03b2546d2903e9908ef7cc4fe,36ff3b3666df400f956f8335cf53e09e,0,3,1,0,4
4229,9105ec834ce04a7189a94dd361dfe121,2018-11-27 19:55:31 UTC+0000,019bb09b1b0d47db8957315d54e95b85,8d6d3604708c47be93014a2edfc589de,0,1,1,0,2
3425,910a4e9866b94201b999118509f8ef52,2016-05-08 18:23:50 UTC+0000,d3b795d2f8834fc7a9a9b4db1a462c9e,58fa5e95fe9e480a9349bbb1d7faaddb,1,1,1,1,3
3290,910f5974ed724cf49c66d46908eaa13b,2016-05-13 22:11:20 UTC+0000,b059b739a7bc4174aa031f73451f0897,7667c23d26ab409ca3e49758f5367925,1,1,1,1,3
2441,913a2558f1d4414baf59c3b46c8c5995,2018-02-28 02:19:00 UTC+0000,a1970491c0304186a2212be615b21630,3acc3867ec8b4cc7833f6ebb761a4470,1,1,1,1,3
847,91500ebf50404a0b84ff763404b56cc8,2018-04-25 01:40:39 UTC+0000,ab34f12626bd44bdaff5276e0aeb6649,b9d7800315c44c7382bf2046b99d4955,0,1,1,0,2
1491,915fe4a7ecb04325bf98042d72391e46,2015-10-25 20:43:35 UTC+0000,5aba5005e00f4d4cba845131a18ed582,a1006e6a58a0447592e2435caa230f78,0,1,1,0,2
726,91606e384e754f71a9e600b41a21a640,2016-10-15 08:30:12 UTC+0000,cc42f06930fd43d08cee1660b874af5f,b3dd5e04f0ad412ea7a6ec07c99248ab,1,1,1,1,3
1444,916882c6cd8e4b8db483f69fd4bda53b,2016-05-11 18:23:13 UTC+0000,0478cf7d3a194eb196e7c1e3f84b6e18,f9f7a40cc78c421a87ab8185c6d9078c,1,1,1,1,3
3562,917020d7319f40568e0859a565f3c35e,2016-05-10 15:22:10 UTC+0000,6be85209a31249a1994a1d2585a4650e,58fa5e95fe9e480a9349bbb1d7faaddb,1,6,1,1,8
2882,917f0d0bd0554fb4b7be252640585f99,2016-05-20 05:31:30 UTC+0000,ebf2afe56f834cfcbd95ba62cc0f6a92,06eebab6ea4f421daa1c7ebfb4467021,2,1,1,1,3
6898,91891a5fb7d44470b267140e40f59fd1,2018-03-22 01:20:19 UTC+0000,c00f45380c6e469b82398a7e4f48673a,949f1dbc351a498c85606d758ce6373c,1,1,1,1,3
5277,918ca95bf0e24f1b91b49b958eafd17a,2016-10-28 00:23:12 UTC+0000,a10d70b7a21540c891d18485f3e3a9a8,dc5a781ed30e46b6911acb328ba8f6d9,1,1,1,1,3
4896,919acbcaaf8d47d7999f4e902afa6176,2018-03-22 15:58:41 UTC+0000,894baa8171fb4e96b293e73361140650,d556298b902b4b39a2ba23f2520bdd94,1,1,1,1,3
5943,91a16cbc3a89423abbafae807238686f,2015-05-12 12:39:00 UTC+0000,1405d2c9d187436f9fbc98a1659bddd4,e644b51be2364df3aad4521bffef791f,0,2,1,0,3
6440,91a5acecbd0e4a4a88e51d0b29983e91,2015-06-26 20:30:40 UTC+0000,5f27e9f1045e4996afc601ad6b1e1f79,a1006e6a58a0447592e2435caa230f78,0,1,1,0,2
939,91acb6506b5341e48fdf15e5080d19a1,2015-03-31 17:10:43 UTC+0000,1d9b66ed621c4c7697d6c8ca85e91c63,369f1c8646b649f6997eae7809696bd5,0,2,1,0,3
5286,91b6529d30ed4bf9b6fe5427ce5263de,2014-12-24 07:57:56 UTC+0000,743df145a55147f385fc2cea5b5a85ad,d74c2aa30b0348a5a616738e131de76e,1,3,0,1,4
6204,91be06830d6f4782b28c6d3287ff2a77,2014-03-10 21:15:44 UTC+0000,c9af503095424a649c41ac42f318a642,564ef581bed64addb3cf0ff0ab652ffd,0,5,0,0,5
2763,91bf15a74eec484496efc1380fe4913d,2015-05-07 15:22:51 UTC+0000,4644fddc9d864f9799a2228259823697,fd3c391cfeba4a0f9bc36b7abc3d9771,0,1,1,0,2
5619,91c9a3e8c9104189803d4aad88f53222,2018-03-21 12:53:51 UTC+0000,90454090e1da438bbf0a40bbc0f896df,a9d8a9ee3a7f4f989a564476f9d666b9,1,1,1,1,3
415,91e888e77fe3464086f05528c849350d,2017-01-24 00:00:33 UTC+0000,dcef112510a9436a9f38b9fd60782c1b,b74860355dcb4cd7a24efc7e16427589,0,1,1,0,2
3860,91ed2c4e2ba64d40a8a421f3177b59c5,2016-12-21 14:53:49 UTC+0000,c892a53c886d4b9abc93ce5d2e38e6ee,0355aaad83704ad98e6d71b79db85849,0,1,1,0,2
4028,91fb08431237412681d67a3f09e47c05,2015-08-18 12:11:18 UTC+0000,fd3aeaf8a56643db8172b0aeccb0a6af,a1006e6a58a0447592e2435caa230f78,1,1,1,1,3
6814,92000e07efbf41de80b3345812e97c49,2015-05-15 04:43:19 UTC+0000,a53144385d7a42f09596acd850e9cbb7,9d3226d47179432581e4ff1944776cd4,1,2,1,1,4
5194,920600333541474685a5f1e055b84279,2018-02-20 20:58:53 UTC+0000,7b3e6e164ad9466fab4a7dccbdba3266,198904bd227846adb8ad7f548a44a4f6,1,1,1,1,3
7526,92231a787b16497d839c7827f979a6dd,2015-05-14 21:31:26 UTC+0000,894fd72b0f74486c9a4f8c921943fcca,a1006e6a58a0447592e2435caa230f78,3,4,1,1,6
3258,92385adb6064474ebee416ab2c365983,2017-10-20 19:13:59 UTC+0000,1abd6d60eca845aaab0cc1f60c1d7309,63fa2421e7fa4006ac029e92dc29011a,1,1,1,1,3
2068,928ca825eab441e8a82ff34530d75313,2018-08-14 12:43:42 UTC+0000,efe6fea5a8234cc694ec60495f2189cd,1cc76b22dce84cad9baa0d554c2bea26,2,1,1,1,3
3738,928da2a2f04d4952bc97b78bf32c75e9,2016-03-27 23:37:00 UTC+0000,cad02023c5594038ac251fc5dba53342,58fa5e95fe9e480a9349bbb1d7faaddb,1,2,1,1,4
369,9293e7e9c9c040df9e88ac76e265f5fe,2014-03-31 22:25:30 UTC+0000,e5ea62e061c84dd5b169aea0a01f877e,3409d2ee250545558ea03bfdfd8da22e,0,1,1,0,2
1068,929a07cfd0894eb99d92e1f4134c36ff,2012-01-09 23:15:45 UTC+0000,d6cd63b357e34d0ab61fd45eeb5ef8cb,e14d5241d10e4ea8b8e461ae6f41963a,3,5,1,1,7
8026,92e0723bdc5443f7b61bf96d53d21f36,2017-10-09 20:56:19 UTC+0000,e0e104c62cf0478d8c2649863e3c6a00,d7f9afe721af42b1a03a993909e0568c,2,1,1,1,3
5396,92e1c54ec2ea4711ba3ee9d02e6a6f00,2016-09-13 12:22:39 UTC+0000,7c1107a64bff4e7e9a93a1d7127eed88,58fa5e95fe9e480a9349bbb1d7faaddb,0,2,1,0,3
2819,92eaf4e50a1f4ad1b9af543eafc5430d,2016-07-29 00:09:49 UTC+0000,affabbf0a4a7494fac3dd57d27511be3,0489e08c398e46e2ab7a8e9c6fafb7d4,2,2,1,1,4
5366,92f2a1600bf648acaaf272c1ee6ab9f1,2016-05-25 04:38:29 UTC+0000,e0d2e47bafa441d19c870b429ba91c1e,51129cd9c6ec4f2fa1825eaad9d87735,1,1,1,1,3
4067,92f670140bca44b792f094af7053b43b,2016-05-15 15:31:56 UTC+0000,6d9bdf7d2b3742c5bd4c7b3de3e980d9,2356a99867fd4fb8a01b2cb60ac7617c,0,1,1,0,2
5033,92f954ce91f54255a0893cae8ebba65e,2016-05-04 21:33:40 UTC+0000,c0488c76ad4f4ac681e7793221593d76,c1c9567948464c71a90ad67627c8f070,3,1,1,1,3
7371,9301deeabfa94d34b360e5924a0a9987,2012-03-01 02:53:56 UTC+0000,b623cd88e429471da5907fafcc1d1a95,392a273cb57b42389ec01a8fcdaff3af,1,1,1,1,3
5137,932c9c5816074946a37da02acc04575c,2016-10-31 20:26:28 UTC+0000,10f0f5ae48194b13b3d8ecfec519b74b,8aa7ba4c38aa4a2e88872c1fdad7d068,0,1,1,0,2
1796,932da6c988d14b7095827e07464a473d,2016-10-28 00:20:14 UTC+0000,54709b6422474ee0a3672cc3881f4536,dc5a781ed30e46b6911acb328ba8f6d9,1,1,1,1,3
2278,93335c084d484dd09aa4f67554a83034,2018-01-24 23:41:42 UTC+0000,933fde37fc744bd688b888a713edd473,d7f9afe721af42b1a03a993909e0568c,0,4,1,0,5
7736,935e434f460a4ce59c392c6839664457,2013-09-25 21:04:45 UTC+0000,a4b11cad629d45caae4cbecc845fc562,168b649125b54d6c84f9f5fc1f4033a1,3,1,1,1,3
14,9363afff32194c019531442ede664a4b,2015-04-08 01:10:42 UTC+0000,9354bb1647d74b51b929390cb6bc639b,198ab88e6873420cb781f1c7f041c1cd,3,1,1,1,3
4435,936acba74b32419ab4a297f817e77528,2016-05-20 22:35:07 UTC+0000,b1e9a2cae4324099964a8b399f112a56,b7873ad20efe4ce9ac6926424becd33c,1,1,1,1,3
3851,936c694a9b494e91926bfb8a5ed3e727,2016-05-16 17:38:24 UTC+0000,e6c07aa6ccf948bfa000e59108aa6f2a,04df52cae7db418faf5f9b285799ea5d,0,1,1,0,2
6709,939469ed00c842f790f0092a64df8a0b,2017-03-20 02:54:18 UTC+0000,22cc53a9569a4abba874ce79f6f7a700,8136c8653d3a4895b49cac90b88120d2,1,2,1,1,4
6482,9396e4a4eb58497caee38a867af0c514,2017-03-17 12:29:11 UTC+0000,2af7b1a9eed94b728a79a03436037806,36ff3b3666df400f956f8335cf53e09e,1,1,1,1,3
2971,939b5fde787b4c4d94f34422834b3ecd,2017-12-14 08:36:15 UTC+0000,cb3be84c0bc94b538354e8954b788e1c,4269d6f3d21741b186048455bd513b0c,1,2,1,1,4
4334,93a5d17fe8ad4ee59727d22244562a50,2017-05-16 19:30:07 UTC+0000,2f362d589ead4214bbcb479f8b39a30a,b5696c6131924f889efbdc6e8cf40bf8,0,1,1,0,2
6666,93a6fb98b00c4ec3b7b1a2d7404e7eba,2016-05-05 02:56:26 UTC+0000,6d4f8b69ea154a048bd38543b5d87478,4fd49d7ac3ef40b086bd90e09bdb0f68,0,1,1,0,2
7384,93b5c8bdf388466b9e8f8d8f57376a0d,2012-04-02 17:23:14 UTC+0000,483ed3f53f05429a9c045a42fdd1d60d,392a273cb57b42389ec01a8fcdaff3af,5,5,1,1,7
2271,93bdf520ccd44a809592dc1ce63ba059,2016-05-29 03:02:56 UTC+0000,1bf524d6ae6a4560a419c0f1f9b7543b,08f4c4808d8e4eb1b9b287cda01beecc,1,1,1,1,3
3297,93e12a0bfaba4f6b82f06cf648bc2120,2018-01-23 17:39:32 UTC+0000,a5b31c160c384747920424ff6ba1f4c9,4d9079c15bd94726b57d4ebdb63cc0f0,0,1,1,0,2
7891,93e2009fe0934be9bc0aa04695ac9b70,2016-08-14 23:05:00 UTC+0000,d490587bda5f4b8bb3700bae0bf54b7e,34df64a2783a4623b22b4f3afff97d28,1,1,1,1,3
1322,93e5e8f3813843e0972b2d6585fd0f5f,2015-10-26 14:51:58 UTC+0000,6f60ad490f5c4fd8b5467d0213b1294e,c1a24b8f746b47488da02a0e5044a7a9,1,1,1,1,3
2048,940af067ae644df5ace230b26ce5a121,2018-03-22 11:43:09 UTC+0000,9bfc88a39b2148fcad874fa36d57fd7c,ad867a83ba3d4e6c91faa398a37a699b,0,1,1,0,2
1710,940d0030053a466ab37400f4bf9cb839,2015-01-21 19:38:52 UTC+0000,c78d23cf5a914604959a016d696cdce1,ba5cdfeb591441788104f31fca40d5ba,3,3,1,1,5
6438,940d78a9a0784321b61d97256c31468d,2015-11-23 19:56:19 UTC+0000,059daa6e2ffc46c8a1f5a127714decb0,a1006e6a58a0447592e2435caa230f78,3,1,1,1,3
3366,941802cf59f9486c8a7914f676bee967,2015-11-25 11:34:29 UTC+0000,4bd901157bb94838930f92474a94f2a9,a1006e6a58a0447592e2435caa230f78,3,6,0,1,7
1584,941a5dc350d4490f932db49ba7bf8458,2018-08-22 23:07:03 UTC+0000,95172a0b603145d9ade3928908cdb8bc,582ac0c7ffe8417e9eadaf11a056f431,0,1,1,0,2
458,942627df4ce044fd957a2e72a9b43e78,2016-10-13 18:27:15 UTC+0000,c4cb50e1d6b04eecb15ae840d590a4d2,4fd4c181339d4392be3c665cf68a5965,0,1,1,0,2
1510,9436496d04c3477d96d38246b38b5193,2016-08-15 23:31:54 UTC+0000,0a62918611c4499890ba890d4565d051,4bb5bf1800a64eecada0928ea27d090d,0,1,1,0,2
1440,945b3d447fb94e15a9bd526ac8d33c39,2017-01-13 14:58:28 UTC+0000,220df36d0e424d8d81b36a3d76744110,32c5b4ffac524531a64b161442a64510,1,1,1,1,3
6838,947f1c489ca84bab84edcd34b17ee2eb,2017-03-06 21:18:24 UTC+0000,2b1405af03ac47248ca1b8b39d5c5ddc,36ff3b3666df400f956f8335cf53e09e,1,2,1,1,4
5438,94893631689a4b518906af5d8e4bc258,2017-02-05 18:12:15 UTC+0000,30a80f93f2ae4d6abf03ca85006daeb0,d97aaa6b7f7e4b1e9a6d65d5a0958183,2,1,1,1,3
6568,948ae4b121e04750aa54579de2a62d58,2017-03-08 18:57:13 UTC+0000,f772af5d3e344db38d38aa11ebdfe82f,96bbbdd06a334805a0501034d9df1aa4,2,1,1,1,3
4352,9498fd7c3c994c06ad1e16fab1e2a89f,2016-06-02 14:12:51 UTC+0000,16209be10a274fb2b86aa4e935cc9f37,2e0e85c9b38f44c9be0e0834e15c1894,2,1,1,1,3
3675,94a2f4d6351847ea946cb851b369d467,2017-07-25 14:05:09 UTC+0000,9dffbd2c3ffd4f04a317bc22f0cc71d3,8b931f8161304262ae22acef97c2c75b,2,2,1,1,4
6758,94a4257e41674145ad0940e39279f2c9,2018-03-20 16:40:23 UTC+0000,13c5cd7879fa411d8002b67c8ee99592,2c003ab1aa8e45c7b0e8fba3f01fc29a,1,1,1,1,3
3481,94bd742ddab14951ad24a116ad70e4b8,2018-03-01 18:12:54 UTC+0000,2640fa004e7b4b35b96edb4b0f55f0f8,cbee94c02b4841a0ba2d5dae91043ce4,1,1,1,1,3
122,94c58241962c4997adb4fcad89045b56,2017-01-25 13:08:34 UTC+0000,91d40ad0bd814e289e92054ebeb70fcc,cdc48d26d62049a0b99d73fa4f75245a,0,1,1,0,2
4106,94c61cdd836c4ec2ae3cf4b10b4ec70f,2017-05-08 15:41:22 UTC+0000,a976648d033444159309bb2dbb02de1a,89aba19f6aca401abe9a9ffccfdac1a2,5,1,1,1,3
4742,94d0385343994415b81de69f9f33ec8a,2016-10-09 00:46:25 UTC+0000,bb6a4c0d3cd84bb2ad362167c7c040e2,cc49ef2285724342a4a6a9595e66243d,1,1,1,1,3
2885,94d49973713e4c92ac50de4d22cbd3b7,2015-10-26 06:52:56 UTC+0000,6ab3c2057e334ec389dcb83cefbd9aaf,7bffa1792d474359b922e5de700d7a82,2,1,1,1,3
5059,94d80a0ecc3048b5858ce18a03c649c3,2015-11-02 18:36:10 UTC+0000,3e4e3bbb7c974261a8045b287a9c3121,e4e7cc05a0b64cd6b02168d404a45d4f,0,4,1,0,5
5016,94de354eca40482ab4af9939d14c97a9,2016-06-02 14:10:21 UTC+0000,b8affb792a1e4f109d147d12fe0031a9,2e0e85c9b38f44c9be0e0834e15c1894,1,1,1,1,3
1918,94e053c0fcf344f0b8dddb139bc5e014,2016-04-17 00:11:51 UTC+0000,f566f2234ce24b86973481ec76830755,58fa5e95fe9e480a9349bbb1d7faaddb,0,5,1,0,6
5055,94e2c37aecc344fc82eae85aabb86c74,2016-10-04 02:38:52 UTC+0000,4aae991be661478aa0a536df1bec70e2,4e8c922829234a2b8d9406d3546be3d0,0,2,1,0,3
6519,94ebe18a813945049b6cfa05325c049b,2016-05-17 12:24:29 UTC+0000,9f85cee26b544961b3c917b126f1bbd4,c7913fb2bb4244ae8948cda75ccf7a8d,2,1,1,1,3
6418,94f17af3e60447bcae28d635a4cf0f21,2017-09-05 18:43:08 UTC+0000,6831514417d04e5ebb5979c7214e93bb,729ab1c23fce471ca1bc3741bbbbdeb2,0,1,1,0,2
1548,95039a08769241e8a1403a124f447c42,2018-08-09 00:23:07 UTC+0000,87669d092f814ed4895669c24969a525,36ff3b3666df400f956f8335cf53e09e,0,2,1,0,3
7823,9518495dd30a49e6bb4b25abc5411e85,2014-05-04 21:52:43 UTC+0000,1e43009d3ade4a3e978f3b2d9f958adf,3d8847ddc8d04185976a9e78b190ebdb,2,1,1,1,3
6559,9523583306b4460ea46745577cf23fad,2018-01-30 22:54:27 UTC+0000,0b6ef9acca7f442d8e1d7945edb6cb33,c0995c5462ed467fa94ebc1ea8cc4592,0,1,1,0,2
299,952861b3037f43e08093f3166b54b934,2016-06-05 22:45:59 UTC+0000,7a30fe3db2a34d309358902773384224,58fa5e95fe9e480a9349bbb1d7faaddb,1,1,1,1,3
1517,95587aa24f73477391f2e614b5439d31,2014-05-01 15:58:50 UTC+0000,0444026520d846af8c74e7e75e00d674,fe4543418c0846e5a65fa22b4ad9a304,5,5,1,1,7
5881,955d4994e512413796232a443f5467d1,2016-05-30 22:49:53 UTC+0000,dd7f6908b6704076abffe424be983bc6,83cfc4f44b9d4fef8cb95530319d8b53,1,3,1,1,5
1525,956729905ca645c6a559bec172b6d2a7,2016-01-11 22:33:40 UTC+0000,027005136c164646939e815ca17b8ed2,c3b1c9bc3eaf4a48a57990956d8ac30f,1,1,1,1,3
4189,95775de6dbb04686956bb84f2cf30a9a,2012-10-11 19:29:39 UTC+0000,1103b7d2923f4497acfd958f22ff486a,8442ddfd38bc422fb4677785db0630e6,8,1,1,1,3
43,9597ded3fbeb4bff8aaaf81401e410ed,2017-03-16 20:11:05 UTC+0000,d4295d78b7fb4e87b29ed1b839d8626f,5f95b0ac821e4e8e9b4fa9fc8eb9ff61,0,1,1,0,2
7734,95997d25a56f407c995f4f9047202d19,2016-05-12 16:47:56 UTC+0000,094ca430569347faa340fa266559d8e0,317b35d9099e4f38a3147c514c1db691,1,1,1,1,3
881,959da5294c8d49398399890d6afb1c0c,2016-03-04 16:05:08 UTC+0000,e19e86cdb3154eb88a731c172ed9be3d,1972751ff4ba4c38a4b53cee74a600a7,0,1,1,0,2
976,95a62a745283418cbf38b18f0a44663e,2016-05-13 17:29:23 UTC+0000,730e22cf66cd439e9e594c33fe5ae6a8,3166cc28dcb84b73bee485ede7d07dea,0,1,1,0,2
1127,95b06f6b474d4335bcd5e15396f117bc,2012-01-09 13:51:11 UTC+0000,2f5c0aaec1db45d5b69d1b048cde81f9,c79d4e4fd9af4ab7a7e6b6f433128476,3,1,1,1,3
1551,95b338c310494d20aed76962d7cd1788,2018-02-15 20:46:18 UTC+0000,b90c2590f954420ab99e4c1cd940b69e,44dee277555142319fea07b40de0634a,1,1,1,1,3
1172,95b5c115c71c40f799bc11fb7de9a8ae,2016-04-17 20:43:43 UTC+0000,de4f237f34f74c3786df6e8b98423f53,a1006e6a58a0447592e2435caa230f78,0,1,1,0,2
5349,95b65f275e524b5fa1845d65a64b03c7,2014-04-30 02:09:29 UTC+0000,9100a02075df49a0bafd8b2a15d0e24b,2de6424897f6469b8a5598bf18124fb2,3,7,1,1,9
4963,95b66062d0964cbbaa5b82c67ab89fff,2014-04-08 14:21:36 UTC+0000,0716740650864f479eb43e1054ab1b51,a5806385db1845cc996f66a99cc19dab,0,1,1,0,2
197,95bde6ff6cc145b698f7421a015775ac,2015-02-19 22:41:03 UTC+0000,dcd09b7b79a44b31a8f3aff40630eb54,5fdd771b9fed43d9bb7a0730c6d4f3fe,0,1,1,0,2
1040,95bf68bdb91740c7a0590a139f110133,2016-03-17 15:09:19 UTC+0000,e203e01ecc6a4fb99ef01b772fe7daff,e9b42439feac4d399a22e480d0391e59,2,1,1,1,3
380,95bffe59a34a48409b06fcdcf9d8d1c4,2018-11-14 17:33:08 UTC+0000,c05f7ba8d6164396902dc40472c4d5bc,16c29c8e458a4857b1688259b6d458f8,0,1,1,0,2
3589,95db1004f3d34ca697ec3501983e7b4c,2016-03-08 11:51:19 UTC+0000,75ec9300c3c24b88b12d6b5d21ee649f,7197b8bc171241989c50e1ac93836947,6,2,1,1,4
3748,95f701a2a35047a89d5e8e00cef50088,2014-10-21 20:51:52 UTC+0000,b4fa6a5d81a0469c88fdf79222b82693,dcea3f9e1a554c099f8d08e9d139d195,2,2,1,1,4
3023,95f9dc5371d04cd2a2a61e5e35e8fe5a,2015-04-02 19:47:30 UTC+0000,96d0dac916cd48b0a8c52451683f5317,2c285600a07f43508baefa37cd53cc02,0,3,1,0,4
1518,95fc985647744f5eb7011ff1c5cfa915,2018-10-07 00:08:11 UTC+0000,1389c59e4f5c4262a3417f5ff37a691f,36ff3b3666df400f956f8335cf53e09e,0,1,1,0,2
3180,96008f42454a402e8d7ce6ce2e10370e,2017-01-26 18:25:45 UTC+0000,1c1771bc392f4f598f055a1b734b314e,5688325ccc864f5fb814dbb388f83411,1,1,1,1,3
5381,960bf04989d540918643377e59060893,2017-06-23 01:55:20 UTC+0000,10828ee4ade040f8882e6506edc63aa9,ea3e0da0337e46daacfbb7bdb123f223,0,1,1,0,2
7476,9629f2079297445ab355eb2039308610,2014-04-06 02:27:36 UTC+0000,83c10b3e47344c4187bae7e78f0e72d3,fe4543418c0846e5a65fa22b4ad9a304,0,2,1,0,3
6912,9632052f6dae41b2b93817e3951fd6d0,2016-04-17 01:24:04 UTC+0000,5e12d6873c004b39b26876b476b258a7,58fa5e95fe9e480a9349bbb1d7faaddb,0,1,1,0,2
916,964d42069ab748b2b37e95e9a541c226,2016-09-06 11:28:06 UTC+0000,d09d7b8d694d4e469f50ab5880d79ae7,36ff3b3666df400f956f8335cf53e09e,1,2,1,1,4
3160,964dd016ee694f7ab97281eba6c41932,2014-04-07 16:37:20 UTC+0000,9994509e0e0740ebbfac6dc72d201fea,2a8328f6ceb548699a64293f986f3d19,0,1,1,0,2
4406,9653232195684c3d8b9e29eac0edbed7,2014-01-23 02:24:59 UTC+0000,07b5f576156d4dbbacb41b128b3e14a5,331c075b95c74215b0435818457f0324,0,2,1,0,3
4167,96545bd3c140401abf1aa284c35a3efc,2016-05-10 20:50:37 UTC+0000,6ffa0ac03b5d4660ab4e62a3120dd409,58a4bfd0d3444c7e8053294f3be96dbe,0,2,1,0,3
6064,965f146298bb4654983c1381517cf728,2017-01-05 23:25:08 UTC+0000,0372882469fc45689cf2f837fa2a0e78,198de0b90ccf4d809a10205fd41b5523,0,1,1,0,2
3884,966b4b692e7e4113a4e0071563e665a5,2015-10-29 21:14:52 UTC+0000,c125f69f43554724bb7c3225afa36361,36ff3b3666df400f956f8335cf53e09e,0,1,1,0,2
1000,966defd73b6248a79e512f3913f1ede3,2018-04-18 00:23:11 UTC+0000,24281a5ff0ea46c0aed9eaddff522332,36ff3b3666df400f956f8335cf53e09e,0,2,1,0,3
6653,9678874ac64f4c61be1103f34627e27a,2017-05-10 18:20:42 UTC+0000,77e5c137cb7245f38993fac3ba65a19c,3136e73b49cc458f8dbe52522abf823a,0,1,1,0,2
6161,96c03830ce894f92803094e151fd6148,2016-05-09 10:54:00 UTC+0000,00f3f3c3e006499c95616fca8fac7e05,e95e6d0fabb1401c8f32a433cd29c369,0,1,1,0,2
913,96e2d53761c84cdf9fe2bdee4149409d,2012-10-01 03:52:04 UTC+0000,624e8f672c79466b8a3bbb85c7d1c47d,560a4bb63dad4df7b9a81efa29c11231,2,3,1,1,5
4169,96e8bec918864219a33aa8923fa7689b,2014-06-06 18:05:35 UTC+0000,d50b270859494bfbac20d5e048e15336,9eb5b915f61844ac9a9e1d8eb6f76df2,0,1,1,0,2
2683,96f854c3cda346d6b1ce2e0439e71ac3,2015-01-24 16:14:35 UTC+0000,bb0094c5d31049f48ebebe556599407a,ca520a7f0df34ced8ab5cf25c8e0a2ee,1,3,1,1,5
1683,96ff80ac134f4617bf5ccbe3fbf956f1,2019-01-22 23:20:15 UTC+0000,7a144ffc39844b6bbf86fd6eadc9b0ad,a303c1c4faef4adda38fcd4c0d2bade1,0,1,1,0,2
2630,970159c1e234413f82e5ee9dfb0dae64,2016-06-22 20:05:14 UTC+0000,622b58edff394c938f6d909a9f2811ab,48e71c06a7fb4202b88c813489329093,3,3,1,1,5
763,970e699cbc674460b849e7dda615dbed,2016-07-08 19:14:59 UTC+0000,fd205475bb1848eda315f4ed18cc1d02,a1006e6a58a0447592e2435caa230f78,0,1,1,0,2
5067,971b24f1e0904c7583bd0579384ba37a,2015-10-27 16:28:33 UTC+0000,83cb1b4f1d444ab8949c939d4b533b23,e98bd839b4f14cd6a3fa1cd9833d44be,0,1,1,0,2
7509,972fc2a19b2149b18d6e3a87e3c3d661,2016-05-01 19:17:05 UTC+0000,7c59dd4cf0064c7b9c2b56cc7f1a7436,36ff3b3666df400f956f8335cf53e09e,3,2,1,1,4
7439,9735138e687240b7b862825d13655a85,2016-05-20 02:07:15 UTC+0000,6e860e70338d411997862540f0153629,08f4c4808d8e4eb1b9b287cda01beecc,3,1,1,1,3
3400,9738d9134ed946e7b3695d12fbd0f96d,2016-07-31 03:34:52 UTC+0000,188759b9a92c4388864bfb5c921097fc,2c308b05c3ec41f7953bdff1c9464a60,0,1,1,0,2
770,9747ab12d8c34757a8c1d0cb9f2304ed,2015-10-24 00:23:58 UTC+0000,09911177cc944389a80eb3b259b9325b,4b7737cb8c46400795bdba3a4f333997,0,1,1,0,2
6145,9752199108e340698fb4889c9d91ab1b,2015-10-20 02:08:08 UTC+0000,01c9c3c38a1d482d843e59d0b0f5feb7,2fce3f29292d43f687b0b677e1551f3f,1,3,1,1,5
822,9756b18429324b0b815564e44afbe5a5,2018-05-10 21:31:26 UTC+0000,ae98d9fede874749bdfef397e6b20236,a6d33c38902546849c36ea7e9e9f0870,1,1,1,1,3
262,9759be3e50b845e19865e7b5d5e200f2,2018-03-21 17:47:05 UTC+0000,b5a2273d519d4d1c83a36d7ac7f18946,cc0ef2b535894a77a92cc740be6c2513,2,1,1,1,3
4138,975ae52210d44a36a3fd0ae9ac91bcee,2018-03-23 06:51:03 UTC+0000,be16df84ff514a399ce3232af7f56049,6a388a0aecba4e25a7c06cb389577386,0,1,1,0,2
4263,976a97e9d52f4722becb6953eac78f67,2016-09-16 18:07:06 UTC+0000,17391c58baeb4bbc939525bf9d04ca62,53939a491acb42a4815463845a638186,4,4,0,1,5
2859,977690d4ee01408ba4e46f8afbf3f105,2018-01-24 16:08:44 UTC+0000,f9bcc1fc3db74a2cb5467bf42a47137a,5ed76ac8560746fa9e57150dbafdf4ac,3,1,1,1,3
4588,977fce838fd54a78bd13abb404db07e5,2016-04-26 03:29:20 UTC+0000,a06ed2d6bf10483481678d4b57875a56,90ddc3c0cba54ee28958e064c7ae9eb1,1,1,1,1,3
6343,978e7966118a45b2b16d9be66b0a61e3,2015-10-16 14:27:31 UTC+0000,4257922b8dca44d7b6f08b351203c44b,a1006e6a58a0447592e2435caa230f78,0,1,1,0,2
1326,9799cdd525db480ab91e36a458a66d7b,2016-04-20 22:43:23 UTC+0000,7966adda2d61423ba7b0d5583f8dda96,7919ea19db274c1fb862f3456cd25ac5,2,3,0,1,4
6238,979a50e3e38f4d5e9838af755125bfa5,2017-04-05 22:32:10 UTC+0000,ac10772001894bfa953af02a8e6a700c,5361e4e6be2d40729ec52dfbd5d5ecd4,3,2,1,1,4
4345,979a91e84ca04d14acbb3711caafd81c,2016-10-20 13:00:49 UTC+0000,fd37e85d8c194a5ca511ca7d6fff3b3e,7a9c69dbc1d54ce4a35b77328996c4d0,1,1,1,1,3
2445,97a5464c4f034e22ab2c8941bc87c8b2,2016-03-01 21:34:53 UTC+0000,d63971f91159435ea9cc043680313900,96bbbdd06a334805a0501034d9df1aa4,1,2,1,1,4
3867,97a5a7f49a474e75a147af0a74d4f18d,2015-02-09 00:21:17 UTC+0000,667d6036bde54f17874072265089bd47,072fee1551324584af69f246b444f688,2,1,1,1,3
5359,97ac01b5f4c5435da883db2bb4d463d7,2017-08-09 21:29:14 UTC+0000,7b90229184914b9194c34b92b0145735,132063ca9d9946cb927ca7cd3b7812cd,2,1,1,1,3
936,97b2ca0f748643a98baca4fb515d8cd5,2016-08-24 00:20:53 UTC+0000,a01852b3e8554663a6c24a53394dab7b,50d1429c5c6b44b59e581b53c92c60b5,1,1,1,1,3
2524,97b4fb50cd944beaa00f9b5fdf732825,2016-07-30 23:16:57 UTC+0000,c3c131431d744fad969821c44488f0f5,36ff3b3666df400f956f8335cf53e09e,1,6,1,1,8
1978,97c4331fb9b342c5af5f8e81798128ba,2016-07-23 00:22:18 UTC+0000,6dab8d68fb42445193d7af9b14b112e3,bb2cd1cea205452c94a3f64187bd0173,0,1,1,0,2
7501,97c4fcdb16274e5abb236c193add7c3b,2016-12-22 05:31:18 UTC+0000,4531055fc92049b5a28c6b17a3a67688,4f3f080d728144d9b57a72f6533101fa,1,3,1,1,5
2977,97ca2aaf658040eda315003d4981a96f,2012-05-24 04:37:15 UTC+0000,0b7a434694c047eeaeae81cc63f2e0da,9c5803ae43ca4cf6b27ea85871625116,4,2,1,1,4
2202,97db65f3bbe44856b07dad91b5516c9e,2016-05-23 00:09:01 UTC+0000,e74d9362884745b782fff1bdf7a4121a,bc46e3699d92477ba8c7aa723e54a151,0,2,1,0,3
6887,9800d522e0164c7d946db1e2db118bc5,2014-04-08 15:51:45 UTC+0000,0280b06cf4eb4f1190017e44bf1f7525,a40408127b504ab8b89118eaa328a0be,1,4,1,1,6
448,980f069e9e13404eab444aa1d687e4d3,2017-03-11 07:52:01 UTC+0000,fadd7d3975784008907ce7bc53d1913a,0d4cd29c55c64547b0488a9cdcb218ce,1,2,1,1,4
2541,981cbabadc1b402f89f26875d4a06698,2016-12-21 20:53:46 UTC+0000,79a4377d670f425c89f55a9d2b30623b,36ff3b3666df400f956f8335cf53e09e,1,2,1,1,4
3355,9822fddb826c497387da2501fc6be8d2,2012-09-09 20:08:16 UTC+0000,12425808ef894574a149c7147bad5efd,4a71c85e58dc4c1a8546574188582a92,1,1,1,1,3
2357,98312c499e244f35b5e5cb245822da6b,2015-06-24 20:21:01 UTC+0000,fb48bae24a5e4983b480e743e58351fc,369f1c8646b649f6997eae7809696bd5,2,7,1,1,9
4179,98322aaafe6e4406ac0a0330446d8eae,2017-03-03 16:41:19 UTC+0000,22ff7924bfa74d68b0ea0075040041fc,369f1c8646b649f6997eae7809696bd5,0,2,1,0,3
5983,9832580c5f0f4d4e8cf6e897fb4b3166,2016-04-28 19:13:56 UTC+0000,f01641568e33430187dd74c33ca7c90c,dab1ccb54ed44b9dada34f70ae039814,1,1,1,1,3
6373,983b9b22486e49c1a31582ed5fcc16e6,2018-04-27 19:01:02 UTC+0000,3619994d2e4f493bab7f0f12c702e026,4e173862084b4c5cbbd8b7a666bdbc10,0,1,1,0,2
413,9840059737e14d228718455219d26b0b,2016-09-12 19:14:49 UTC+0000,5cdcbdac55b147f7a2b3466eb110e66d,a1006e6a58a0447592e2435caa230f78,0,1,1,0,2
7634,98545fb5022841038ed4bd2046e19772,2016-10-10 15:26:56 UTC+0000,d0f166b1ef094f28b60cd00f3f59a984,e0375e2a3a354088aa36762cae83d2c2,1,1,1,1,3
2078,9854823ad40a4ed5b011ace944824e82,2014-03-17 16:00:15 UTC+0000,c1f74904f4dc43dc996242acb5270974,18237fb03c8d4d368085a5dd67c5307e,2,3,1,1,5
2085,9861ca2107ec401bbfa8f96faf3b2efa,2014-04-08 23:42:08 UTC+0000,e15202accdcf4d9a926db230a24e168d,861fca48f47c4fccae43a799f4442684,1,1,1,1,3
3399,987d2c47fe3f440d9ab19676538090cd,2015-10-22 21:36:18 UTC+0000,781dbbca3a524c3aa756390889c9cd68,721c6bf35e2e469c8d93aef5a67c70c3,1,2,1,1,4
7877,9881d23e2f774c4e8662b2f44b9196ea,2016-05-24 00:41:33 UTC+0000,c2ef6ba91b4e4c6daf8491d676c87d3f,eb15c50494664ea18365288a779271d8,1,1,1,1,3
6894,9885a7e4a5be4a05a927211141234ed9,2017-04-02 18:53:58 UTC+0000,dddf8250f0224295bef2cca0cc102166,a1006e6a58a0447592e2435caa230f78,0,1,1,0,2
38,98b5ebb2fdf44368aad560bddd2fb286,2016-12-02 23:31:40 UTC+0000,c1c88a51eeea46468095b8bef6430bc3,58dc8847d1e649878b8bb712ca3134e1,2,1,1,1,3
1735,98b82b8dc86f457f8f3d6034cb18e265,2016-06-29 16:20:23 UTC+0000,2ea17bdcea594b66922172084504c92e,a203d27f5d054ffd829771ac7a2fe4a4,1,1,1,1,3
4656,98c312d5620d41bb911aa93a2b2d58ef,2015-04-23 11:47:24 UTC+0000,12a5d79805524bfc92d1933ab1292101,4da94e5295a8463b93813b7be8570712,2,1,1,1,3
3894,98dec2fa73754c37aeaca934fa08dbbc,2018-08-20 13:14:02 UTC+0000,67677ad45d7141a2af9df7936f8ea0e5,36ff3b3666df400f956f8335cf53e09e,0,1,1,0,2
308,98decb0600804b4e9feb0a5ed7f81acc,2017-09-03 11:32:32 UTC+0000,6504ad33bb6e4b5f89088e23d4ce4715,5b9a933fa51040ab965b93485680657a,4,1,1,1,3
3960,98e2803fb6a94260ac4661d6d88f8425,2014-04-26 04:18:01 UTC+0000,d2150e7ba34c430ea9e4c8a75359e994,fe4543418c0846e5a65fa22b4ad9a304,1,10,1,1,12
22,98f462102b634902840e23e0d42de36d,2018-01-19 22:06:22 UTC+0000,55b529af80fc495793763a7241ed4858,8e7137fafc1d44cdbe075e4f07b79e39,0,1,1,0,2
1438,98fa9b6763c24464843d946ac6dd3029,2016-08-18 20:11:53 UTC+0000,8c51fc834a3e420981d599bcaa1faa06,a1006e6a58a0447592e2435caa230f78,0,1,1,0,2
2757,9900d82e0f224c8284a14cc61eb695ff,2014-12-15 16:01:17 UTC+0000,9b41f10ad7d148abbfad37f06b53a851,8526230b44c94173b69d71d5d2faa161,0,3,1,0,4
3498,99012fd853b14ef983690f613804a4c2,2015-08-06 16:53:29 UTC+0000,87f656d2dede40348b278ecfc5ec3327,05444a2f42454327b2ac4b463c0adbe0,1,1,1,1,3
3879,9906e82b732142f0ae445d21e9f16563,2018-02-21 21:05:06 UTC+0000,dfbc25fda06f4d61972361ed21a22892,9cb04b65223f46d8b2731f5f44695973,0,1,1,0,2
2145,99178c86ddcc441ebdac13714c1dd041,2016-12-04 01:37:55 UTC+0000,879bb9e0b650446caff2559cb255fc94,a1006e6a58a0447592e2435caa230f78,1,1,1,1,3
88,992b2b3a26d34e43a1aa71b8af585b85,2018-05-15 14:28:00 UTC+0000,86495dff190a4a568a67b262023245c8,4a5d65ceaf3e46d49f26fdccc2aea884,3,1,1,1,3
4375,993a80ca9dae4d4c944d9ed51410dc7b,2017-10-19 15:45:38 UTC+0000,60d74adc436b46d89287da416cb9a8ec,e45b541104d542ed88ea6e167022af65,3,1,1,1,3
6827,9954558f50884e3daf288cc0a7d515d0,2015-10-09 18:19:33 UTC+0000,74858cc1b3ce472db886034162af531b,bbb77799ea964b889e00d5d0a9c45808,0,1,1,0,2
1759,99858e7629e94263a0f0893fe1c7abda,2018-02-27 00:03:49 UTC+0000,1af13f3f4f2743ffa1c474f18faf7f71,41b3984603ec43bdba6404c675800889,1,1,1,1,3
567,998bb5989a7b4393a048b318264e5ce4,2016-07-22 21:11:10 UTC+0000,e013795b6cdc4fa4a097fafb9c67e80f,5525f642a56e4c6ca01e027e58ed677a,1,3,1,1,5
4035,9994632f6c65474a92e35fd7f93dd83a,2014-03-28 19:19:52 UTC+0000,43943206659e404196ca2f26a9eaac48,0dc4c381bda94701a967703ccec5c676,1,4,1,1,6
156,999514e0cb0a40f5af2dab3abf47b99f,2014-06-05 23:12:25 UTC+0000,4e66e4844db244d4b02c9ed118858d26,2111b43dd2464cffa32db1d3e6fcc248,0,1,1,0,2
6104,99a8c5db8196434780b51983b37a5074,2014-03-28 19:32:07 UTC+0000,967428dd1e2f4e54ab35df18caf38ffa,0dc4c381bda94701a967703ccec5c676,1,1,1,1,3
3024,99bf2d497ce244d9aa4b98f099785ea6,2018-02-10 06:30:28 UTC+0000,e804e89940ac4feea058f0a064d5a01a,b3dd5e04f0ad412ea7a6ec07c99248ab,1,1,1,1,3
5820,99cae9432b1a4a20915eb4d8919a48be,2015-11-18 17:33:19 UTC+0000,2a950432080446d38a17ce59782e1421,a1006e6a58a0447592e2435caa230f78,0,1,1,0,2
3564,99d45189e54945a88b4ff0b9a2b12df2,2018-09-28 01:00:25 UTC+0000,15a32d5ce28e4bd4b6a3f52fc8435613,14694875d43d453ea5645db2693fa576,0,2,1,0,3
1399,99d48cd1a3a34af98ea94f678fa1f7ca,2017-07-10 20:33:26 UTC+0000,e12b3641face42e681b88e198097a33d,e2023a86886142b3ba63127caaa53095,3,1,1,1,3
3708,99e2ca2d862d41e69382d43b2131c350,2016-12-04 01:47:08 UTC+0000,fcd11e9f583d4d78998c3d9f5744b601,36ff3b3666df400f956f8335cf53e09e,0,2,1,0,3
979,99f5cec90df04dc7802f81004d98dd78,2018-05-14 14:09:27 UTC+0000,73953c1d3c5b49768af83866edeebe9a,272bbb3460454ebbb49c7d7c48948b42,0,1,1,0,2
6134,99fa8b210ade4fddbe895dda7bbcc632,2017-02-27 20:34:00 UTC+0000,75c2a9cd9434449cad21cf7d86ea4b27,13a116434fa14aab8e373b843430e5fa,1,2,1,1,4
6480,9a026b23eaf947a3ba904694ff17edf1,2016-07-11 12:55:29 UTC+0000,c00869f05d7d4b6f9c021f334742155b,ff506465780c44b8a1a662517ca7b04f,2,1,1,1,3
35,9a03eac173094e3598d51c04505725e5,2014-03-28 14:43:29 UTC+0000,17f0d37153e74bc7a8ea85c63cb74aab,953b8bd794124b7f81f1dc659640c9d4,1,2,1,1,4
1921,9a0795bc344546e5981685e328a67863,2016-03-03 01:04:37 UTC+0000,76522729d5b94dd89e3c3b8d60bfa2d4,2fdae2adc32a4e30bfd9a43364387297,0,1,1,0,2
1006,9a36d433c4514c12a6187de161d84c27,2018-09-04 15:47:49 UTC+0000,8c3ac312e2f147d38c1f5f431ea75b70,36ff3b3666df400f956f8335cf53e09e,0,1,1,0,2
3896,9a42d4109ee141c0838fd966efcb5026,2014-02-10 17:04:32 UTC+0000,aa910cebb75b4f0d86754f50a29e0c33,34df5c19a4044e9791978f8ed867a350,7,7,1,1,9
1603,9a5649c383044889879255c631378dd2,2017-09-06 00:32:32 UTC+0000,72ff05f5964f45f29f66491d396731a2,c3b4e11154f74a858779be7ba9b6f00c,3,1,1,1,3
6859,9a63a467ca2249c8bcddbbb3054c3280,2015-09-17 22:12:43 UTC+0000,1577049e6adb47748710e7e5f1ac0a12,a1006e6a58a0447592e2435caa230f78,0,1,1,0,2
4843,9a6e3f315501476abd755304c7ab9087,2014-04-24 02:53:46 UTC+0000,aaf61ea3599147d48413b728a1b8b571,fe4543418c0846e5a65fa22b4ad9a304,2,1,1,1,3
915,9a82740d19474c61bbc90a26cba86678,2016-11-17 19:13:15 UTC+0000,f0f331a9440b4ac3a47a4b457a87d18d,78e1ce09bded445b9315d4f3cf91b351,0,1,1,0,2
3499,9a8c5c6e82e944dc825eb5fdf4777c87,2016-03-12 12:03:27 UTC+0000,e42b18c4215a412499c118e84d9e6415,6cfa0f96a00249f9bfe0108b7fed8f81,2,2,1,1,4
5275,9a8c6d38dbcd46d69a91a1773bd5d63d,2014-12-31 16:52:58 UTC+0000,fbfd50e0ecfd4e8fb6e815c7a6b66278,ccad7c94952a49b9ad0fb85b09d1398d,0,1,1,0,2
1117,9a925167c910463ba84503b2cb4d4dcd,2016-03-07 18:23:11 UTC+0000,c1bd9625493047f08fef825de401e08b,abe02587eef84c27a72c86f4f1644e69,1,1,1,1,3
1302,9a97c5df044f4af4af320bb05a452fa5,2018-09-28 01:22:55 UTC+0000,9e537c0eb06d473caf7396b6648e848a,36ff3b3666df400f956f8335cf53e09e,0,1,1,0,2
5226,9a9ed66ee2c34395b2bb74473c523376,2016-06-26 18:13:39 UTC+0000,94efb4b2d828409ea36b01b30d4674f9,58fa5e95fe9e480a9349bbb1d7faaddb,0,2,1,0,3
3877,9aa4283a1247469e88126dd34c71293b,2018-05-28 23:28:39 UTC+0000,dcc70faf3da84f2fb78829b78a2a1e9b,36ff3b3666df400f956f8335cf53e09e,0,1,1,0,2
3530,9aa68b40d571440e976e0d8735b928dd,2016-05-19 02:23:27 UTC+0000,bf55dbecedbc4a88b6cb9dc4e10ef75b,f8c639fbd3dc4ecd8c95bf2265943ce8,1,2,1,1,4
2111,9ab4899424d34ee68ec953ac390b6bd4,2018-06-15 19:39:40 UTC+0000,385a0b932b4540b881f8efc0571ce1f1,4838548217424b1dbc88c03a586c8ecb,0,1,1,0,2
837,9ad5e0300388490ab40b25931cc39ba2,2015-02-25 15:47:50 UTC+0000,5041354c0db246609e34ce505688f5f2,369f1c8646b649f6997eae7809696bd5,0,1,1,0,2
5994,9ade264973db49af91b11f826c514849,2018-02-28 15:00:55 UTC+0000,5ad950fe0cb8435c81efd636e63733ec,89a4ab42ac0548cf919ca2d8ec161d74,1,1,1,1,3
7540,9ade78d9254946198da8ee26c913187f,2017-02-06 21:41:33 UTC+0000,a071c2f9b4a74e00be5ed3d4777a3268,bb4fe08bb5424f08972927d90bad9642,0,1,1,0,2
1263,9ae44126ee814c4a8b6488518ae9e0fd,2018-03-22 13:28:15 UTC+0000,0c176bd34564424f83fab8b30a65c99b,e5f0572009394739a65412bd525f5a39,1,1,1,1,3
2828,9ae9c9d68f4645298877c60b329b7604,2014-10-07 17:39:21 UTC+0000,724d4bea97eb406ea7490e279608c06f,d1f04208de3643c088f4a25e57f1cb2d,1,1,1,1,3
4133,9aea33334ac8443791bc8c4b98611054,2014-03-05 21:51:59 UTC+0000,e361abdd6293432c8e6d92ffafae5b0d,dfffd276cafe415e9ab18a0ad5564a9c,0,7,1,0,8
4903,9af01890b08e423185c5f2c1ceacc938,2018-02-16 16:23:53 UTC+0000,4db5fd8fda02468ab3c5e4fdded4b562,4a3c04ff69a74d4ca624aaf4029d5f1a,1,1,1,1,3
673,9afb244894c14b37961ff7a6ddcaa536,2018-05-18 01:35:54 UTC+0000,aa5a92c2d79547528a3dd9361da3f8e2,cff9a9679be1434f93afd0caadea94bd,0,2,1,0,3
209,9afebe48294b45bbbf3cee0dc29e848f,2014-03-07 19:31:56 UTC+0000,63f7d1f46c4d459c869f2c5b5ea2a3c2,50f4b7e7ee2140fcb66a70e575984328,1,5,0,1,6
2804,9b0fc59006c345cdb62b8caaca2ad4e9,2014-12-19 16:10:46 UTC+0000,fc98945a146144cba5f74e96adca8adf,2ad6164ce1e14cc4b76048e0652fb1ce,2,1,1,1,3
486,9b1ca8e2259141969296850ac9801124,2017-03-05 17:30:25 UTC+0000,12deec7da2e74b52aa0e1b962ad85e65,36ff3b3666df400f956f8335cf53e09e,2,3,1,1,5
4910,9b232877bd36430e9077a8c80a5b14b8,2015-04-08 18:37:28 UTC+0000,6befdcfdbabc442192b42b5703f378c5,bdd28bb878494d4bb10e7ae0afc3ec0d,2,4,1,1,6
1483,9b2d75eb36e447ca92ecc87c8161c353,2016-02-25 16:55:59 UTC+0000,617ec9d360c944ff8acaaba3ae04bedb,a1006e6a58a0447592e2435caa230f78,0,1,1,0,2
6960,9b43cb0c123f4c71a2f584115710654e,2014-05-16 03:12:34 UTC+0000,c9c71d22b13040cea8cede23b84795eb,ea9e6cb81e994d0faea7eceeb9ce3fc5,2,2,1,1,4
3533,9b4685c7d84d47daa39d9af179f4b6c7,2016-06-24 16:11:07 UTC+0000,0ab2067afe3a4991b656dabddce0660f,2e5897b727b34d0abdfc6d5c5dd7f537,1,1,1,1,3
6254,9b4f7f8899204435b32ae84b84576179,2016-05-29 13:18:36 UTC+0000,245d450ef71b4516957234e94bffa88d,58fa5e95fe9e480a9349bbb1d7faaddb,1,2,1,1,4
3265,9b51651b1a904c928c2d1a5a7859972e,2018-12-19 02:34:46 UTC+0000,99abe6afcd2b4a74bf336be24e7efa98,4d0ff9fcfad14fe098c5d76a849f8642,2,2,1,1,4
4292,9b5553dcbcc6448b8d25ad06c981ee51,2017-02-08 19:07:21 UTC+0000,5c2ea5ceb1c14a6e8f93329bf4a9b77f,96bbbdd06a334805a0501034d9df1aa4,1,1,1,1,3
2435,9b667c1c458846cdb111d26dd6a5eb1e,2017-01-13 21:06:59 UTC+0000,35a0a2f7eb4d43c49c10a110c9eb036a,a1006e6a58a0447592e2435caa230f78,0,1,1,0,2
4373,9b68f487ecc84ac9b3ea59dc15096f00,2014-03-17 05:07:49 UTC+0000,770b21cc6b2b46859e660f4c7978bb89,4bce59e2537b4228adb73b856d2c6102,3,1,1,1,3
2395,9b69ad9c7ccc484a999fb8183cd7ee6b,2018-10-29 01:01:46 UTC+0000,eb1c9e998cb641d69ffba1159f981f4c,b1488415466948b5bee3896efbc31fdd,1,1,1,1,3
6962,9b6ac6065c5f42c1b2c2ca2a95bd0756,2015-06-04 16:17:19 UTC+0000,692444ded2344e76862633ab0fdde1be,38278d114b7241a794557962e1991795,0,2,1,0,3
1766,9b7edacae5374d8da042161ca67ddd7f,2016-06-26 04:17:17 UTC+0000,7000065036c542178ef135d403f47712,e798ef62c6974392b037e93acdfb5aa4,2,2,1,1,4
325,9b8654c3e99b4c52bacaa80eb7b6e58d,2016-07-09 20:04:46 UTC+0000,418d1b463c434c998897e273b6448f97,5f95b0ac821e4e8e9b4fa9fc8eb9ff61,0,1,1,0,2
5782,9b89d50c3f094c4c962b7e657e14963d,2016-05-24 12:15:14 UTC+0000,0f2f4a58c44643fa9248c4ab56de57a7,aba30b19c8be456ea76b6668e5f7d6f7,0,1,1,0,2
3855,9ba2ab74fe354109b065bb74b5e75aa0,2016-10-28 16:57:08 UTC+0000,d9e0d26e98b74ce8993f72fff0186ada,434adddb685542059ba650223ca134e3,0,1,1,0,2
5053,9bab675b123f47f7ba093829445c6db7,2016-11-02 22:34:51 UTC+0000,b76e954bfcfc4e1b81b8ed9e79b1bbfa,82193c4d89e54e56b9287c02d993a4d0,1,1,1,1,3
4219,9bbf74568ebb45a19f8348f6907c22a1,2015-03-17 13:30:41 UTC+0000,b5e2de0f0d9d440d93b1fa7ce3b3342c,c1341204dce1463dad3964c3f3f462c3,2,1,1,1,3
4654,9bc2939dbd5e4e009a0dac88c7c0a95a,2014-04-08 15:00:02 UTC+0000,d23aaa2143fb4efdafc11ea0ed648dee,7197b8bc171241989c50e1ac93836947,0,3,1,0,4
949,9bdd404152e94ce58cfbfc04e32d5d33,2016-05-25 02:01:27 UTC+0000,0f5ccaa676b04963880c922c32df0ab6,aa27976302f04c74a36ac18825e490c5,1,1,1,1,3
4946,9bdeccac16924564a9fc80342e9a6aaa,2015-10-28 18:17:54 UTC+0000,265e2d9adc0a4c5fb343c1affbe82371,1272964da2504fe8a8a6400539cd8b1f,2,3,1,1,5
6253,9be47a96fb4042b386bde4cf886d1c9d,2016-07-22 18:07:46 UTC+0000,af612fad06cb4117ba4d085582a06559,a5d53a25174e4b8a822ff13bc5aaaa2a,2,1,1,1,3
1533,9c1d658d10bd4288a2ea74a50b60e15e,2015-10-22 17:52:48 UTC+0000,9869a8955bd34264b8ffc22433c82dc3,a1006e6a58a0447592e2435caa230f78,0,1,1,0,2
3990,9c1eb6e71fa54193a854de84fb45a171,2016-06-26 23:36:06 UTC+0000,089f5f1a437d4f37a64622be1e025175,58fa5e95fe9e480a9349bbb1d7faaddb,2,3,1,1,5
4428,9c2059632c684df0a4777370a679c64c,2016-03-01 18:05:50 UTC+0000,2c3b5b46e9164accb356ddb34be5fb71,4d0793926fe345aa958d1796c9adf5fa,0,1,1,0,2
7232,9c2eea5f3dc04d48979c5880084aedc3,2016-11-03 00:11:58 UTC+0000,6d3e6c6bca9f4c558a5c0dbfe10e7ba7,42deada7c50c4859a34615d70193317e,1,1,1,1,3
3490,9c33e07928504baa9d414c3578de787f,2017-01-24 14:26:17 UTC+0000,f5925217be414e4e891fddb27bef0cd8,e798ef62c6974392b037e93acdfb5aa4,0,1,1,0,2
1060,9c39344509fd40b088428719ba2ed49a,2016-05-05 11:07:10 UTC+0000,07af1795f7314ddaaef19425183a7a14,168b649125b54d6c84f9f5fc1f4033a1,2,2,1,1,4
4216,9c3a167348384fd29d6c418efecae827,2014-03-05 02:55:23 UTC+0000,0f8760edff954f1693f4286917746ec5,31a0f209fa6842db89818c08b43870df,1,1,1,1,3
824,9c6d63525270466aa668ad3a57329ebe,2016-04-24 21:48:55 UTC+0000,0965e2c649e8467685ec9462a1cc0b2e,58fa5e95fe9e480a9349bbb1d7faaddb,1,1,1,1,3
6481,9c941614f5424fdca43f79e53024d7bc,2012-09-09 06:28:18 UTC+0000,b219cf4371e94a808490ce6b7ea1bb72,f05b33a454c048f3bbc73f5f3f7f5127,2,2,1,1,4
1734,9c95ddf8972b4e2a8e734b99320ff050,2014-03-29 04:54:47 UTC+0000,39209d376b034500bb9ba66122183dc3,b688e766eed04a37b7abc9218aca1ce4,1,1,1,1,3
1442,9ca038fb3b3543379c7a9fc0c2ec937c,2015-12-28 03:48:14 UTC+0000,f0f2cda0e3814ac8b4f211eb7d69b315,5e3b926876974ac680a8821e9dde5370,2,2,1,1,4
4485,9ca4cffa303d4d1f807ff872502fb48a,2014-04-09 04:54:01 UTC+0000,ca4b0128461c418ea1421737b84c09d8,6774ee9e8f9247728dbbe896726e911a,3,4,1,1,6
4583,9cc0d367f96c4bb2bbe0538876e006eb,2016-06-25 00:04:37 UTC+0000,b9faa35ba29f4bae8e562fac62a155e5,27422ede1b77466480e0f22aff6e03b9,0,1,1,0,2
2776,9cc2279d1e8e4a1780426bf93d7468ab,2016-07-11 01:25:27 UTC+0000,4cc367d3f9264ee9a0ff9bb1f6a6ba18,be5d23056fcb4f1287c823beec5291e1,2,1,1,1,3
5531,9cc4f73029774bb3841370cee3126260,2016-10-22 20:33:58 UTC+0000,6bddd27e3b0441e3a686d0639ca25975,e79dfb861eef4538a7c38bdbebb4293c,0,1,1,0,2
4637,9cc548af36e042f4911c405cc36d1e92,2018-09-27 21:50:10 UTC+0000,69f1245668524ddd894521740347b580,da781edcaa4d486a97b06553a1c7c1dd,0,1,1,0,2
6361,9cc876985bfb4013a55670cea2639a85,2015-10-27 16:22:40 UTC+0000,404a99348aae4f1da3d95532b20271ac,e98bd839b4f14cd6a3fa1cd9833d44be,1,2,1,1,4
2793,9ccee9e67dc948e381ba38ec57328755,2016-10-28 23:22:40 UTC+0000,a8151166881b4eb29c1a61ab243959c8,a1006e6a58a0447592e2435caa230f78,2,1,1,1,3
6806,9cd45df7a01a4162b7e8376e2755ee96,2015-10-23 13:39:11 UTC+0000,175235c3e4094eb18d41c7d3e6b553bc,36ff3b3666df400f956f8335cf53e09e,0,1,1,0,2
151,9cd877a4b8e54dbb8b60b8cc9adf8866,2016-12-07 11:19:44 UTC+0000,488d29bd1cae4a1f98ba68ad167a300e,ea76f7c1aec747848d86d9990d9d0713,0,1,1,0,2
5596,9cdc90ad07894237b3d66f85c57861c0,2015-10-13 13:36:27 UTC+0000,7bc228940bad4ea9b29909b8453761bf,a1006e6a58a0447592e2435caa230f78,2,2,1,1,4
1665,9ce7cd25c4c24f13b6b96c458f3c178a,2016-05-31 16:18:24 UTC+0000,ab065b6b89fe49dc89f0df414d5b2a72,1272964da2504fe8a8a6400539cd8b1f,2,1,1,1,3
133,9cfce4edb2054c88b2130d2d265fa6a8,2016-05-27 00:09:37 UTC+0000,d56b6f9985ac493dba3e6fe15f712b15,43177a3bad0944e4af0c4c4a3551883e,1,1,1,1,3
2279,9cfe4b4a884e411d947f79edfe0672ea,2013-03-28 14:26:03 UTC+0000,e7aa1d0e35f74c0dbec7513e5bd6d76a,2d96cabfab6d4857856e2ad177cedc49,0,1,1,0,2
4442,9d0eb636cea3488486610252a494f005,2018-01-26 14:58:08 UTC+0000,4c100c7c6aa54a9899591356507f6756,9a1d143c7f604d04bafb35117a4d3c84,2,1,1,1,3
1154,9d0ec733491b4bffa59e6df1078a6ae0,2015-04-01 15:45:06 UTC+0000,33aeb16630724fa69c3b79f8abf1fdb1,369f1c8646b649f6997eae7809696bd5,2,1,1,1,3
4660,9d1f8d9302984d649dc1aea9fa3bbbc5,2016-05-12 16:54:28 UTC+0000,80d5febb080648d6b15aeccfca79399c,e08c6ad14ba24315afc5985dedc71be5,1,1,1,1,3
5392,9d29bc85db9d479cbd0c17a211d88eb0,2016-11-08 14:01:33 UTC+0000,7bc65f523cb343569d2eeae5b31a83c7,ff659e98efae49e181a970534ccf3c8c,1,1,1,1,3
7025,9d443225f0884837affe9ff92fac287f,2017-03-13 16:23:09 UTC+0000,2a6d8b86c6624c7d816357b7b6f808ee,0b17f4e9d93c40eb9a5d087865084ce6,0,1,1,0,2
2555,9d46160705e84e3b9cea9363d67bddd8,2016-05-13 18:02:07 UTC+0000,b71d2f3d6851445aa09ce15ad50b19d0,bb62d86f4d104d1bae1dab379f837a0f,0,1,1,0,2
120,9d46f9a6c19a414a989a4fea479639b2,2014-05-19 16:07:26 UTC+0000,f14e92b9ae7d483f9ef21e2cc2438243,e4e7cc05a0b64cd6b02168d404a45d4f,2,2,1,1,4
6194,9d522f759f1741129e5b622a6faa0bcf,2014-03-27 22:29:19 UTC+0000,75cd6f426c774440a9e3dbef894279d5,031c50365c1145c3a435627a74732fe1,0,2,1,0,3
6531,9d542d9d920c4af8aa9ec883794f5406,2014-04-25 19:37:18 UTC+0000,1750ecd567b1450e95e4352384413d0f,fe4543418c0846e5a65fa22b4ad9a304,2,4,1,1,6
6038,9d55891979394acfbf8aa2215222a75d,2017-03-10 00:09:55 UTC+0000,4b4d9939540546dfb44b81a6f52bb97c,3b0d687829024e34a666a19daf42d5fa,1,1,1,1,3
1654,9d7dde32dbbd4314ab41da9ac6f94609,2016-06-24 23:23:37 UTC+0000,b46b545ea1c94845904084f9e12cbcbb,193c0d6ae79145afbad3cc3199746f84,2,1,1,1,3
2361,9d94728c80a74860b1c93d96ff2e9ba0,2018-08-27 22:09:21 UTC+0000,59d0f105d2344007a47a1050cf2ea476,36ff3b3666df400f956f8335cf53e09e,0,2,1,0,3
6146,9db7923d10814a25b39a651900a05444,2016-05-19 18:07:07 UTC+0000,54beb09d6cdb4ff0b08ad2de30024c27,92ac3085661849568e57d745a95e2010,0,1,1,0,2
7420,9dbe51f9de3942e5b56eaf922db014b0,2016-03-01 03:39:12 UTC+0000,0d3f48651eed4dae844d4c8264890db4,4760364050824a11bb40bfa97d2455b6,1,1,1,1,3
1495,9dc02d3610284ce59541fa628f140188,2016-08-12 14:20:09 UTC+0000,aa39d24ea7eb40c98c1fb0552f14dcaf,de51e745b6354185a0ca5d02dc628416,0,1,1,0,2
5553,9dcafcfb66ad4794b55133a97136d36f,2016-05-10 16:17:58 UTC+0000,c59763118ab548b2a2622770835db5b0,d4d8f2de77454f64b23b333b7cae636e,0,1,1,0,2
730,9dcc8b87ab59499e892a3e0474536985,2016-08-13 12:16:10 UTC+0000,2f88fed52bbd4583aae0a7f3530a0775,36ff3b3666df400f956f8335cf53e09e,0,2,1,0,3
4088,9dd559273cd64035ad407164ab66e893,2016-03-01 22:48:25 UTC+0000,2d639e6172d54884863f987d4e64b193,e6b29607f1504bc9bdb81783016df845,2,1,1,1,3
537,9dee2921b5c945c288883767a2edb1d0,2017-05-27 18:34:13 UTC+0000,0f733570bdd84a8483cc20255d518a75,be5d23056fcb4f1287c823beec5291e1,0,2,1,0,3
6697,9df8f44c8bac42d49a3c0117bab66a98,2016-10-26 13:05:34 UTC+0000,fe0d264096d4459db076dafc1151e631,d67ce930870945109a7ad86d29ba2035,1,1,1,1,3
4445,9e0f0cf3177541eb8ad5eb053e8c6076,2014-12-16 19:27:36 UTC+0000,8aaaffc30290417ca56758332d907cf0,13b55ed4834e4814bb33a4c87001063d,2,1,1,1,3
3198,9e0fff1f4ced41bcb2d287e992913d0b,2016-07-31 15:48:16 UTC+0000,6e7977216f264e1a912ada26c586507b,36ff3b3666df400f956f8335cf53e09e,0,2,1,0,3
1148,9e1a27bcef2745cca16f249f3613e357,2014-01-28 01:46:52 UTC+0000,a82460b9a4f84239b9554ecc2ced91d2,12b90373b0994c6b9a32ffa8ab9a970a,3,2,1,1,4
434,9e28531d1a0246d890bff1992381a12d,2018-06-17 05:22:28 UTC+0000,d3e2ccd36ce8495f95d8973a1a5965eb,426bccd7932c45ef80e7b6480b251e2b,0,1,1,0,2
5518,9e370588faf3449188cd506ef6db8f5f,2017-02-07 01:58:48 UTC+0000,b0f11825eac24fa086b04ebc6e4b5f84,c258f388f42b4f608dd6fd8e9b6c1dd6,1,2,1,1,4
4670,9e3b15d778184684a7f4ab5bdccbd0c4,2018-08-10 23:36:38 UTC+0000,a15c9c6e6b784c9a8242508b07cb031c,85043fa9a4db46199558715bb2b0b490,0,1,1,0,2
7617,9e3b7cc201484943bac63e0ef96d9dfa,2018-02-16 03:38:14 UTC+0000,f38def6413e84fcfae2762ee84349120,c5ee38e302514a228cc54ec69c1f7841,1,1,1,1,3
3248,9e4a5b54de2246fb8a34f0a1eb901a01,2016-07-19 22:43:21 UTC+0000,77e77812ea1745bb91260d78446c6bab,0190d1d7e4d54df69c6c4967a576c1dd,1,1,1,1,3
7675,9e56e46e91f64909a42a6a01e68ece6f,2018-02-10 01:32:38 UTC+0000,ea09c190dd1d4eebaa8283508f550c1b,e1cfd8be420242eb9b59aadc4cc590a9,1,2,1,1,4
4894,9e59fb575c6a48db843424323dffbcb9,2016-05-15 14:27:59 UTC+0000,e858b4a6d4b743cc9197f599f8f51c4d,58fa5e95fe9e480a9349bbb1d7faaddb,0,2,1,0,3
627,9e71617fd3d34ed4bc44e88f3b47ff7f,2018-09-04 18:44:12 UTC+0000,8c11fc10100e4a00b0b24d676e587d19,564a66960314437ea2cadeab079c92b3,0,1,1,0,2
7386,9e752227cc334c62940027d8ac33b2bc,2015-10-24 15:29:00 UTC+0000,447db8f303714c16b234701121fa2d12,c1a24b8f746b47488da02a0e5044a7a9,4,12,0,1,13
64,9e75907219c8484088329b58f72a7ce0,2016-08-22 20:32:17 UTC+0000,6b60dd5022a8404083b1a8c6a4b78a7d,a1006e6a58a0447592e2435caa230f78,0,1,1,0,2
2446,9e787849bec94da9b3d3bc2a54b4aece,2016-06-11 22:46:19 UTC+0000,bf365752ceb340b1bfaa3627e6867374,c0a9c84db7bb48dfa9852c67d449bd50,1,1,1,1,3
4909,9e9897e126284f2e9f3b72435daa4b1b,2017-05-16 13:31:33 UTC+0000,93fd47af8eb84be1ac98c5b7374d335a,56d4db39d41f4b508e9e35597fb73e80,1,1,1,1,3
2333,9eaabca25bf24415875567f40690a79a,2014-10-27 19:48:43 UTC+0000,b36f3e949b004df19e3a5042e679aa01,6d3aeebadc6a403a814b2ceafd79862b,1,1,1,1,3
2781,9ec0630a2b874397a10816efcc90c63e,2018-11-03 23:45:46 UTC+0000,00b79ac6fe734e7e9f6632ba200535e8,d50218bb5cab447781d381c279abe605,0,1,1,0,2
8029,9ec2fca2159b446e950ddf867e45281f,2014-05-07 01:18:05 UTC+0000,36b679b2473a48e089a60bb6cc3580a3,18237fb03c8d4d368085a5dd67c5307e,5,4,1,1,6
5485,9eca85c4dcea4765a971d5ce3c2339d9,2016-06-26 20:09:22 UTC+0000,4136cacd293241fb8aaa5ada11236dc2,58fa5e95fe9e480a9349bbb1d7faaddb,1,2,1,1,4
6308,9ecee21d043f437592d92506ed8b66ae,2015-06-24 03:11:09 UTC+0000,cb740ce0053d4958bf76a113233ad01d,68ecc66323b8418092fdd724aaf5be94,2,1,1,1,3
225,9ed00ea0505546b4ad5c7db8bcf685ba,2018-02-28 00:27:29 UTC+0000,e2e7d3ddc7aa4b1c9b596ea23112cd5d,aa3aa0ba7a244573b18b162e5e50790f,1,2,1,1,4
1845,9ed1381604dd47c09849da86d1a5bd19,2018-04-13 02:19:09 UTC+0000,f99ad6f10a4c410783ba13d9c2228d9e,53939a491acb42a4815463845a638186,0,1,1,0,2
4777,9ed50b4dce0b43cbaf7a600cd5aa4bf8,2016-05-25 16:29:28 UTC+0000,9d1c16a537924cd6ac0984af082147ef,81a594b683d54e6dbb4b04ea00a5e25b,1,1,1,1,3
1468,9ee5e41e6ffb43cabe3e223824e6935d,2018-05-25 14:02:39 UTC+0000,d610db2d03fa4b218f0a712313a4e99a,a1006e6a58a0447592e2435caa230f78,0,1,1,0,2
206,9ef44bb75041442a8f4bd21c154a68f0,2016-03-01 17:30:27 UTC+0000,29d14ead35a94f35a343532d7cb49087,a1006e6a58a0447592e2435caa230f78,0,1,1,0,2
6631,9ef8342178fe4422b4db29dd3336a793,2016-04-13 14:59:46 UTC+0000,1759348eea1349e58112c0af5ef982e4,8d613aaaa84c48ba90b577dea69172f0,2,2,1,1,4
4277,9effe00247b047d7be2705bee208e80a,2014-04-07 21:42:54 UTC+0000,5572d1c20a3d49a4b8557f745486e657,fe4543418c0846e5a65fa22b4ad9a304,1,1,1,1,3
6478,9f023cd9f22e4e3b9968332b5bd9e796,2018-03-20 16:35:31 UTC+0000,69bb7f3c96354430b2278878a343be9f,e29bd173217743cf8800e45296de8083,2,1,1,1,3
7740,9f125fa472fd47538a3dcbdc150075d3,2016-05-18 03:10:26 UTC+0000,36d13b74251d47f5b6c43b58a65d276b,a14d2d2cc61d4275a722eeb7204cda90,2,2,1,1,4
7794,9f12b6548bf543c4802f3d1a2d5b754a,2016-10-26 01:21:37 UTC+0000,07194be9cf684b17a9349c2a403a1ee0,708dac91e794411880262fd6769828a8,1,1,1,1,3
4222,9f154feb655c45afb857ebf2f1a57bc8,2016-06-21 03:49:00 UTC+0000,b41a62f7b5134958be929056f30660ed,f4759af9b17f44c9865b041a0469dc45,0,2,1,0,3
5946,9f17b2d3c7b6405fb8430454ca232cc6,2016-08-02 18:19:45 UTC+0000,f131fec035ed4027800c97f935854a42,241356daf97f425386b8500c7165fee0,3,1,1,1,3
3993,9f363601464047b79358026362d88a12,2015-10-29 20:46:39 UTC+0000,88976e4db78f4f75b2a62b8b61ca8b5b,a1006e6a58a0447592e2435caa230f78,1,1,1,1,3
2320,9f3ee9f228114a61af2bb5febdbf5fad,2016-01-07 10:14:50 UTC+0000,7c210ec5c4964ad4a16592e39f58d9d6,af2bf6e753c3405f8b937570aa8e06b2,0,1,1,0,2
7792,9f42cc4446f54f7099a987d33d4e7b35,2017-02-08 08:16:20 UTC+0000,9a1364f879634b588c2b243f84af8b7a,b91618eebcdf4832b71482034d6ffd8a,2,1,1,1,3
1559,9f42f13348b74589b71060f41e3d6d13,2018-03-21 18:07:13 UTC+0000,93550301f17a4de5a16889adb1c02826,fafeba89ca764bd891862fb8440a2962,0,1,1,0,2
3997,9f60126f25194a82bf2af40d546be35e,2016-05-19 15:41:31 UTC+0000,226d72fb0aa24c3dbe9f4ddb2d9b6b71,20e96c85343545ef923d11b7038920dc,0,1,1,0,2
7560,9f6207bb847747d8982e4e8faf030b00,2015-08-03 16:31:04 UTC+0000,c5fb50dc440e404e887af4e45f0688e4,484ba21a3e19494aa036d3baeabd89dc,1,1,1,1,3
6402,9f66f9790828453d8200d40e0625ffb7,2014-04-29 15:23:55 UTC+0000,c0377ecce82746bebea2beca9f97a22a,3b7e352267da403695a5c0f50f28da8b,2,1,1,1,3
3827,9f8de36dfea3434d876b9721bd96b40c,2015-03-21 16:21:58 UTC+0000,01acfd03e3164242af3e85f4d1aefaeb,d2d56c36d61e457689c449bdd59c1d36,1,1,1,1,3
5714,9f8dfe195fab4a06a23eb8f48610f53f,2015-09-14 21:37:59 UTC+0000,6fb38bbb9d104730937d207ba55b944f,13b55ed4834e4814bb33a4c87001063d,1,1,1,1,3
3177,9fa45c77e4c2433b88e15710bb243db0,2016-03-01 18:50:23 UTC+0000,7f2e0065eb1f47c88f71d9eb1e08106f,a1006e6a58a0447592e2435caa230f78,0,1,1,0,2
2949,9fb620996bf24b9abc4f62887b01defc,2016-07-11 23:50:54 UTC+0000,282ae04f29964cbcaf0bbc0efb73b1a1,562d5824c0cb4bf9a4cbcaf183126c2d,1,1,1,1,3
5500,9fb8a70779cd4a92911d7bd6e4bc5a0f,2017-02-20 15:24:28 UTC+0000,8835a35e48864298a79a5f1d49aabd39,36ff3b3666df400f956f8335cf53e09e,2,4,1,1,6
5856,9fb8bd3433d74f67a7c17da52e71c2e6,2012-03-29 20:47:10 UTC+0000,594a77ab7fbe4c23aed75717f052859f,8442ddfd38bc422fb4677785db0630e6,5,2,1,1,4
791,9fd66ab6220a4f37b440c4035c059310,2014-04-29 18:42:08 UTC+0000,87509f2fb44f4ac79caf5a01a7fb628f,44b2484ecd3642c6a47514f3876cf14a,4,6,1,1,8
6442,9fe7abf8134443e885cb3266fde81873,2014-04-08 13:31:25 UTC+0000,7d25ec8fda0c48f0a16c87beaea67af5,95f1104e8b604c98ae237020a98921c4,1,2,1,1,4
5355,9fff6c49889443c5b06007bca774ab0f,2018-04-13 18:23:07 UTC+0000,6a811fbac1da4a60be8e97893a3e34be,89d6872473284f388d1265d087a89a09,1,1,1,1,3
1651,a00097894ae443b79348fbb56e2c4f4f,2014-04-09 04:27:47 UTC+0000,8f2d1fb1ad944d08939a267f2b13976e,6774ee9e8f9247728dbbe896726e911a,0,3,1,0,4
7043,a01994dcb2084d679563c88e705de4da,2017-04-03 00:51:06 UTC+0000,8d36e3dfbf4548fd96087026cf71b228,dc28056163a8447686e5691f4c1475b0,1,1,1,1,3
7525,a0236d19ce8841f58899749acb949b6b,2018-03-02 14:25:52 UTC+0000,a8f4f88859c24b33ac62c6d522287fdf,0355aaad83704ad98e6d71b79db85849,1,1,1,1,3
1572,a023bfaa2b4b4a638ae2d12f33ed00e9,2012-10-01 21:05:00 UTC+0000,71744897368a4dec891a401ff78e63bd,560a4bb63dad4df7b9a81efa29c11231,5,5,1,1,7
6664,a02554c5f7ea43969674c3a682061b4e,2016-04-29 15:04:45 UTC+0000,34d86523fcc942dc98c002edbfe1d2dd,7bffa1792d474359b922e5de700d7a82,1,2,1,1,4
2183,a054fa49e51b40758d1e8dc27b5f9661,2017-02-03 18:17:38 UTC+0000,ed2279352c5d4236beb045b3d3d10286,96bbbdd06a334805a0501034d9df1aa4,0,1,1,0,2
3211,a05c98e206b24a7eae2118bf05df115b,2018-01-23 22:40:04 UTC+0000,44107011ffb14bbdacf83076f40c35fe,d02f6d9faac24997a7003a59e5f34bd3,1,1,1,1,3
6808,a08d35198a9843a7a6ac8c16a72ec8f5,2018-01-24 18:48:17 UTC+0000,d36e2fcff23c46edbff91d6604264f84,eb7c9e19fb4c4e6ab4a0bbdcc80487e6,1,4,1,1,6
1182,a08d3748639445b69cd1aae4a9cb0f92,2016-05-21 04:39:13 UTC+0000,b2a3c827b44448dabec22f4d6880f516,04df52cae7db418faf5f9b285799ea5d,2,3,1,1,5
3620,a09cb478e7c34e56b6c32e33c0d0e380,2017-05-12 16:05:59 UTC+0000,85600947495d4591b451a33247e2d12e,bca6e570f3f44606b12fe56f469e3ad0,0,1,1,0,2
186,a0a59481389b4c8494bbafcf45284e16,2016-07-11 08:38:18 UTC+0000,29b15d9bfade4bc9b305ba938ba0ebe5,a7b01a1f0c974c2bbb60c4777c770659,1,3,0,1,4
7806,a0ac52f756d04983a2952796d50e2b21,2016-04-28 22:33:53 UTC+0000,68c4a027c257419495cc3952f09ce1d5,10005df177a444198e4a6052d8ac7502,1,1,1,1,3
7925,a0ad5a5976704e13ae37cc6eefe4ff19,2017-05-09 14:41:02 UTC+0000,83bdd6380cfc40fca9ccbc131b8bf2a9,b0376b390354402aa04c9958e99c0d66,1,1,1,1,3
670,a0c129a87b0943f7973c9372273e0b6c,2015-10-29 15:21:00 UTC+0000,90549a7608a14e6b95997e1c57c27ff4,a1006e6a58a0447592e2435caa230f78,1,2,1,1,4
5550,a0c67f53296f42209334731dcae9ee0c,2018-07-24 00:23:49 UTC+0000,6e02a418509e4ac7aa9f43f29ed702e5,8e7a93e0afa442e0bf63a3cb9824562e,1,1,1,1,3
1578,a0c6890a0dea48ef831c7918745b2e8d,2014-09-10 01:53:04 UTC+0000,63990900539d47b7884a2c8cf967abe2,ec3cc911d25745a4a276b5627bcac6a0,1,1,1,1,3
5826,a0c8a11115a54f09a1457bced5ccbbfb,2015-01-19 21:00:03 UTC+0000,267400cff29345c9a3d2a29b0bc49e59,05444a2f42454327b2ac4b463c0adbe0,0,1,1,0,2
148,a0cac8ab8e39407fa6c6a670809edac8,2017-08-22 15:10:48 UTC+0000,1d23967278fb49d7a8f38b164f65c26d,a2a3490912f9435b82172850e907c1c7,3,5,0,1,6
7614,a0cc5d13dfc24c00a4c20c6e8c11c671,2016-03-18 20:18:32 UTC+0000,ab0954ee19c941b4a1cdef1e46ca8fd8,a1006e6a58a0447592e2435caa230f78,2,5,1,1,7
4720,a0f642c93e6448e6b0b4f52ba7a0843e,2015-10-24 00:46:11 UTC+0000,cadabf42680f4a01b8cc311cb11f3c1a,4b7737cb8c46400795bdba3a4f333997,0,1,1,0,2
7189,a100e80025a2492aa6e83e9a73989abe,2015-06-04 21:03:49 UTC+0000,c2c9c417291e46d3805e2b77668d86c7,7bffa1792d474359b922e5de700d7a82,2,2,1,1,4
1279,a10bd9432f6d46a194cfc14c09339dfe,2015-04-09 14:18:20 UTC+0000,3cefc93fc9c4407697d0478a302c1153,f0f6f665441e402aa9c328c3026b049b,3,2,1,1,4
5029,a11813a6989a46a5b80c109e11ca18a6,2014-12-15 19:26:55 UTC+0000,9bf2937f514144e8b2b5b09d1a76452e,77a65aed859f4b11983cd07399f1e3b1,2,2,1,1,4
564,a11ac7f1ae18412b93b5fbad43a16d1b,2017-05-12 18:09:08 UTC+0000,51332b012a1c4245b091bed2d5ef5d47,c7bf019f041c4f2cae8f8ed89d16ae85,0,1,1,0,2
6479,a11d6d5b3fd040e087df7ac683a061c9,2015-06-27 01:02:15 UTC+0000,c6bf2ce9b5a94f61ad84b16fd3cf1134,119d5b9c1610486c9ed639efad99e120,0,2,1,0,3
2221,a11e2ead9ee74655901f8b5393623da4,2016-06-23 09:36:12 UTC+0000,5d05f9601d9c41c78d1778c79c5e2ce6,c85420d41be7444d9588f806457025b4,1,1,1,1,3
7980,a131f79817b74c6fbc0bfb607f68bcc1,2016-04-15 16:32:52 UTC+0000,f6d1c98c4b5f416eb66cdc36cab89297,1045da0b922d4439a8adeda1b62038c2,0,1,1,0,2
7931,a141f926dfff4fe0903ab23133ae3e00,2017-03-27 18:57:46 UTC+0000,8d5ac3fb6e3e400eb65c4ab689c2c6ac,24fac8940aff427c848b2a59265c1204,0,1,1,0,2
4341,a14ab07d75ae4b58905f748cb06ff3b2,2016-06-25 22:43:43 UTC+0000,eab2f54797294876a09fdd9c6cb41106,4dc7d9040592416f98c0bef1ad2c31f5,0,1,1,0,2
17,a14ba4493a564c0a88be6c4cb9a53a3b,2016-10-02 23:30:28 UTC+0000,2d65fdebecbb4afc97b269342af1d620,9421dd803d164e5da26436a01a92ce13,2,1,1,1,3
3576,a14e9100a0444e159f59e71b016a60ee,2012-01-19 22:50:25 UTC+0000,c8ac501ed357453d859562a0f61dd693,7d425e8d7cfb4fe7b0702fff4d6d84e7,6,1,1,1,3
6403,a15f4b90fb754d6d9b70101ed33bcb28,2016-05-30 11:27:07 UTC+0000,56ddfe6096234d6dabc336820572902a,60f7baaeb98b404ca65663154ab9e538,0,1,1,0,2
1301,a167862aa3a24d42914f2158243db4bf,2016-05-30 02:43:24 UTC+0000,ee88b17529234af4897e07e588e0ccb7,58fa5e95fe9e480a9349bbb1d7faaddb,1,2,1,1,4
6529,a176fab2d9b949dc831bd1ae870da01e,2016-05-22 23:50:07 UTC+0000,d68e91cfdf054619ab9cdd17af7e1177,bc46e3699d92477ba8c7aa723e54a151,1,2,1,1,4
4968,a17e82e9ce964561ac06366a93fe792b,2016-05-11 20:48:56 UTC+0000,e3124181bc3744938aa1626b591f92f8,58fa5e95fe9e480a9349bbb1d7faaddb,1,1,1,1,3
4925,a188821f7266469aaa4d5c10aa60761a,2017-04-05 18:25:20 UTC+0000,5a5e35623b0c48198fdc4afffa5c806a,36ff3b3666df400f956f8335cf53e09e,1,2,1,1,4
5534,a191966d6783427a9c1b98d635640875,2017-01-31 02:46:16 UTC+0000,8c1f6d437bbf406ea014e3cb9c5d1832,a7a8e9fc6f0849dab3d825c39b22262b,0,1,1,0,2
690,a1936422b82b42e19119635734751f5a,2017-01-20 21:49:36 UTC+0000,6d3f5a6d36bd488a8aacc0235e1da27b,a72bde6ac9e349d195a6d356444c9578,1,1,1,1,3
3327,a193b37bfeee4c078132610e9f26ecec,2016-07-10 17:42:08 UTC+0000,c21206d3babd4c69bb615eafe299fb96,58fa5e95fe9e480a9349bbb1d7faaddb,0,2,1,0,3
3916,a1b6bfb150e64164a29e53d765fa2117,2015-06-04 18:07:09 UTC+0000,256ecf1eff8f42dea8d429e39cf3067a,f319c1c9280847f48f6d703aff76b4f6,2,1,1,1,3
3522,a1b9b0519af14de79ef52e7ea8c30d69,2016-12-26 18:16:08 UTC+0000,bcbdd90c9d4b4ca29b32909b079d948f,36ff3b3666df400f956f8335cf53e09e,1,4,1,1,6
4316,a1c13d43cddd4dbb9cffac1a75797f5c,2015-04-23 16:45:34 UTC+0000,c27932aedcd24003817311ebde49006c,641737d4dec043e9b02b9d6837aaa4c6,2,1,1,1,3
4286,a1c4ceafc2fc43149711aaa938b8a5cc,2014-04-23 13:24:59 UTC+0000,a2e19241c0e740eaa62cc8c5ee17e0cd,b688e766eed04a37b7abc9218aca1ce4,6,6,1,1,8
831,a1c9699890844956a725ee584ad08427,2015-05-29 15:33:29 UTC+0000,dd38d2b21d9c494aa376021d0c2f3436,369f1c8646b649f6997eae7809696bd5,0,1,1,0,2
5937,a1d09dcca0e94ce4b9e300154b4fde1e,2017-04-14 01:47:39 UTC+0000,cb4d6688e9df4ea39bda13b03bb7c7b2,d97b69151d1f4c22b97582347e5926c1,0,1,1,0,2
279,a1f20e9578754e43a71f606d3f788832,2017-02-23 03:03:29 UTC+0000,e0000da9803145838a78c2363ef4b582,037efa1ba22241de8e3c04fe991c9b1c,1,3,0,1,4
4738,a22faa8e0c144340b9c4cec885bcce3b,2017-05-06 17:32:06 UTC+0000,c40b38aa61514f148768ae7568bc8e14,bf6edb3e76b94594a982c5776764cf75,3,2,1,1,4
6782,a23e0457a54141868318c0391e341823,2016-07-08 17:43:04 UTC+0000,76c82e2347164b249e2872a7ec9148d3,52bef8bad59d4aeda57b312edb6c23b4,1,1,1,1,3
4097,a2417869e83b4eeab5d4b17d2814b529,2014-04-18 03:12:48 UTC+0000,12086979b9234b21a34ff5fb482caeb2,fe4543418c0846e5a65fa22b4ad9a304,1,1,1,1,3
4543,a243dd4f040c492d8e4626e425bfe942,2014-08-31 00:51:27 UTC+0000,9bbfe18f1646442eb250ef011320c18c,05444a2f42454327b2ac4b463c0adbe0,0,1,1,0,2
5135,a2581c5a3b4b4ee998c3575b26f9cc4c,2016-05-18 17:48:28 UTC+0000,020e434970e244428ed66c0860e41c07,e4e7cc05a0b64cd6b02168d404a45d4f,0,1,1,0,2
792,a25c4cee64974799ba0c150e6afce95f,2019-01-31 11:46:15 UTC+0000,b476f9c6d9cd4c50a7bacdd90edd015a,b1eade16ada94bd8a02d8a60efc37759,0,1,1,0,2
2571,a262d0301e244d6fa559a4c3f16ddd92,2013-03-04 21:12:08 UTC+0000,767ef72177a449d99089501620c063b2,94ba583b81ed4e98acd15f291172bf8b,5,1,1,1,3
2173,a26a0ddb53a14d19baadfa010c6d33ae,2017-02-21 20:38:57 UTC+0000,e6cdce85f9604dc6a4f5c56e51cf1397,cff9a9679be1434f93afd0caadea94bd,1,2,1,1,4
1360,a26a18403d3b4331a43034f4a856b1d7,2017-10-27 05:39:02 UTC+0000,d58fc3b1259447399b5c922b6e4ea0ec,5a360ca371e149048f6cedab908b140f,0,1,1,0,2
1053,a26da4c85efe4ab6b31c6c1202036e7f,2014-10-31 16:44:32 UTC+0000,b4343c7382d749bdb002d8bd3033109a,9a0f09620c6640718c1792a74f3b8438,0,1,1,0,2
6560,a297d568f0bd4d2a81447eff7fc8ef4a,2014-03-28 16:49:05 UTC+0000,d4dcce1d690443f58f6a2ab3183c285d,7eaf89c13f0146959426a741b3f56b7f,1,1,1,1,3
1138,a2ae8734f9034c2d89430a67c5f2605e,2018-03-02 23:11:13 UTC+0000,4fe182b10a8e4123a636f9822c936df6,6241d58a10c844a38c858f58b2eaf8ee,1,1,1,1,3
5755,a2b71c4399e84fb8958ca8765e7d2b55,2016-06-23 06:29:10 UTC+0000,98d33b193f66422a8f214175809fbc35,30504395c3ad418bad5de2954ab8d0fa,1,1,1,1,3
372,a2bb8a68e427461ca093e3f2f265a038,2015-05-05 19:47:24 UTC+0000,3a5d6d37632b44bbb34c3885d378e183,a1006e6a58a0447592e2435caa230f78,2,3,1,1,5
1072,a2d5a193bfd84db59cc1f21be1d220f7,2018-02-16 02:53:30 UTC+0000,9f84432b991b4b68a9373d3a328a8f59,dd319483145542869315868c5aa1accc,1,1,1,1,3
1631,a2e8916d5bd84c45b981e3edb86f9aa9,2016-05-28 15:26:17 UTC+0000,9857f869909d4757aaa48ea4efdf8460,36ff3b3666df400f956f8335cf53e09e,0,2,1,0,3
5017,a315b5ca42f641bc993a6df4face51d7,2014-03-12 14:37:27 UTC+0000,48aacd53721f40b0ab4bc2a39f5292ab,3610651286574769b899efd7204265f9,0,3,1,0,4
3843,a31d89e3be1646548a09cb0557f9cfd4,2015-03-17 12:57:39 UTC+0000,4a613b6b4d084390b2cd9c99cc99b476,05444a2f42454327b2ac4b463c0adbe0,2,9,1,1,11
3002,a325c23016974d3da36951d39dc95fcb,2015-10-06 19:42:05 UTC+0000,32618b2bdd5b4519a5c7ec08ba79ff16,410d13f870954475af0cfc6a45527bca,0,1,1,0,2
1261,a33b2ef77e604e3f94a49418474b4ae2,2014-12-10 23:44:57 UTC+0000,c170289d541d4c2dbd767a3002c0467d,e0fbfa616ab7409b8263f4afa590fcc1,3,3,1,1,5
3019,a34cd87f7647484892e528cac2a0d7d6,2014-03-17 14:58:29 UTC+0000,642cede1dbfc4a36bc63020993b24f8b,18237fb03c8d4d368085a5dd67c5307e,2,2,1,1,4
4461,a34d3c6cb98041e78775e6fcc7a36278,2018-02-15 16:50:07 UTC+0000,859c9dfb339b4b5ba65361e02cbf0926,75b168e0dc4e4bf28cff7754567ad415,1,1,1,1,3
5165,a34fa985a4a5414a9dc690dcd11ebc63,2017-01-30 22:01:59 UTC+0000,e2fe0105971e4c07a15ad722f85c4a8a,2a3644c6f5d140ffbae97dc57f9ce2f3,0,1,1,0,2
67,a359510dd5264e4da48c04152ecd71a6,2016-04-27 14:55:23 UTC+0000,c7df204c67ef46f7b3596b09ff916dd9,67950358756c416aa5dccf1dac9ce313,1,1,1,1,3
1969,a35f2a2e765a43848e96a8f3790cf4ba,2016-10-08 01:55:43 UTC+0000,63a5ac6a99c3426994190d1f6a14c7ee,faa0582ea12e403180bbd18848cea2d4,0,1,1,0,2
6137,a369bdc9b1f345ee85416f4117fa3019,2016-04-26 18:43:31 UTC+0000,808c00ca37ca4921b2e214c116f0cc60,f3625d8f4cf242eba824f905a15568a4,1,2,1,1,4
1998,a3809cddbfcf420aa245975a4ed79e50,2018-02-18 18:02:51 UTC+0000,498d99886a4842a1bf29f690c31c340f,4d9079c15bd94726b57d4ebdb63cc0f0,2,2,1,1,4
7534,a3841ce60da04130bb4ca8dc4cf6a6c4,2015-01-02 21:52:56 UTC+0000,d62f4858a5bd45a3852e1a192eba0e05,b688e766eed04a37b7abc9218aca1ce4,0,1,1,0,2
2548,a3afaefddcd14cbf987ad0a764ee4621,2016-05-23 03:35:05 UTC+0000,4f8ac43a6fdf4f9980a1e5f6fcd8cc5d,23b6df4d73fb4d9bab3eafb6dd8bfb86,2,1,1,1,3
1953,a3b8dbd41e54411c9b454e484ed05e65,2018-11-27 19:32:48 UTC+0000,c5db48a4abcf4ba8883320bbac2fc728,336e46537c0244fda497afa362966595,0,1,1,0,2
2620,a3bca544f8f5435ab52fe4d35bdf9432,2018-02-16 19:36:24 UTC+0000,64f69be1612e4dd7a0d88982f5fad33c,92bfff6673fc4a9795a09210bdd4ae95,1,1,1,1,3
6009,a3cbca35b9a94adfadf84f225e30eb35,2014-04-07 18:32:51 UTC+0000,f5ca88bf7af44ffd8ae34ed8f31eedf0,a40408127b504ab8b89118eaa328a0be,2,4,1,1,6
7810,a3d358624aa24028b2b24c72d4fa26e0,2015-10-27 22:55:06 UTC+0000,7729f41ac93743f6ae912952d00fb0b5,a1006e6a58a0447592e2435caa230f78,0,3,1,0,4
3441,a3f3f9f034964f02869410db4911ff22,2015-03-24 15:47:58 UTC+0000,070625b9d1e8433286ee58f5a4284a9c,e0c3c9fc3634444ca0474c231b2f5959,2,3,1,1,5
5650,a3fab9d4cfa5402ba57927230a79f1e7,2016-05-16 17:04:24 UTC+0000,b2beda3185a74815acf640f94e52b619,04df52cae7db418faf5f9b285799ea5d,0,1,1,0,2
3944,a3fe10e58b03456e9e6edce7fdef2b1c,2016-05-28 14:42:11 UTC+0000,825d6c1c52454c53a4a7b2eaecf2fdea,c1fd4048e28346a48f301c410f2a6d52,0,1,1,0,2
3728,a40ea8fcb1f24720937ac04cf0a21274,2014-04-20 00:39:52 UTC+0000,ab672417e8d743bea0927c4106bfcd6d,fe4543418c0846e5a65fa22b4ad9a304,0,1,1,0,2
4293,a41e4f809b184f9b9cc891a54d2b2e4d,2015-10-03 19:17:36 UTC+0000,445c3fdd33d340d7a0aaacbe7b6559a2,e3529e64e70643b6889353db79eeea3e,2,3,1,1,5
4592,a432b33fcd3a498f9b9568cdc2f19f78,2017-02-07 11:10:15 UTC+0000,0de5037d56854eb99c676102ca40206e,3ced279c77df43d3a0278cc43566d3a9,0,3,1,0,4
3912,a44f5ac916c44c0896922ca099d5aed0,2018-10-30 20:59:25 UTC+0000,c8d7779865bb4640822327e8026b01ee,39034f9981354770a61401a8da1bf714,0,1,1,0,2
2091,a4513fe6827f4f98b99f4d8ec738aebb,2018-09-05 18:00:38 UTC+0000,db67b5be52bb478abc812690c6eaff7d,e44c2855fd6649ae869fe145d167cbe4,2,3,1,1,5
6400,a46fb8388acb41e4818026a98ccbdd1c,2015-11-06 01:04:27 UTC+0000,35534a0c2ddf4aae857234cc2e1e71bd,a1006e6a58a0447592e2435caa230f78,4,4,1,1,6
4790,a48178e16a6a4ae997bc509fe77fdfc6,2016-05-02 02:52:38 UTC+0000,266a6f148d4f4d79ba607b9e7c371773,44ecf414c6914a82b2b7bdd03db2f59c,2,1,1,1,3
2655,a49eee0216724d4e86555552f3260f4d,2017-11-25 04:28:48 UTC+0000,cd2225d7e81044a89037400f79f99b7a,914aaa31bada4f3b878ba78e0a76ccc2,0,1,1,0,2
1106,a49f8f35b8434163a354cc070492ed95,2017-11-17 20:41:04 UTC+0000,2816dbeb3669493ca84f71b60a0efca6,c0d1470427bd4684a5fb21f793c21b73,1,1,1,1,3
6075,a4ad90ea6b5b436d8c6b4695b26bb050,2016-08-19 13:17:37 UTC+0000,abae820a9db8468191227cb15ef5345b,a879ecdcf3634945ba691e1a8da87245,1,1,1,1,3
6040,a4b16cb0bff64df8ad31e90055aa0a0a,2014-03-29 21:33:56 UTC+0000,375a74d332e248e9968803c84d16790c,861fca48f47c4fccae43a799f4442684,0,2,1,0,3
5747,a4c27781c0fe4a8aae81a626567d2b69,2014-07-18 18:04:06 UTC+0000,1fa9792060d14536aecf848d2d81176f,0c0ed374391349fda6d982624bd0bd4a,0,1,1,0,2
3472,a4c3b940191b4c5eb7a1aa9e93b03e52,2015-06-04 16:58:25 UTC+0000,d17e186412be4f849b9b415b169b435b,c1341204dce1463dad3964c3f3f462c3,2,1,1,1,3
5703,a4e6034aa1f843e6a7f10109e93939c3,2015-10-23 12:17:02 UTC+0000,87b5fb9ac71e4678bdea1d5ad84875a4,36ff3b3666df400f956f8335cf53e09e,0,3,1,0,4
4872,a4ff5a4769d448439f52ba85ff8f5173,2018-03-01 01:34:35 UTC+0000,d565c79546f74c79b520453784f456d9,9211738bf6974b16aed44a029d40eabe,1,1,1,1,3
7231,a501dc79081a4fb7ba49d511ddb1e968,2015-11-30 22:08:37 UTC+0000,09b1b0ca231a4041bd9c21cb5a1c9ee7,a1006e6a58a0447592e2435caa230f78,1,1,1,1,3
2251,a505f40ca7fd475ead27c7eed8a73393,2016-03-05 16:35:07 UTC+0000,eafc1be7d83d4c888d50e162bdea38d3,b9b4dd3e497548d0b5c2aba2b069430e,1,1,1,1,3
7124,a512317a48e041e6a45f65d5347ffdad,2017-11-10 18:34:30 UTC+0000,95714849d9654979833c5835bda358cf,c2e5caf8000440c2890891bbf9a9d301,0,1,1,0,2
7905,a515fcf4de14443f88374cc98c593642,2015-02-25 21:09:39 UTC+0000,8ae5c26729eb4796be8bd0d332c294bd,93acc65fba694fb5a4a9e590dcd81c68,0,1,1,0,2
1303,a51a6471ca9c48ad9e76744f0acb3d9f,2018-02-01 14:42:34 UTC+0000,0850887ac0c04f52a6a06d295ed77d29,69a0079e5625471a9a5ca9576bad59f4,0,1,1,0,2
6168,a525fed5abd64a8abc099786d0c688e4,2016-10-17 21:20:04 UTC+0000,53780dcf90264e268d4d3b7cdf069ff4,4cec342f92264b74a7bf14101abe448c,0,1,1,0,2
3626,a5681636e0de4999aa3d7a9a90ffa56b,2015-10-27 18:52:59 UTC+0000,5139909be12e4b6f82ff31ed2fbdea84,7cce25cc8c1042b1b4f135bcacfdad82,0,1,1,0,2
2437,a570c4d8997b4ea48b63b1843c60d136,2018-04-12 14:31:35 UTC+0000,326f38d10a39493aab132fa4ab0f9e27,674513a492bf4c85a2fd7678831d205d,2,1,1,1,3
3701,a57119596e5c4c24b4aed629f9e652a3,2016-05-26 09:25:03 UTC+0000,45b2774bd9bc4a69841bbe238cff9767,223bbfc5e62a43dabfcc43bf35002aa9,1,2,1,1,4
4684,a5774296339d44e8a772560b5a2b7c8f,2017-06-23 10:41:10 UTC+0000,a1bc8981a6fc44e88931d4f4f79fde18,eafcfc428d30485c8e6dd487256b221b,0,1,1,0,2
3096,a57bd170efdf422b94dbdcc4ab042bdd,2018-02-02 04:04:07 UTC+0000,ea710158ab254fb19779b604f275d281,d2307e2205da4759a5a1c27ac988808a,0,1,1,0,2
230,a57ee011f87240cbbe83a215243ef70d,2012-01-19 14:31:15 UTC+0000,af52ead247f0441b997c44f075ecb5bc,4d4bc047c47f4b8cbb9a6365bb1ac959,0,1,1,0,2
4812,a5827357e5534167bc19c61884bd763d,2014-10-21 14:02:37 UTC+0000,8e7d475fca7d467db284cbb38c1318a3,f3f77cdaafed4729b0fe95decacea3df,1,1,1,1,3
179,a583f5c3312c474494d9f98a4c3869de,2018-03-02 14:58:02 UTC+0000,a432ad46c5184ef58f69de3698dd6e60,988f95794e2d49c092ea57fab0e423c9,1,1,1,1,3
7016,a586ee04a71344469d787b1428890671,2017-02-27 06:07:35 UTC+0000,4edae14704e44c4dbe777aeab7c567eb,b8b77df14ad94e7bb64f14eeffb72d9b,1,1,1,1,3
7085,a59737a6f37b4b488a0294cb3c833e55,2017-09-01 15:58:13 UTC+0000,beff88f01f93486fb15d97a797742c08,ecbe372b1e61417999a563f7c1708033,1,1,1,1,3
4492,a599d6c52c08405d9b449b3bd3dff7c1,2015-11-18 18:36:10 UTC+0000,81cbe47575e8496ea0ae73a5a4c32538,a1006e6a58a0447592e2435caa230f78,0,2,1,0,3
5198,a59cc4bdd3aa484483245b459348537c,2017-04-15 20:38:25 UTC+0000,c1ebb27a84894c339429737ac25204f4,be5d23056fcb4f1287c823beec5291e1,0,1,1,0,2
6385,a5a9050fbafc4c5191f8fbb8c1352cc8,2016-03-01 22:12:53 UTC+0000,af776813203b4af1bc94609da6c8aaa9,31313bd6133d4c409006fa9560bc1a1c,0,1,1,0,2
6807,a5af09bc563f4ad3a9216341d786a905,2016-12-30 00:21:47 UTC+0000,91191c59f50145fd934ebca9111a3107,cd8c06e078d0401db5af1128903ca295,0,1,1,0,2
7350,a5b351e8c1c54d248eee5838017f4d09,2016-06-07 18:09:51 UTC+0000,2b20a4452bb14e97aed109a6e80a8102,b7ad4a96122b47fea182dea5cc86da3f,10,13,1,1,15
4715,a5c89dbd5e3e49efbe03c8dcf4065806,2012-10-31 21:06:52 UTC+0000,645ca4c076284f01b1061c41326afaaf,e92c35af7a0440e8b1fed40ee7dda14c,1,3,1,1,5
3751,a5c9bd76d0e24adeaa9eb65893248a10,2017-06-05 06:10:01 UTC+0000,06c2a7494b6d4334bfc5eeb5c2f15f03,ddc273687ee14dc8a9d04b4c1dd54f67,0,2,1,0,3
3412,a5cb749ba4c945a08011b21711a76b5a,2016-07-19 00:43:55 UTC+0000,73316893ae3d4b16a6e39d80e0f69725,a9ad3bd21f8b4631b18d6de7723d4c54,3,1,1,1,3
7487,a5d4e42075ad42c4a130bf5fe1848ef7,2016-10-27 14:16:17 UTC+0000,2f2a3c368ba54b75a43f5b3e6ac7386b,d1dc7e671e05451bb4b4c19db0e9d48e,1,1,1,1,3
6207,a5dba24fa2d4446b8c2a7d9fbdb44a1e,2017-01-17 23:48:26 UTC+0000,44e2699da9334363862c6e123f8a95aa,5f95b0ac821e4e8e9b4fa9fc8eb9ff61,1,1,1,1,3
3514,a5dfa070a89c47c28460557b1f4dabb8,2018-08-27 22:13:24 UTC+0000,08ff4818926547e880ad886a8d35c2d7,36ff3b3666df400f956f8335cf53e09e,1,1,1,1,3
5435,a5e06b55e8f14aaba03b875497d332f4,2018-10-04 12:23:54 UTC+0000,d91e41cd595d4594b4bacb8f38619fb6,2286332b9a014cb5991f06a166b48ceb,0,1,1,0,2
4895,a5e11bc963fc4be2a787120b40e73fa2,2015-10-23 19:11:41 UTC+0000,fa790adaf0d64d718df9671c6916f697,07237f90a48d447ca6754504a07b6891,1,1,1,1,3
4840,a5ff97d4e6a540429d8a77b9c1e4d7da,2014-07-18 09:58:24 UTC+0000,539ebc8b776c43efbf05a17f2636c18d,50cf3d2dd2044152845aceed66b48c65,4,7,1,1,9
7892,a6016c7a68ee451ca91fcd5593fdfda0,2015-09-02 22:41:25 UTC+0000,b39d733ebfe442a38a148ca32bc755cd,05444a2f42454327b2ac4b463c0adbe0,2,1,1,1,3
2380,a61badc940a34e5c9360ad1d2031954d,2015-10-23 20:05:19 UTC+0000,7a8a693f0dc04f4eb447b7faed02de37,36ff3b3666df400f956f8335cf53e09e,1,3,1,1,5
781,a6261b0f55f64030834344b76f9caf3f,2018-02-28 13:49:04 UTC+0000,3d4f7a3b66114d2ebd35efc7d3da81a6,eeb8555e29c840598cc378ceef7859e3,1,1,1,1,3
5514,a62955fa270043c399a1cf861f596122,2015-07-30 13:44:46 UTC+0000,2f7b5402e36e4f47be4576dd65f4d2f1,369f1c8646b649f6997eae7809696bd5,1,3,1,1,5
2858,a642f65a3fc34bee8b736ea9c43f0b82,2017-03-20 19:47:02 UTC+0000,e3c9d3ad634a4f0ca98a5e600b8c2363,369f1c8646b649f6997eae7809696bd5,1,2,1,1,4
2973,a66f344462f44a2b969e603f907f9d0e,2017-12-02 19:27:56 UTC+0000,ac429539fc26400c80a6f4ed5ae5dc3d,aab426db109b40de866f938eb82f41f7,3,1,1,1,3
329,a66f3e0ba10246928807c40fb40014e5,2017-02-26 22:37:06 UTC+0000,e7f58d5678f348f0ac2a46d838967eeb,36ff3b3666df400f956f8335cf53e09e,1,3,0,1,4
2631,a673cb02b315487a893a9d2f2d3faed1,2018-05-30 02:40:31 UTC+0000,b3471ccbda6744fd8d8e5baedee40066,36ff3b3666df400f956f8335cf53e09e,1,1,1,1,3
4076,a681a2f366fc41338cfd7012d24bc41f,2014-07-18 12:30:26 UTC+0000,6e7ffcceb5544ff184f19d12f3998433,5b9b73fbb25549ddac0cd7143c176635,0,1,1,0,2
1797,a69147a67bf648feb6d4245a41b0789f,2017-01-23 23:04:55 UTC+0000,59524c318d5849f395d4b7236be63ee3,c423b56f85034f50a12b0a8600ac6e19,0,2,1,0,3
2465,a691d52364d549a9a98698540e160499,2017-04-24 02:44:06 UTC+0000,927d5bdabc8c4a70bea56916fa5f4ce4,a1006e6a58a0447592e2435caa230f78,1,1,1,1,3
7497,a6a01821a2d04c908b0329ebde4f59b1,2017-12-01 16:49:15 UTC+0000,84fab18ca67d411e92fb6d9a1e3b4c4e,0b7f8b32049c41cb9e3504a15feda8cd,0,1,1,0,2
6896,a6a2c61be7bc4c79b9dfed4112a10f5d,2017-04-08 13:32:16 UTC+0000,321cfac6cb0c49afb6c6227d84b5bdb4,58067dd8d39744f08ae637ee808234a2,0,1,1,0,2
2270,a6bc1b3b000e4ba4a7c308afc9372410,2012-02-15 19:26:22 UTC+0000,230a7934fb9549c0b56376467db2a028,f05b33a454c048f3bbc73f5f3f7f5127,2,2,1,1,4
3534,a6bdd6219e7b4b19934bce31d751d660,2018-09-09 18:00:55 UTC+0000,d241e3dc0f9b446498dabd8a0fba14d6,36ff3b3666df400f956f8335cf53e09e,0,1,1,0,2
7121,a6d463ec6eca4b6c9a7ef36b528ee462,2015-10-06 13:02:28 UTC+0000,10f62cd7a59347d098084f1080a033f6,7ab9f00a02b14e3da551244e54e56285,1,2,1,1,4
7853,a6d65e3bf10340d694300b764081f32c,2017-03-10 04:34:42 UTC+0000,bdb6b19c473646ba9e97dbdbfea31a9d,be5d23056fcb4f1287c823beec5291e1,1,1,1,1,3
2730,a6e3037e6c83443b85c9dd63263f74d8,2018-03-02 23:06:23 UTC+0000,07c8c9febdd746568e5ef1cb1baa6b6a,daa901d127c04fa4b93fb33946e891dd,1,1,1,1,3
4516,a6f5dd13210940dd89e2be8bc1bb7471,2016-01-05 04:59:31 UTC+0000,0b32bc24a7b84f609632934a88f7a518,6318848d88214c3e849aa2bea4308df4,2,1,1,1,3
3623,a72748f2b5ac468983a29425aa613d16,2015-05-27 10:51:59 UTC+0000,f7d983b3d81f4f0dba98daa5e4f47e6e,05444a2f42454327b2ac4b463c0adbe0,1,1,1,1,3
3706,a733063bf4f84f269169dc2468396d8c,2014-03-17 05:28:58 UTC+0000,29d9032eaafd4ca19ce22402d47b520c,4bce59e2537b4228adb73b856d2c6102,2,1,1,1,3
7304,a7487309e2f843a18bf6ff810068511a,2018-01-24 23:43:19 UTC+0000,6c85d8b9de734fabb85df8fe71509cf2,e658a2ed212041e897347a66ac2db5e7,1,1,1,1,3
7106,a751167d082e4e199630e011f0c0c469,2018-03-02 21:11:46 UTC+0000,2da8345357914d0b80286e6ec668d492,4b7737cb8c46400795bdba3a4f333997,1,2,1,1,4
4927,a7526d903fe34f8e836bf1df03e4d0da,2016-05-13 01:45:15 UTC+0000,31040deda5c64f5f8c718df117ee86f1,47b0e0eb62da4ef3ad95e1ffbf0d72fd,1,1,1,1,3
964,a753081571ec40bfb1a33f20b15291c0,2016-10-05 05:36:31 UTC+0000,69786e75d24e473483d0520914e02941,6318848d88214c3e849aa2bea4308df4,1,1,1,1,3
175,a75cc13d197545f180373c771ec0f1af,2017-02-24 14:05:07 UTC+0000,0bc88953f4cb479e8a8281436bcca4cb,a72bde6ac9e349d195a6d356444c9578,2,1,1,1,3
867,a77b1ac5220a4d9b9bf8d89bbf0bb10e,2016-05-19 13:46:07 UTC+0000,42549872907d4f5bbf19b343d7d32022,c5c2ca95fcd3463a8852b8bc9d636313,1,1,1,1,3
5523,a789af50954c41bc95e19c3fdf3e5cad,2018-02-16 03:13:47 UTC+0000,dd6b2015fa0c4d899805e6650e6919ae,19adde8973034043ab515842ecc0d038,0,1,1,0,2
1492,a7a282ba67a246b68b54468494cbd6fd,2015-02-01 22:23:31 UTC+0000,2f7991537c8a41d29da5e968e8f5605e,fe008830949d4f1e98c98bfdf48e9160,2,1,1,1,3
3532,a7af16ca28ac4c2d896567127054b2ba,2015-08-19 22:02:07 UTC+0000,2e4f0d79065d4a44b5eba8ae4cd9f236,a1006e6a58a0447592e2435caa230f78,2,1,1,1,3
3651,a7c31ea926d745abacda460879227128,2017-03-05 12:31:45 UTC+0000,84e1469130214a809012af4247ff50c4,b49a8456b8f84c7fa9665aa42f7987a6,1,2,1,1,4
6368,a7c566d3a0574692a597c301c591d96c,2015-10-23 17:08:56 UTC+0000,559f49a99ee04c139b1e63a4c0962fcc,a1006e6a58a0447592e2435caa230f78,0,1,1,0,2
4782,a7ca0e7261424526b29fada7f5323f70,2014-01-03 03:31:51 UTC+0000,6cbfe5906b694d56973f7592a37a7267,eea91690141e4abb98d66ab65852acce,1,1,1,1,3
3047,a7d1429ee51446d2ad33a5745a4faca7,2016-08-16 14:22:05 UTC+0000,ec67c03e05ca47a296c178e1bedc35bd,de51e745b6354185a0ca5d02dc628416,0,2,1,0,3
2753,a7e1f03cb8e6490d84d760c4c8c2fcfe,2014-09-15 13:40:22 UTC+0000,41ec5d956b554301aabd46e35d5dbaef,3166cc28dcb84b73bee485ede7d07dea,2,1,1,1,3
6212,a7f7925548864973992c3bcfe494ef72,2016-10-02 00:08:42 UTC+0000,cf9e0a31acea4a86ba5de378cd13f3fb,62e145e292c64c1584ad2a95769ce846,1,1,1,1,3
6151,a7fac53e039c4a8aa276a89c83321abb,2017-04-14 00:22:03 UTC+0000,ff95b474b8d841e8ab4c577a7edbc477,6d15a722012441489d7ddf6c8ad9dbc1,0,1,1,0,2
5346,a80a6712d024469097e6a3444d347d35,2015-04-21 10:11:55 UTC+0000,46da567edfe1463093ec516664fb9900,b57db8fdeef84a4eb0563e60ad2a6acd,2,1,1,1,3
4349,a81615f2ec6b4b4cae808c79b9af62b7,2016-04-01 17:42:53 UTC+0000,cb8bfdd4177f47a0869ab4a951f8b0aa,83cfc4f44b9d4fef8cb95530319d8b53,1,1,1,1,3
1529,a836802b948d49cdb8e893bf3f9d5d95,2018-02-10 19:22:13 UTC+0000,f7097727c9364db7bd2a89a433bd56ec,9b1c83cf58f6497f8c0a2a141b86b034,1,2,0,1,3
292,a8381f0f39994754be3982b78ceb2052,2017-01-23 18:04:11 UTC+0000,6b155f254a0447df9a75a775d04ab600,35b9c2768aac4c949e70cea51242d316,1,1,1,1,3
3175,a843a378eebb4921b61653344f185b65,2016-07-02 23:06:30 UTC+0000,e64a1ec0236d4129b8aa23dc400cee90,42deada7c50c4859a34615d70193317e,1,1,1,1,3
994,a844c51085bc4c7e8b031e4334e00f97,2014-11-20 02:59:19 UTC+0000,690c2c8ecf7445a8b753586fa0050504,c1bda2764ee642b3859b1ca6839fa16c,2,6,0,1,7
1983,a84ad62c92664dadb3a4221c83235c9d,2016-06-23 00:44:56 UTC+0000,201e3c4d0740497aabd531f570c49a22,8c135c634fc14af2a15eb06303ca1f0b,6,8,1,1,10
7022,a84d92dc78f7493695161687725fccea,2018-02-02 21:53:09 UTC+0000,cb21e688944c4eea905546dd9de4478e,1b7b629021c845be82787bb98eb81962,0,1,1,0,2
6888,a857b164f66948b09f7ec4a91b3a1554,2017-04-13 17:25:07 UTC+0000,13e274b39caa41418ac6ff99ebd542e3,59439c55c46447729847f7dff2daa507,0,1,1,0,2
4313,a86a475bcac5479aaa835449e460999b,2016-10-31 23:30:07 UTC+0000,a132b6f4b4a94ceb931dcfac46a625a8,9d9705c23af44a0e879b4707846fc892,1,1,1,1,3
4324,a8796fd6ea234a6787311bd8ea465402,2018-10-06 15:48:22 UTC+0000,40572579571e478fad786d120cbbe265,0334dfd55c574601ba8e56b4c6e2e4f0,1,2,1,1,4
2128,a8814ac11d624b1bb6caf83eeb219a48,2018-02-21 16:49:40 UTC+0000,11c472a4f3da4bc1abb28da86130d3e7,e3605142dffb4d87a0f8b950da727f73,0,2,1,0,3
2883,a88688faa8e04de5abbb7ba2045339e2,2016-10-26 18:31:59 UTC+0000,3c44d445d12a4be6a593d51119a3fb34,e1049f7f1b8c4f90b7db30e14cd0ace3,0,1,1,0,2
136,a8873a67904f4f5a9bbd45d5e9aaffaa,2016-07-01 23:13:31 UTC+0000,c015066242e446059ace68a22f744ced,e6ae38ca62d5423daa34d7088f4295e4,0,1,1,0,2
19,a8b8e257d51d47d2848a8bf501ad2d97,2016-06-02 18:54:57 UTC+0000,4437e2b6d488434d84588b4877ae7c4d,12e8dea2f3534f6dbc31701cf64f9a4f,0,1,1,0,2
4941,a8c4b29505d6448288aa2d04556c3f4f,2017-01-13 21:24:11 UTC+0000,74bdbe7604fb496e8af9badedfaae890,9496418c2b6a4c059442c81cd73d55e1,1,2,1,1,4
5513,a8c5b9fccba14f38a1b8fc5a73563765,2016-05-13 03:23:49 UTC+0000,970dbd88f855413da86e25e8a86641bf,b65702b81bae45c08757f88e797afcf2,1,3,1,1,5
8012,a8cc6e6a264543e6b0dc6d4a62016ba3,2016-12-03 02:13:39 UTC+0000,d461baaf9a8544a0930182f655daa548,0b17f4e9d93c40eb9a5d087865084ce6,1,2,1,1,4
1419,a8cf64ee6b0d4451a430ced863ee811b,2015-01-22 18:29:48 UTC+0000,611728105d7645cf99d61689b529ab04,6c45a5332ff44c09b6c3dfdf53d2bc56,1,1,1,1,3
4317,a8e0badb1eb84d10b9bbbd3b7b467ac4,2016-08-24 00:28:38 UTC+0000,a43c1564b1ed45048e2b74faab486e71,50d1429c5c6b44b59e581b53c92c60b5,1,1,1,1,3
7873,a8fe0fd797784106bc7bd2172cbb8d87,2018-01-13 00:39:25 UTC+0000,6929adbdcb90485888afec7926199266,887c5a142b42466fb74740d72989fc74,1,1,1,1,3
2904,a8fef3dd31b9427cbd490b6df2deb872,2018-03-14 11:50:28 UTC+0000,4c924596ae394b25a1da67b0902efe11,8b30413febb749f582781486ea22f40b,0,2,1,0,3
7906,a906fdd832d34c698e1ada26bbd80380,2017-08-22 04:24:14 UTC+0000,c755b11a37824b0995899b7d6fd02730,e581ca11c8fe4f15b4367d75edfa64a9,2,5,1,1,7
68,a9123acdd55542d89359fb1815a848ca,2016-04-21 22:55:12 UTC+0000,87508ff56ea24ca9a777eba288606209,a1006e6a58a0447592e2435caa230f78,0,8,1,0,9
2365,a91aada328064a30b63ce8fbbd99f46b,2016-09-13 22:25:08 UTC+0000,1fd28462e99e48a59983919f5df00faf,375133d6c3f44ecd96f25dc34121022d,1,1,1,1,3
5488,a91f6004771d4356bb13904b5ed6ef50,2016-05-31 20:01:33 UTC+0000,26d85c382a0b4a22b4646e219fba6d00,58fa5e95fe9e480a9349bbb1d7faaddb,0,1,1,0,2
3583,a9257d10f27c4fde9077854343e1cd39,2018-03-22 12:47:23 UTC+0000,b9cde38caac64401bd97ea03e2f53517,b8a1f9a434ea412dad6ecba6c36d7f4b,1,1,1,1,3
7863,a9384590b5944712bf3a6228f84a2d39,2016-05-26 11:04:29 UTC+0000,d6c8487d4be84384b17507d92de98a09,2706ab56034d4ead87747b981d4aa741,1,1,1,1,3
6233,a93eec36752546608337450fcf2384e2,2016-05-22 07:14:24 UTC+0000,ae5acfc4bbef434d993cda2f1e5eeffa,34df64a2783a4623b22b4f3afff97d28,1,1,1,1,3
4675,a945889efa7c414a8ccf96a6a548f609,2015-10-28 18:45:21 UTC+0000,ac7b13e008f14ad3b070b2606a1ee354,a1006e6a58a0447592e2435caa230f78,1,5,1,1,7
7967,a94babc61dea43e085cf6a2507dc5cad,2014-05-02 19:01:20 UTC+0000,63e82bbc08b34b9e93fed5819d29a071,18237fb03c8d4d368085a5dd67c5307e,3,5,1,1,7
7108,a95a469bbfe341f0967eb55217121f51,2017-05-10 18:40:31 UTC+0000,de44ef3b2b6f44788050b62997f40fc3,03dc41ec57814bc7ac1a3b26baadedfb,0,1,1,0,2
2908,a95d50904dd340b78629df4ba2d542b9,2018-11-27 21:31:59 UTC+0000,77402e58a15f49979d3e4394635f97ad,c845e9be9393441bab0ecac421d789aa,0,1,1,0,2
7100,a965109b9cae4243b1d0613420c397e2,2018-01-26 20:49:28 UTC+0000,f9b2461d0ff24a73b05f6f175f788482,08f3b2a0eedc4e05902b100b9edf691e,5,1,1,1,3
6809,a96547de4f844e328f9902ed8f02acee,2017-02-13 01:50:47 UTC+0000,a9ae15f6ab314147b2b54f9ce79247a1,58a39fde2cdb4036a4e414624afcc0cc,1,1,1,1,3
7820,a969419fab994feaa8b6828a2c0e147f,2016-06-24 21:35:43 UTC+0000,edda461cbc2541fc958a76b9a8752570,fe5fc534894e45c191e87f8c2ea0c6bd,0,1,1,0,2
947,a98b8fa1f2044472ac53579727f802ff,2018-01-19 18:40:35 UTC+0000,fe532a50f4814c588c77de7c939e743f,e4b617982f7541d88dd091849596d92d,1,1,1,1,3
4544,a99dc667a8b446c8a33545c7f114ce80,2015-05-07 19:13:10 UTC+0000,853f911e05994274beef4e8b7a89a42c,a1006e6a58a0447592e2435caa230f78,4,8,1,1,10
342,a9a1a1fc14f5464a952b592ce9c0d8f7,2016-09-01 10:53:31 UTC+0000,f612bb7ed0204dbfac6e8cb39906a9dd,408723f34bf94a9ab5839b068c66f037,1,1,1,1,3
7146,a9cda3ba024b4288b5c77cf9167c371f,2014-04-08 13:59:06 UTC+0000,0982cc52e8ec44219ce4369359e6924f,0355aaad83704ad98e6d71b79db85849,1,1,1,1,3
2358,a9f70909578642a8a5a896089581aa06,2017-03-06 14:54:21 UTC+0000,972e2bf6856d4a2c9e9dc1debf48a9b4,36ff3b3666df400f956f8335cf53e09e,2,1,1,1,3
684,aa09191cc2e14b9a9799a908d66b6d09,2016-05-22 14:42:55 UTC+0000,868d96a2146f4778b7013e9f5f6d5c4d,e0c3c9fc3634444ca0474c231b2f5959,0,1,1,0,2
1213,aa0e7d1d23eb4658b041d451637c7630,2017-09-27 22:11:27 UTC+0000,29a2a2dd47fd4b42ab3c98fa6421481f,4b7737cb8c46400795bdba3a4f333997,0,1,1,0,2
2207,aa1b3090c890413f8d52f92316421060,2016-10-13 20:31:53 UTC+0000,be6461d97cc64e909c7aa876e6e631f8,a1006e6a58a0447592e2435caa230f78,1,1,1,1,3
4595,aa1ba5c1aef643598cfef56ef1b0b176,2017-09-18 01:21:26 UTC+0000,b6a8d54679884c79a1e67b3d84338e53,19c5171f824a49fe866f16eacc1382b5,1,3,1,1,5
3769,aa22435c7ecc43b6be68de226917a443,2016-05-05 13:04:20 UTC+0000,89775ea4b1614ba3bc4a86c02130c144,e3529e64e70643b6889353db79eeea3e,2,1,1,1,3
3051,aa358b3e2bf34ea3806c05739900e041,2016-05-04 19:44:42 UTC+0000,c6a6bcf52c3f408d9a1d440f3ed850ee,31553bb914964a1697a2f9d58fcef39f,2,1,1,1,3
379,aa45d24f40d4489ba69dce163a6d197a,2016-06-19 22:52:27 UTC+0000,46abcbf11c0c4660ae806f2a0ba9552a,58fa5e95fe9e480a9349bbb1d7faaddb,4,10,1,1,12
2004,aa47498fb8844442a5b70e21e131b2e9,2016-05-11 19:11:41 UTC+0000,f26b3d21b70a40149120f5c3bdd93fd0,e08c6ad14ba24315afc5985dedc71be5,1,1,1,1,3
1298,aa48bf15774e44a1ad4e0c2379b8867a,2017-03-15 11:20:57 UTC+0000,dada358bb53d4c3f9690a64be041bfba,be5d23056fcb4f1287c823beec5291e1,3,1,1,1,3
4134,aa5af4f15e90474ab5c6f05e97fe0625,2016-06-25 20:17:56 UTC+0000,52803010624744059b763bcfe18c87b7,4dc7d9040592416f98c0bef1ad2c31f5,2,2,1,1,4
3612,aa5d6cfd7b8645f494c7161f65857eff,2018-01-11 00:38:12 UTC+0000,4386de9ba04d414fa49f3a24c769ab35,887c5a142b42466fb74740d72989fc74,3,1,1,1,3
4511,aa83352d47844080a9fef51fb56b4f59,2018-06-30 04:38:11 UTC+0000,84b4f4eb9d2e4039bd7aff09e46c25bf,9bdc8a2b5c8b492980d289ad6dcbfc1f,0,1,1,0,2
388,aa911a897c794ab19a2a417e99fc2cb6,2018-01-11 23:22:01 UTC+0000,320f9d4b106d4a56ab7a8c71c06c83cf,d9ee4b1f242d4bf2a395b278faa56de4,1,1,1,1,3
4674,aa9fa1f990c145e4834ea033fedf3e50,2018-02-17 08:20:23 UTC+0000,504ab5001088479a816e65072d2a79a0,a6d33c38902546849c36ea7e9e9f0870,1,1,1,1,3
403,aaa5b501f2c9426690a4d91f961d6150,2015-10-07 20:33:21 UTC+0000,6a7853f771c84f1599dec41b382a1d28,fa52bb8a7ca24aa896e26887c75e702a,1,1,1,1,3
7178,aab1c97de0094e4395c56ce99a81e537,2016-10-30 01:17:55 UTC+0000,500ca43ff0a54be388c55db9eaa5b77f,7eb73efbfb974d92b24408d514f7c213,1,1,1,1,3
6647,aabae20e0e3b4bf8abbbbb8799b92bd5,2018-05-04 01:53:15 UTC+0000,bad78cacafb647979ea9ecc85d3a80d2,fcf74a00ac844d8a8a11e481a4f1489e,0,1,1,0,2
36,aabb5384c3484dca91aa63ac8a277ef3,2017-09-09 20:52:49 UTC+0000,3af4bbbed1994ea998d885416064f687,25f5e94c4cb14e569aeff7cb2c98222f,2,1,1,1,3
576,aabd502e48084c019bb4fdd39ffbda90,2018-05-02 19:13:31 UTC+0000,9907db631e6c4808a4a7627517a9b980,4dc61581ec7b409bbd037e483f53ba0a,0,1,1,0,2
178,aabf9b9df1944c0f8b70b8e651eb04be,2016-05-07 17:24:45 UTC+0000,e5844c307c0b42f88a7099dd6780b707,58fa5e95fe9e480a9349bbb1d7faaddb,1,2,1,1,4
4597,aac30608b92249c3a912805d49c3464a,2016-07-15 16:32:57 UTC+0000,b847510256514fba886451373f0a363f,092a9fe9883848a8b6126d4bb1c67918,0,1,1,0,2
4940,aadfb4caa2d84a02bccdf1c0323906a0,2014-04-06 03:03:01 UTC+0000,84f6685a933b4922b449312f697d54e9,fe4543418c0846e5a65fa22b4ad9a304,1,2,1,1,4
7520,aaffdf19b0324d3e9a6f20e227d2dce0,2017-02-08 19:09:19 UTC+0000,f44af638698f442387f73ef7d4e99857,96bbbdd06a334805a0501034d9df1aa4,1,1,1,1,3
1368,ab059ce2bf03428f94966dda97b896b7,2018-05-26 15:52:13 UTC+0000,7ca4e81da5524d519b5a0607efc0f809,ce7ba6b41051489b9d42cdf968b93a2c,0,1,1,0,2
6251,ab0ce714447946c9abccd8c123c68e56,2018-09-07 10:45:55 UTC+0000,e0b8af12a9cf4282a873ce96b309ca66,3871ba8256b24ed1bd82e896774f13cd,1,1,1,1,3
7561,ab1780557b3b41c3a35070fa2c019fd8,2016-05-13 21:06:18 UTC+0000,47b2dedf9a674dae8c475564efc23725,7667c23d26ab409ca3e49758f5367925,0,1,1,0,2
7563,ab2c3038067045878bac6d071a768c62,2014-04-25 03:02:41 UTC+0000,79bb7089346c4a0e97d08a736207c4d8,fe4543418c0846e5a65fa22b4ad9a304,2,1,1,1,3
4780,ab31840b19be4bd584d38aab4f9de17d,2018-04-03 14:27:12 UTC+0000,e2b6ea3961e14fd19346f4fbf8b292c7,db8d0c76e89a4cd4adc28e2aa481f067,0,1,1,0,2
2302,ab46cdac27e94ab69ca84414640bec40,2015-10-28 04:38:24 UTC+0000,b199c8763ead4346b79509dc0ee2721a,8435fd16c86e492885acc2cf5b6e372a,2,3,1,1,5
7498,ab4d5075cab745f8b26e39f3213d49f0,2016-11-30 19:23:57 UTC+0000,464ca825755047c28b924043700f6470,32c5b4ffac524531a64b161442a64510,0,2,1,0,3
4474,ab505e44e94d4d4b9aebbd034706d978,2014-03-18 01:39:14 UTC+0000,81b79745cfb546f3997d1666d3c6a2fe,77a65aed859f4b11983cd07399f1e3b1,0,1,1,0,2
5637,ab54c042ea8c41138478408ea0059de5,2016-11-30 14:30:58 UTC+0000,40c0f823c25b4b9cacf450a3f988ffe0,416321b48a634ac8a53602625f0a5d40,2,1,1,1,3
5121,ab6ddd92f6a84ec5823068a5ac439670,2016-07-21 14:14:51 UTC+0000,05fbe705784d4d1d818b99e5d18323cc,1f52a53f782c46298b933a5f70d28f67,1,1,1,1,3
1718,ab92eaa7b7234aa3a53a40e8331ce99d,2016-03-01 18:55:23 UTC+0000,60780faed6c74db79be8071e5bd6e55d,a2885a4366ef47768abbf8395f2b4371,1,1,1,1,3
1988,ab9506b72b414378afabf5823fc938cb,2018-10-22 03:47:17 UTC+0000,0ef5c083ce7f4d8b92a84e0cbbd44bfa,cff9a9679be1434f93afd0caadea94bd,2,1,1,1,3
7595,ab957fb414ce43d6be9af7bcb4d9b13d,2017-03-05 01:44:59 UTC+0000,4f56cc2f81924a41a2206c3c9b30ac99,96bbbdd06a334805a0501034d9df1aa4,1,1,1,1,3
6443,aba2642170484e24b6f88e4b83d5a502,2015-04-08 15:18:26 UTC+0000,f6ec98255f24433d8fb3cb91f318e7c3,df31b0be0d4141079074eb2130c60057,1,3,1,1,5
2807,abab0d4b9b0f4e6ab7a898f13d52e71f,2018-02-02 00:24:05 UTC+0000,50631f80378f44e1a53156827651f181,a6d33c38902546849c36ea7e9e9f0870,1,2,1,1,4
7991,abb4921d774a440a98f7cfd39ce29860,2016-05-20 22:54:05 UTC+0000,f43808a97b2b4056bc9ddae165777fb4,bc46e3699d92477ba8c7aa723e54a151,1,1,1,1,3
7290,abbe3bbfe06d4c08ac99c2923eef0480,2015-01-31 18:06:07 UTC+0000,7f4565aadf5f4ae3983ba7af20a33ae8,5b42a5b81d884d238259d796606acdc8,2,3,1,1,5
1602,abc6a159acc746c98cdd6876fcc243e5,2015-09-17 20:57:28 UTC+0000,d6aefc6a561c4239b3831efa7d4964c9,83cfc4f44b9d4fef8cb95530319d8b53,1,1,1,1,3
1950,abc9d4994fb14189b20841c60459f0a8,2018-01-25 18:25:51 UTC+0000,31e9a9a6ea904cbda9d7d9bacbdd6fde,c258f388f42b4f608dd6fd8e9b6c1dd6,0,1,1,0,2
6189,abdb91f1e6834dab86da3e682845d23f,2017-04-17 22:32:20 UTC+0000,c87df2acf073470b904141f5b4cd3263,c5c2ca95fcd3463a8852b8bc9d636313,0,1,1,0,2
6477,abe7e7e26ab4493b8e92b6cf827ada81,2015-04-17 15:12:33 UTC+0000,6974372821cc4625b27942ce88ae3b4a,de6aab0719fb41dcabba94d5cca74b54,1,1,1,1,3
3131,abf0fb35f3284ffd99ebc68f87e57cfb,2016-02-06 01:03:35 UTC+0000,194f864a3f684bd2afd0ce188aedb23b,36ff3b3666df400f956f8335cf53e09e,1,2,1,1,4
5284,abf9a69a7afe49cb9afc618ac311c84f,2015-10-14 19:14:39 UTC+0000,1cd3fb5f7fef48d58d35fc1a5df7ccb5,2adab7916b3747af85b2d82e188c1dc3,0,1,1,0,2
3007,ac089a1f25184fa491a81fa7c31a9a58,2012-10-03 20:15:03 UTC+0000,852e2a3f132b4d5482b0646dcf439f0c,7d425e8d7cfb4fe7b0702fff4d6d84e7,1,4,1,1,6
5665,ac0c5d9fd6604f398a4205c8161ebf9b,2015-06-11 15:12:44 UTC+0000,b8aab0829ab5457faf930d2efcb95a02,a1006e6a58a0447592e2435caa230f78,0,1,1,0,2
11,ac17365b14f94edf805b65a88a7ae83b,2016-05-13 15:46:59 UTC+0000,8e800c8165de47a1bdfc5a457fcc8d4a,0c8001935b314038adb2a17cf57ff8af,3,1,1,1,3
704,ac177e6b00ed4123a4e3132320b35a46,2015-05-07 12:53:52 UTC+0000,6b5d8a8a6e594116965525128f009ba8,2bc887feadaa4ef696d48355583eebc5,0,3,1,0,4
3574,ac28c9885fa345db8117df51157b1b52,2018-08-02 01:08:29 UTC+0000,8d02eacb7b5146a0bcf57a2c310be2f4,9221f63656ca4e8d9fbbac486a4e4292,1,1,1,1,3
3563,ac2934c75fc744c2a367c605f92ed6ed,2017-05-05 19:07:49 UTC+0000,77a2b8958af74aab9f6f67cc6af5c7d7,ecb0d6a8b37740a1a8f49c95e171e5e6,2,2,1,1,4
6495,ac3a277441c842888e7e27e057897936,2015-11-05 05:58:33 UTC+0000,70dc45df65fc45df8b09773d4a7d9341,d9911772c08f433ca0f0c9beaf4f7cff,3,2,1,1,4
3042,ac3b100501ce4531bf9f30cfabcc04a5,2018-05-14 20:26:42 UTC+0000,88d7093e3d0d4ffe99887695700a62ef,60d8da72a97c48b080a2f5b38fd4ae3c,0,1,1,0,2
5315,ac56fde91b8b4388b20095c4a889898c,2016-04-19 17:05:05 UTC+0000,4cce778ab06343ba9505b40b9f1fe8f6,61f8266dfa614a9193b94308eff57343,0,1,1,0,2
6610,ac59aaae38174166b435d271ca15fe96,2017-01-19 06:50:07 UTC+0000,6a67904dac294a7da97590c7e7c96495,665a4dc589d94329b7a752ad551830ba,2,1,1,1,3
7579,ac65811cba1049c285593d3d889c5ea4,2015-07-28 13:40:50 UTC+0000,81e9d32455f240eab3f46e7cc48918c8,369f1c8646b649f6997eae7809696bd5,1,2,1,1,4
5437,ac7361d5188a475884597fe39defdbf4,2016-08-20 14:13:37 UTC+0000,5c2194793aa64ad18a0cac064871bddf,be5d23056fcb4f1287c823beec5291e1,2,1,1,1,3
6580,ac76173023d74d4f93bfff924de6f1a8,2016-06-22 18:26:13 UTC+0000,59c03c6f0d574226853b3ae526cb6c8f,7aa36954229345f28bf2434f90c3f282,6,3,1,1,5
5000,ac84f38977b64204993d47593633116a,2016-05-23 18:12:05 UTC+0000,1c6679f52d56440bb97ddcaa854247b5,34b1e8075ace499f897000cc68bfa40f,1,3,0,1,4
3618,ac935aa8510c4330b4d8bdcdb16cbe39,2018-04-05 17:12:08 UTC+0000,ab4308c11a8445aeacc1322aee39a43d,b148168ad344409eb63c0f3af466f83d,1,1,1,1,3
1488,aca27a1cec164e8cbcab5f00e10e99db,2018-03-06 19:27:24 UTC+0000,fb5caa96972149afa3f1d411d269dfc3,be5d23056fcb4f1287c823beec5291e1,0,2,1,0,3
5957,acb347e1702c43e0b2c5be65bebd364c,2016-05-22 01:26:30 UTC+0000,a5ccb4bf99c74edf8e27ff36f3577fed,ff7a84dfae5f412d9b3857784c3d273a,1,1,1,1,3
428,acbadd9697134f0a88d5890eed2073fb,2018-06-22 18:07:47 UTC+0000,8b304e0ac14f4c6a8c51985482161f7d,cb3d08d074bf4e2eb4c94c66d3f26b19,0,1,1,0,2
4225,acbbf08362bf443f96e76fd368b10876,2016-10-28 00:24:16 UTC+0000,86797f4162a44ca693abe49ceb235eef,dc5a781ed30e46b6911acb328ba8f6d9,1,1,1,1,3
2996,acbe4d3a29e048f4a7e74326aba6cc85,2018-03-19 14:53:12 UTC+0000,1674ec95053a42ebb83ede579eebb2fa,11dfdee44f4f49bd8fe9e4c9c7905c59,0,1,1,0,2
5960,acbef8bab48a47318396d75b88e71771,2017-01-24 14:36:39 UTC+0000,db4ced0dabe54e36b829ede8b81268b9,c39329e6c790449f812590c3b897aca8,0,1,1,0,2
1005,acbf2e0e30264ca9a5ba9441d39f688d,2013-10-09 21:16:20 UTC+0000,a6cb6fbeea3b4735a89017064d3597c8,05444a2f42454327b2ac4b463c0adbe0,2,1,1,1,3
6798,acbfc53dcbe1476b94442ec8a5545a2a,2016-02-16 20:36:25 UTC+0000,ff83448878594a96a0395c03c6cf2a3d,a1006e6a58a0447592e2435caa230f78,1,1,1,1,3
6772,acde582e3ae144fc925e61e8705c5eda,2017-09-03 01:58:34 UTC+0000,b4332e6c07db41879e693e156e46e7b4,b0ccbfab6055496d9a7b17a0ac5f0165,0,1,1,0,2
3134,ace047362bf34e83ba51758a86f5fd49,2014-06-03 22:46:26 UTC+0000,a817dbda38c94c1b84834680a50c65fb,92259cc6e17e4eb78bc069d2ac901e81,1,1,1,1,3
848,ace837e2e75f4967a877619f509b8b91,2017-05-11 18:17:47 UTC+0000,df64c7274c8d43589801419a5d0a3a52,496c608fc29a45d4aa0489585be8f99d,1,1,1,1,3
7210,ad06fac4089b415db391016daef2f183,2016-05-23 11:48:58 UTC+0000,7be8987786084cef919fe9b5d908daad,8c135c634fc14af2a15eb06303ca1f0b,1,4,1,1,6
1549,ad20903d916848acbb8f2b43ab619f76,2014-07-18 12:07:29 UTC+0000,4e75e20019fb424d9bd8677b05e9de00,550f2d81126f4d59b3fa69a2ac5821ea,1,1,1,1,3
5655,ad2e64f8934c498aafee2f484e723a3c,2016-03-24 15:36:55 UTC+0000,76a8fbc6a93a4360930d65ccd06af7d9,4bbd5593e5a7439abbe21721e9f97ee6,1,1,1,1,3
7632,ad39a0425cc6446c9389304b891b9424,2016-12-10 21:30:06 UTC+0000,b8c0e4dfe23f479db8ab957a221568b6,36ff3b3666df400f956f8335cf53e09e,1,2,1,1,4
6800,ad39e71536db4aeb8aa8d4d2400dd556,2014-03-06 01:06:35 UTC+0000,1870dba8b5a0493bbf227d1d22f504f8,77a65aed859f4b11983cd07399f1e3b1,0,1,1,0,2
2967,ad4b31476abd42e687c31047a088cd9d,2018-03-21 00:11:26 UTC+0000,73fdcfe82aa34df49254fe4262d5d181,95afc7f032aa41809195d0d1f989c9bc,1,1,1,1,3
5918,ad51a5213d8d45cfb312e72eb1494fb8,2016-05-08 19:46:39 UTC+0000,dc497ffee4714440b3fbd70e7acfa808,58fa5e95fe9e480a9349bbb1d7faaddb,1,1,1,1,3
6988,ad5f82eb56344bad8218db4259900038,2015-02-21 00:39:43 UTC+0000,cf9f4a49916f4706a44e1da3a079950e,f39d1cfb0d11492d8e3291943674ace2,0,4,1,0,5
5172,ad7193dc3e1c4d32b5ae6e6c2f5f7c05,2016-11-15 13:44:45 UTC+0000,36b94dba031542d292f9a4ecfe9e3125,f1cc078488fa49b2827a9671ab1cc582,0,1,1,0,2
6725,ad803564949b47139cd21076cf9002bf,2017-01-11 17:47:06 UTC+0000,2bd2a5ed18634eb28be1c3481e353ea6,331c075b95c74215b0435818457f0324,1,1,1,1,3
6138,ada0c4a808944789a29aa8d1b94d20db,2016-07-11 08:52:32 UTC+0000,7a275aebf47a49c394046777e5c7a755,a7b01a1f0c974c2bbb60c4777c770659,0,1,1,0,2
4955,ada1b79c6edf438f9326c07fc057e85c,2017-02-02 00:07:20 UTC+0000,ed53a4c4946d442d9fa956155e98261a,36ff3b3666df400f956f8335cf53e09e,1,2,1,1,4
2517,ada9ece11b13436196a596cf1b1fb6ba,2016-06-16 16:57:57 UTC+0000,141a10eed604476f9d4a509923293a75,58fa5e95fe9e480a9349bbb1d7faaddb,2,3,1,1,5
4060,ade0bb7c62234d46821f52879c3fb995,2014-07-19 12:49:05 UTC+0000,11840193e1e14f8da852791806e4fd64,7b23d6e64a9c4b9682d9bc6109249c61,0,1,1,0,2
6354,ade0ef4de0cd4272ad2c048460da0483,2014-04-26 02:10:35 UTC+0000,f8966c91d74341ed8be5af8f6cca1c75,05444a2f42454327b2ac4b463c0adbe0,2,7,0,1,8
4124,adf8ff340dc644ca974322d4b4a7078a,2016-10-21 00:38:13 UTC+0000,97421fd550a64088b4b1e4c9cf94f7fe,b4d3eeeff06b4b94bb82f3265811b697,0,1,1,0,2
4874,ae078443d934434c9ea5893ccc7c60bc,2015-03-04 18:36:09 UTC+0000,a6b43d7f09c64448a5dfe39357f6c498,c1341204dce1463dad3964c3f3f462c3,1,3,1,1,5
7182,ae10994ddaa5499496e5a666cc2db232,2016-09-13 22:05:37 UTC+0000,19d7410a1cdd498eb8e7be6ce9449052,6e3ce34fb67444d2ad14e8b67a33c7e3,0,1,1,0,2
7230,ae2c399ae4f84776acec916e6706e92e,2015-10-16 01:51:41 UTC+0000,697127aebd2c4bc9a0124fa5681754f0,bc46e3699d92477ba8c7aa723e54a151,0,1,1,0,2
5799,ae2d836ff380431f9238456daf5d2b47,2015-06-24 14:25:22 UTC+0000,dcb2f6a3ed37438bb8c4871979e3004c,e644b51be2364df3aad4521bffef791f,0,1,1,0,2
833,ae3108d43f364070a1e21d581e506918,2016-10-21 09:40:55 UTC+0000,3bd4964eb5f74594bff4a2adc52ab519,4fd49d7ac3ef40b086bd90e09bdb0f68,2,1,1,1,3
4945,ae48b35ae9a74d588b35518c58f827be,2015-06-23 16:05:48 UTC+0000,68900b9fbcc8466ca8ca4c258bf9db90,a1006e6a58a0447592e2435caa230f78,1,1,1,1,3
1539,ae59ef32872242349e75eb0bf2429fe7,2012-03-09 05:04:41 UTC+0000,48761c928c3141c2b2a056850ad9d9a0,9c5803ae43ca4cf6b27ea85871625116,4,4,1,1,6
6984,ae7472dc56b44faa886e16c87bf6d441,2016-11-25 18:20:33 UTC+0000,2e20f9e6da6444bc84602de00a0a7a33,83cfc4f44b9d4fef8cb95530319d8b53,0,1,1,0,2
4991,ae79142f790e48ec89aa568b87bf7efb,2016-05-30 01:52:28 UTC+0000,1625b8463f8e4ea088cf733d50407d36,58fa5e95fe9e480a9349bbb1d7faaddb,0,2,1,0,3
6487,aea10a106f6e44b79e0e7b9942d81b96,2016-05-13 15:25:03 UTC+0000,76c9d16264304ce6b1da70f451034278,0c8001935b314038adb2a17cf57ff8af,0,1,1,0,2
6796,aea4d900401d42679f6ce85b923659b8,2014-12-30 22:30:04 UTC+0000,4727c586ff2b466f8f5f4b0aecf619fe,54537882ea844fb6a38fcc53479779c2,1,1,1,1,3
7024,aead990cbb984bc28b4d1736b16d7bc7,2016-06-26 02:57:55 UTC+0000,6f97d682fdac4a9083ea4b772c95e8e0,30b1ef88592643dba57c33e4626684c8,1,1,1,1,3
5133,aeafeb8ae8404a31b1075f0902ab9766,2015-06-02 19:07:21 UTC+0000,6899339cd3574ee9bc53bb5269709da8,a1006e6a58a0447592e2435caa230f78,1,5,1,1,7
263,aebfce1fb1324ba0aa6f71cc4964e2ac,2016-05-27 01:27:06 UTC+0000,088ed1a3b265486d937208248671a314,4dc0698c310d4688b1074d2d59306a74,1,1,1,1,3
1425,aec211eae7d74c3f823314f46050e0fb,2014-10-02 15:13:14 UTC+0000,7178f7f149804074bfa45e9371047b0b,17001ea532b044b08a006a989924e2e9,6,2,1,1,4
7780,aec252821f9b41b696db3edcd4562a78,2015-08-16 15:52:27 UTC+0000,8481f3f9a2ae41baa68f2573549be307,73bcea14bfe8427185a5de7748b650df,3,1,1,1,3
5783,aecec039106e430d845eec11489b407b,2018-10-17 19:37:57 UTC+0000,9c246ef8a7a544f4b8ffcf75720811f6,1460905b74994213b80aff1a5fab48f1,2,1,1,1,3
2346,aedc102ce18645e797f262aa389a57fd,2018-01-09 00:27:43 UTC+0000,7bc43ce8483d4e80aeda35b842c49d3f,887c5a142b42466fb74740d72989fc74,1,1,1,1,3
6699,aee43e62b9664d03b58cfcf9eb2a53a7,2016-09-20 10:32:11 UTC+0000,e9f469fd5bb3431bb288b12e133a0ca2,abb4e22348084910adee4c5330db925e,3,1,1,1,3
6980,aeedad0282804ac8b3148c3b50f47d59,2016-10-29 19:41:17 UTC+0000,e334e3db8baa4ddcaf302713d91e824d,5f95b0ac821e4e8e9b4fa9fc8eb9ff61,2,1,1,1,3
5897,af1515aa37ea4562851de78c682d21b7,2016-01-11 01:44:09 UTC+0000,59406689433f44269735da268389ad85,a1006e6a58a0447592e2435caa230f78,0,1,1,0,2
1515,af1753a733d841db8fa3f8fddb897530,2016-05-04 14:35:19 UTC+0000,58048ba8a9d64de0ac8882f83cccd1b9,33dad4c5547d4569b9235017b411a01e,1,2,1,1,4
691,af18eaeaf1624415b7efdc80af7fb6d1,2015-04-26 22:16:37 UTC+0000,402f17ce2edc4dd4abbe38b22f0a12d5,7aab6fb9a4ae4d0197fd2bc05960ba56,0,1,1,0,2
4867,af2ad348bab8431b8f07bcda8ca120a5,2016-05-07 21:47:10 UTC+0000,9a5501f5f08f481e9609a92d10c319a2,58fa5e95fe9e480a9349bbb1d7faaddb,1,4,1,1,6
4215,af38b8810e814f1da79c22a409bbdb8c,2018-02-14 19:16:36 UTC+0000,e4ed5329cf604fc9a9b55d1703d879a7,be731dc1c1d74521a22baa946457b2da,0,1,1,0,2
7321,af39256bf9274985b8b63e22ffdaa7cd,2016-06-17 11:03:49 UTC+0000,b324ff7ad3c44928aaf61bd99062b016,8478c6985d1e4ee88086754cf6200ed1,0,1,1,0,2
5723,af47c653fffa485c8d5958be05a78b6e,2014-03-13 17:14:20 UTC+0000,3bb95411cd3649c3814719c736616a1b,b6dd78b5458e4afbacc8716976d682b0,2,1,1,1,3
2300,af53502fc9d2470d859fd2b7742ff8b2,2016-04-07 17:34:07 UTC+0000,4b7372e64d974a79aeda9522ba1bb161,a1006e6a58a0447592e2435caa230f78,1,2,1,1,4
4166,afa351b960e141cda55a4c967901339e,2017-01-23 20:46:09 UTC+0000,ea2bf0dcf0f24165b0c54f54dc0128c6,6fc2a662a6f141a18ed3c99f17dce4ab,0,1,1,0,2
2557,afaee702fcc44901b2c29d14bf7538ee,2017-05-10 18:42:10 UTC+0000,d02ecf53eed94a348cef8c1b01ea9808,cdceddf41de84bbe9677c2530662e921,1,1,1,1,3
3636,afb499f8a4e2459c8e47227566348f6c,2016-05-23 22:14:31 UTC+0000,e27bab8c32ae4c3fb3517379bef45712,7667c23d26ab409ca3e49758f5367925,1,1,1,1,3
6522,afb837755077499c81e105d1da3338b0,2017-01-04 03:40:59 UTC+0000,51fbcff820cc483ba50822749fd44bf7,32c5b4ffac524531a64b161442a64510,0,1,1,0,2
4536,afc95cc8e908467e9defe62b0731ddd1,2015-09-11 18:35:14 UTC+0000,38b482b4497d404b8ef58fbe2a228d5e,a1006e6a58a0447592e2435caa230f78,1,1,1,1,3
6028,afdbb25e1f704037a22881b143bfa8e7,2016-04-24 00:18:34 UTC+0000,c69dddde559242ad9fb623c01e1a3819,58fa5e95fe9e480a9349bbb1d7faaddb,1,1,1,1,3
180,afdc16a898df43d3aea88a8fb1c0c094,2017-01-11 01:18:55 UTC+0000,a26dedb4273147aa9eafedeab08dc849,6232d3d12c824cbcb3abe1739fa21bd9,2,1,1,1,3
4574,afec0007d6c842d4947ee6f898b11bf0,2017-09-28 02:27:00 UTC+0000,f54c8e6a28b340049784e2b2cb58d2c4,149c2dc5350b45a187fc16261eb5927d,0,1,1,0,2
3182,afec1decb5b248ab9e29210898e8c3af,2016-05-12 15:45:28 UTC+0000,ec0fa238325540c9b1e6dd068af3e628,9728aa46553d41b7bc572649e1422469,1,1,1,1,3
617,aff06180289b46439024abec16ab428f,2017-12-01 12:36:18 UTC+0000,030816d8732a4244a8812c6436280884,ee4393ac856f4a4ba1f06e700fb517f9,0,1,1,0,2
236,b01dcd567b7b43d8871306d1e833afb3,2018-02-28 01:07:21 UTC+0000,caaf9ae730ed467496434aca23dc3612,81b7357a63d647fa84e80e9462be6ee1,1,1,1,1,3
5815,b026f2f4b83a422ea7b1b31f148aa5f2,2016-10-21 08:00:16 UTC+0000,cba05f5be4964f47979d8283ce21c9ae,4862d9b69b2c4f7f99da8fd235cfa3fc,1,1,1,1,3
6336,b027a5c4aec14cccae2110bbbab582b3,2015-02-16 15:08:29 UTC+0000,681051bfcfa943508ec43a189ba362c2,5fdd771b9fed43d9bb7a0730c6d4f3fe,1,2,1,1,4
4623,b0332f4ae27a42d781b99ab87a54435d,2015-11-11 17:09:59 UTC+0000,447852e7917a4f9989db640d4ab8c29f,a1006e6a58a0447592e2435caa230f78,2,1,1,1,3
3654,b0391581eb8c4f49b3e1bbc8e722ee69,2016-04-01 22:39:09 UTC+0000,ef85b8c097f3402c943cc949f7bb9c89,645ffcba55994abd9f4bee73cbf21f9f,2,3,0,1,4
6000,b044ab017ef547499015c6fbe8b64126,2016-08-19 15:24:44 UTC+0000,d93bcf6b0a5841d8a6abf27d718bdfa6,e0c3c9fc3634444ca0474c231b2f5959,0,1,1,0,2
4696,b05228bfef4940bab6eec062b64ecbc8,2015-10-22 21:55:08 UTC+0000,2720403e2eb2451cbb8f4cd24492cfa9,36ff3b3666df400f956f8335cf53e09e,0,1,1,0,2
3083,b0605621363447c78f764fb664085fff,2015-02-05 04:12:15 UTC+0000,496aeeacc075429eab538f5aa4e32f98,fd1243911adb4061a2dc5235b0711490,0,1,1,0,2
5414,b07541e2b3ed48d186b89c34b00331b9,2018-02-01 12:36:44 UTC+0000,243c361430704301a62d2972129b8181,ff165c6b122b47b9a5d4db2504086460,0,1,1,0,2
6384,b0923a663d474351a20f9dfb7ff6c24b,2017-09-29 23:09:29 UTC+0000,8aaa0caf40b244b69f53883c7d9b0484,b565f0a023404ecfb6018773175eb6a5,0,1,1,0,2
1071,b0b0c6631bb44f3ba3a0128397665a7a,2015-05-22 02:11:56 UTC+0000,14a13394812d4613a69d82014616fcbf,9d3226d47179432581e4ff1944776cd4,0,1,1,0,2
6687,b0b3d0b6861b4aea901e819496604a00,2016-06-20 15:44:46 UTC+0000,e9deb557589c4f50af117618d1c4a7d2,2596a69b178544caaf72f70396049fc6,7,13,0,1,14
2434,b0ccd73f64c248699ad19dc6582e8b82,2015-11-05 15:06:29 UTC+0000,139d14b084f648beb7b004714175684c,a1006e6a58a0447592e2435caa230f78,1,4,1,1,6
3176,b0e6afdbbb1846f0b2da3e5d9ccea0d4,2015-05-07 14:57:14 UTC+0000,a5a0bb187b1f4bce9902730d715e2643,f319c1c9280847f48f6d703aff76b4f6,0,2,1,0,3
3938,b0ef80bae66545429ec6f437a12aba60,2018-10-16 20:32:09 UTC+0000,b29ee882f041495b862b275cde626cc3,9221f63656ca4e8d9fbbac486a4e4292,0,1,1,0,2
6840,b0f7c404901a400ba20b1af5c5a6b3d0,2016-01-28 18:04:19 UTC+0000,b04bbe15ffe9456790548dbfd0b3187c,d954f43c12544dbc8cc5f2f30215ac0f,0,1,1,0,2
3966,b10ca7966cde4491b5c7423eca0839f0,2017-02-25 19:24:20 UTC+0000,1383b9cb510746e097c6191cea55ab08,32c2201166cd429c8bfc771493c0def3,1,2,1,1,4
2292,b111dbc7727244aeabbb25890cb3c57b,2016-05-19 21:25:25 UTC+0000,ccadc75d64224a8db39fca7ea0dc644d,7197b8bc171241989c50e1ac93836947,1,2,1,1,4
4551,b11b16f6dd14444c960a9e183ff6c18b,2015-05-12 01:46:00 UTC+0000,c3e0cc6b30724e34b90ada4daea98e67,ba136c4c28eb4d3cb38ca5df20b5b0fb,0,1,1,0,2
5471,b1285d2295ea4564a5cc1592e800e946,2017-01-12 22:47:14 UTC+0000,1a72d77e36834d9d812b8d1778052f7b,9496418c2b6a4c059442c81cd73d55e1,1,1,1,1,3
7671,b12a7b800fbb405a86dd80245db0d198,2016-05-16 16:44:22 UTC+0000,5d44e5273eee4c0393d4418a5847b88e,890a924a39484a6381058a4163581eb3,0,1,1,0,2
1170,b12d4f9f0cea40c0b662f48774579cdd,2015-12-09 22:22:38 UTC+0000,4c97a93fbd284e6a9dcd6aae365b7ae1,36ff3b3666df400f956f8335cf53e09e,1,2,1,1,4
2670,b13e953855ea4247ba73bca44873b260,2016-05-13 01:10:00 UTC+0000,52aaf4d052ea43b4b8a4e701e2784ff5,c8ffe6358764451982263916bd7fac79,0,1,1,0,2
5004,b13f7cdffe004a76b65a28d08a25cdff,2016-05-18 14:40:37 UTC+0000,ce0e9821a9a5410185c350aa4ba75c14,7bffa1792d474359b922e5de700d7a82,0,1,1,0,2
5699,b14c45ce730e453f94dc9415679b045d,2017-05-15 17:59:35 UTC+0000,b407aaa7befd4c6383d3b275badf636b,6a6615e38663473aa59213142a03d94a,0,1,1,0,2
625,b169678e516d4a53b07d5b24ae91e619,2019-01-23 13:55:45 UTC+0000,13327ad8c45a4da390101e8057f801cd,5ad47241ed2e416896690b78e1ae8555,0,1,1,0,2
7552,b179b0488bcd4e958ccd0f4e82052a6c,2015-10-26 16:47:52 UTC+0000,fcc0390e8c844dd4b433a4d917e89a01,a1006e6a58a0447592e2435caa230f78,1,2,1,1,4
6856,b198ef5754574d9e8b065ba59a0a872f,2014-07-18 17:52:58 UTC+0000,853d5944a37141f999dc996ed5e67171,0c0ed374391349fda6d982624bd0bd4a,2,1,1,1,3
2478,b1a70a04c90d464bb333789cc8ea2a82,2016-06-23 19:46:10 UTC+0000,a088fa6e389d4accb20a636274350665,7018c63313994473b3733ff08d9d7fd6,1,1,1,1,3
7516,b1c5a44cc86f4e1388413e6385d9762d,2015-04-01 16:22:46 UTC+0000,5bf2482e95534cbf8d0b6ac5ab77b0e1,77e2af08888a4965aad9689d9b9b34a1,1,1,1,1,3
6973,b1cb8a0bdfc4403cb7d82ba408317963,2016-05-11 17:22:59 UTC+0000,d8712fe9212345da9c02f88c430abf94,aecb857425bf4c5e8e5e7504950d38bf,0,1,1,0,2
2387,b1d04ac1d3f44e6f8a378fedb56487ef,2015-09-16 18:23:44 UTC+0000,d8018b67e3e1403b9953cc8824f3ee4f,13b55ed4834e4814bb33a4c87001063d,2,9,1,1,11
1571,b25053458c4a4091802baa5ce7e8eaa5,2016-03-12 02:09:48 UTC+0000,3d8d044b50154adeb4d874a771e581a2,3320a1b574e64d10b637c2e4538e9dfe,2,1,1,1,3
387,b26e8ff54e7d4b47bc5d03365b0ccfd2,2018-03-06 01:36:41 UTC+0000,c93cc4eb32564990838731b74f5d81f7,3ab86281ac254f53b12fbe039856c5dd,0,2,1,0,3
4478,b292c0a783714c9d91eb3dde12107fa4,2017-01-12 23:35:28 UTC+0000,e2256877d36447bbb6a4610460a3eb83,9496418c2b6a4c059442c81cd73d55e1,0,1,1,0,2
731,b295159249e044aab18eab9b460dbdc9,2017-11-10 15:18:52 UTC+0000,c3fd90de6fd7489dbea1537cbc2b2194,e2fd80bfee124f9f9bd83a48da75a4d6,0,1,1,0,2
3360,b2a1449dda484317ad10a7237c03bdc8,2018-01-24 23:48:08 UTC+0000,b914e277510241b5a7953f39471679e8,be5d23056fcb4f1287c823beec5291e1,1,1,1,1,3
3929,b2a46a8abbde4510954678df8509380d,2016-12-23 09:34:46 UTC+0000,542b786ac55646fda6f8956f8e481ee4,a1006e6a58a0447592e2435caa230f78,1,1,1,1,3
7948,b2be3961e6c34b69a55425f3feef7419,2016-05-16 18:48:31 UTC+0000,718a0953e0cf4ba8b552d797392a4502,5437d5321eb141abb5659c8c55bc95bd,1,2,1,1,4
2824,b2d7982bd5974d63b3e01807de17b245,2016-10-12 22:19:58 UTC+0000,c9525c7ce7a2400db687bc7179a1814a,20569e00becc48fc82be8f9db9bd9035,1,1,1,1,3
7518,b2df5f8ec3b04b9bbed499dada1069cd,2016-07-19 23:42:02 UTC+0000,defc0df3823040e29dde53b3bb0497aa,fafeba89ca764bd891862fb8440a2962,1,1,1,1,3
3968,b2e29c031aa74c298406919819a99a7b,2016-05-20 13:26:05 UTC+0000,f04d47fdfcda4db9b03bb891159fa81e,7667c23d26ab409ca3e49758f5367925,0,1,1,0,2
7443,b2ebc07da5cc4d87a24273b9f52a3dcf,2016-04-14 15:23:57 UTC+0000,a94811c672fa4e43a432a00f685bf255,42f9b0e8b8294edfaf60a987eacc297b,4,2,1,1,4
5046,b2fd91f50f7c4866b79b879f7db8961e,2014-10-04 03:07:47 UTC+0000,4b4b47ad0e1d485997d39e7b4b94f201,56444eb4b925439186a995602e9d7037,2,1,1,1,3
5482,b3027e5b95be4ba8835c8e7f83f5c402,2017-02-16 19:41:01 UTC+0000,2859fa42605e419bbda33efddd83658a,a1006e6a58a0447592e2435caa230f78,0,1,1,0,2
6099,b303cb3425514d33ac9296e3ae4685eb,2016-05-12 22:41:23 UTC+0000,4329355bf61545d28465ff887937d756,2954640149c44018a7b203aac25aa2d5,1,1,1,1,3
4607,b31405bf4c0944af98702cbfed0a0ff2,2016-04-13 16:08:13 UTC+0000,fbd44fe55d654c258f58ad28dd5bb340,b342ccddf46547bb924181e958432391,0,1,1,0,2
5377,b32dfd2f5c6e402fad9a7119b981e270,2016-05-18 16:06:36 UTC+0000,6ec08e19def24ffaa79a60105fba0e2d,53939a491acb42a4815463845a638186,0,2,1,0,3
2799,b33345a38b1f4baa8de2228839683197,2018-04-12 19:49:49 UTC+0000,51c3bb6b75d7445381eea7ee3a62ea0f,2037358605a34ccf971bd857efc63d82,1,1,1,1,3
3893,b33930ef02c342ffbf2d3f0ac8b4d742,2016-05-18 15:36:03 UTC+0000,cb32442c127c4610bc4768879c00e8b5,50ada0cef1204c749bb8c41c7c9c3bed,1,1,1,1,3
2751,b34837774cfa48f8850d5b5ac2097116,2018-03-28 13:44:10 UTC+0000,f88fc3ef6f354340a3860805c2e28740,36ff3b3666df400f956f8335cf53e09e,0,2,1,0,3
6330,b3534776e3854e8bb73d8a1b1be3511f,2012-10-01 20:25:19 UTC+0000,f46ad30f5220449f9ac36f66f49ba310,0c673e046d824ec0ad0ebe012a0673e4,1,2,1,1,4
4935,b358d68c3d29481481a528df980d94db,2018-10-12 00:12:48 UTC+0000,19dd5e3f09eb414dbb787077dd1a01d3,1b585cb2adb440758670b25de46b9459,1,1,1,1,3
3567,b35ac42949de47e8acb199314e8f9356,2016-05-13 16:13:16 UTC+0000,6deffc4766ac4dd48d72c4d3bd5763b0,9193b76e2a504791b65023d97f084bdb,1,1,1,1,3
4113,b36ef76c03ff4645acdbf87064fc6def,2018-05-22 11:48:56 UTC+0000,772cd7c528614b84a9ac636b6a57744e,be5d23056fcb4f1287c823beec5291e1,1,1,1,1,3
836,b3823042287746ecbcba376f8c45449e,2018-04-03 20:37:09 UTC+0000,bc82e60d3c04425da7646363e4f142d6,362344cfbd954ae99a2d07a8767ad4a7,0,1,1,0,2
7752,b386387e9df54e61b73b5894413c9768,2014-12-15 16:03:22 UTC+0000,ad85e4d482064b89a30710e4ecd5921a,8526230b44c94173b69d71d5d2faa161,1,2,1,1,4
6347,b38d19e10f404ff4867f160563283b63,2016-06-14 06:59:37 UTC+0000,6a0b779a037e457988ae87bab85e5415,264fb22c91b9438ab2cef71e29edebc9,2,5,1,1,7
738,b39f3ae849944898b29ce02f663efc74,2017-02-17 19:05:53 UTC+0000,d781b75e57864d988e50f6aa98bb56a5,03cf1fd186ce43229b93f29557216762,2,1,1,1,3
2733,b3a0658a6e4b4f739d8a8f1b9aa154c2,2018-03-20 20:11:43 UTC+0000,ddc77cc64dd9495580f7d927930fcd00,4dc61581ec7b409bbd037e483f53ba0a,0,5,1,0,6
2158,b3b29fe15c864ccb81578fc55a551d34,2012-06-06 16:19:16 UTC+0000,e4af6d3eeee0496f90b28d223ff279d3,624194ea296c49a6a8ef1180787476dc,4,1,1,1,3
2368,b3b3a8e73d2249ee9ba6b15d9c3e3cf4,2018-02-21 12:39:42 UTC+0000,06b208066c69438abd8c256ada856bc4,e58426cac810497db54359a6f60dfd53,1,1,1,1,3
719,b3c786eade4b4ab9b986778300182023,2018-02-10 21:24:48 UTC+0000,b044650b77414b68b1febbdddc662607,e3605142dffb4d87a0f8b950da727f73,2,1,1,1,3
5547,b3cebfee6b3f4916b3bf581000a2dad3,2014-04-19 04:48:06 UTC+0000,ef6a21361a0b4ae1a8c65ba9c6548d82,fe4543418c0846e5a65fa22b4ad9a304,2,2,1,1,4
1420,b3da3dfa837c48ffbcd335ddcb480641,2014-04-04 14:42:01 UTC+0000,1590cd9364bc4c39b037b21d2021a828,2536155dc6b7487dacbe179e8591bbc8,1,4,1,1,6
243,b3e237c182874e4f988e9d638594831a,2017-02-21 15:32:04 UTC+0000,976c09185d9a4ef692c52ab79fc3d37b,037efa1ba22241de8e3c04fe991c9b1c,1,1,1,1,3
3107,b3e7002f485248e5a5c82bdd41ff7dc0,2016-04-28 19:12:30 UTC+0000,8947d36b98fa43edb627b1d94882c3a8,dab1ccb54ed44b9dada34f70ae039814,1,3,1,1,5
5294,b3ef6062e04d4f1296856b59814db406,2016-10-24 19:11:59 UTC+0000,0bd899dfc7a248dd959a517a03b54c0a,9e69d84c3a1e496fbe4009f577c01182,1,1,1,1,3
4631,b427129fb4ed4f0384418131c9d658b8,2016-11-19 23:42:59 UTC+0000,ceab1be6a1fb4ad6821457c1fcac4eb1,ee531ff603254ded86553946b98156fc,1,1,1,1,3
5825,b431c6fdccbf40ad93b9c6fb1e8920fc,2016-05-17 02:49:55 UTC+0000,63d356d5bf744f6e854ca6d85a71f5eb,58fa5e95fe9e480a9349bbb1d7faaddb,0,2,1,0,3
2994,b4379af458f643e3b9788e9467e1af8a,2018-03-21 01:29:25 UTC+0000,b237b6f7a45f45ef98ff7ac68479c787,5f58059585ac45e5833219a8d3a92fe0,0,2,1,0,3
2572,b45e1b83335748e694bec4692dc8c67b,2015-04-20 13:42:10 UTC+0000,2ead4ef99392489b8ea41909d2d6703d,53939a491acb42a4815463845a638186,2,1,1,1,3
246,b45e3d287021431f8a01e6b8f0698000,2016-01-09 00:55:50 UTC+0000,ce3f3106f2fd45d8abb3312d8bad6fc3,a1006e6a58a0447592e2435caa230f78,0,4,1,0,5
5038,b4697a9788d4437c95e31ef242cd21cc,2016-05-23 16:32:32 UTC+0000,e402bf270844401f9ad9b22fae3ba613,1544be786cd54771a5b41761973a2f4f,1,1,1,1,3
3995,b46a4d68a59841eaa3b67cffe5ae3a76,2012-01-17 08:39:44 UTC+0000,a9f269a8962146c3bf12ae074da2c68c,e18337fd36cf4dffb589f2d548e8270c,6,2,1,1,4
5428,b47a12887a394d0f869d69d63c0ef857,2014-04-05 00:02:30 UTC+0000,a9d68251876a4065a844ffbf254dc800,6774ee9e8f9247728dbbe896726e911a,3,2,1,1,4
2171,b47c58a96d8f432997ddcf9068111a3f,2018-05-13 23:29:40 UTC+0000,8f4b8d8bf4b54cdc80215b6ec26904d6,78e4da542f6a4d4d8fcca59158c7d305,0,1,1,0,2
6135,b48e6a2bc5f4409791f57f3e894cc349,2015-03-23 19:30:23 UTC+0000,8def7b6c97934144a53604c421170c52,9a0f09620c6640718c1792a74f3b8438,3,1,1,1,3
4864,b492361c0933427e8ecb59a696e266a0,2016-05-18 14:23:08 UTC+0000,f6b11d5bc19f4b79a23de7fecd318eda,c045fc0d5b7445128cb945450ac8fe66,1,1,1,1,3
5192,b4b07f06f9e64d3c98b2e2aa157704d5,2015-05-08 19:26:19 UTC+0000,5fb3d047244d4c499e5460cb9d9c7342,4e8274bf094c48738e1bd0c00cbcdae4,0,1,1,0,2
3509,b4b3afee827f40439aec5b69e6330453,2016-05-17 19:59:16 UTC+0000,06d2c7e976e848928339bf46a85cd69d,bb4fe08bb5424f08972927d90bad9642,3,1,1,1,3
1197,b4cf1ea4baa6482c9ce20ac550006627,2016-10-01 20:51:10 UTC+0000,3a21f0423ff940a6a11026d712cf877d,4d9079c15bd94726b57d4ebdb63cc0f0,0,1,1,0,2
8031,b4d121f0fccd41e79fced5810f4b3638,2016-05-09 17:01:11 UTC+0000,43da62144476460387ef39e7c64caa11,5e3b926876974ac680a8821e9dde5370,1,2,1,1,4
5870,b4dac0be3ce74e60a651ce5bc571e401,2017-02-27 19:11:35 UTC+0000,063b04c089294708af4e405ecf2b4104,0bdc61bcb15f4f57a755445009325557,1,1,1,1,3
2864,b4eb66e2c4094f268a65e90c6b421f58,2014-06-16 19:24:54 UTC+0000,291211f550fe452e95d0164fed4fe35a,e16b7d7c78034bbbafe677c63a9ed44d,0,1,1,0,2
6863,b4f3e20db06948b29fe21f23df89c245,2015-11-11 18:17:00 UTC+0000,5c2b909e2e83402fbc8ea121f14b91eb,a1006e6a58a0447592e2435caa230f78,0,1,1,0,2
2692,b4f8a99361b44d4593ef117bff7e26dc,2017-01-13 21:19:28 UTC+0000,01f04ecda3de45c28649288f3cf772dd,9496418c2b6a4c059442c81cd73d55e1,0,1,1,0,2
2044,b4fa22c3ea604b0d8875979dcb9b7967,2018-07-20 01:59:57 UTC+0000,8d5e3688a9904df1a963caa0d0e3248f,be5d23056fcb4f1287c823beec5291e1,0,2,1,0,3
3367,b4fa6554ce814079af2bf838a4ca9484,2014-04-09 17:55:52 UTC+0000,22e54e8faea74e94bc1da95bc9cd25a0,42deada7c50c4859a34615d70193317e,1,2,1,1,4
2658,b51d2d9f409043e3a3dfb1528a7b9785,2014-07-28 13:36:00 UTC+0000,90716804d5344207a93bf07456191917,dc083654ba84490d914a698ffb0e1de4,3,1,1,1,3
2129,b523daa4d4294c9aa1a539e612d4eab9,2018-02-11 10:45:17 UTC+0000,df78cc29c9504b4db89e1de9abfa2aee,3ab86281ac254f53b12fbe039856c5dd,4,1,1,1,3
2937,b533fcd634dc47e6906bf02f1f77197f,2017-01-19 06:54:39 UTC+0000,a7ab375fd0ec4f0cad238435d14137a8,665a4dc589d94329b7a752ad551830ba,2,1,1,1,3
7208,b53597980a1448b0ac747d820e00185d,2016-06-23 18:48:23 UTC+0000,363b27f3b27241bb944b66ea4439e71f,139ba2489ea44eb7af5fdbc63e19dcca,2,2,1,1,4
2880,b53699806231467799be77f2a946af26,2017-01-07 22:08:35 UTC+0000,8a2a9fa7f6bf46b79f953a8db62e707b,a4b92ad459d24dd69a7279da9b01851d,0,1,1,0,2
2740,b537ff9235b44e558314de73ce404a6e,2014-03-27 14:34:07 UTC+0000,c235416111d04edc950f76d4374381b2,38bc1866f29744f9a003e2e826e3fcb1,2,4,1,1,6
3166,b53a53c590b0449b8917cdca198ffdb5,2016-12-13 01:25:58 UTC+0000,103b64bc45844eca8f2e5cf5aa69bc2b,be5d23056fcb4f1287c823beec5291e1,0,4,1,0,5
414,b53ac24086fd4a588d109fcee304ae45,2018-05-06 03:46:39 UTC+0000,c6dab37918dc4b7a8972a2245f039e4b,be5d23056fcb4f1287c823beec5291e1,0,2,1,0,3
6360,b53c5e9b7436453fa13a416a23b512cc,2011-11-11 18:52:58 UTC+0000,6c1dcd9ffb2f49d6be05f06e765d30cd,392a273cb57b42389ec01a8fcdaff3af,3,1,1,1,3
5313,b545b14eb2ac4fe68108c0a860a8143e,2016-10-10 15:31:14 UTC+0000,f8d13b1bc40147729be76155c765ca5e,f5b313020d8b4cea9bba70b57920d3a8,2,1,1,1,3
5955,b54d7ba2f7654f799e3a7fa622e8623d,2016-06-24 16:54:54 UTC+0000,c9577ec7c33e4b2db8106de95858bba0,58fa5e95fe9e480a9349bbb1d7faaddb,1,1,1,1,3
796,b54f7283c76f4a2d85c50e175a89c592,2014-04-02 15:03:06 UTC+0000,cbd24d89f1d940ed84e44f2af142020b,b688e766eed04a37b7abc9218aca1ce4,2,1,1,1,3
5866,b551946952ae4328864414a9164a95d8,2016-05-20 20:42:30 UTC+0000,b7098ff49ba44c669c3b3244c3f2b059,7e721be7613246dd9f1aee1fb31271b2,2,3,1,1,5
4553,b56b4a797d9d4c239b153c9d2b3c05b5,2015-03-19 21:20:49 UTC+0000,b21e9c6b18c24ba597bc6de2c4cec605,a1006e6a58a0447592e2435caa230f78,0,1,1,0,2
7669,b56ec00f067a45a18401ca93cb9378dd,2017-01-14 21:44:25 UTC+0000,0ebebfaef88f435a9216051095554ba7,36ff3b3666df400f956f8335cf53e09e,1,2,1,1,4
1233,b57680a4fd1a4b408cdba6241d3660b6,2017-04-15 20:08:04 UTC+0000,18875c034bcf432c81de21712969fc4e,be5d23056fcb4f1287c823beec5291e1,2,2,1,1,4
3958,b577356b0a43477d97852d50e84d53e5,2016-12-07 18:02:38 UTC+0000,274d825b79974018a1ceed739d7817e1,5f95b0ac821e4e8e9b4fa9fc8eb9ff61,2,1,1,1,3
2911,b577bb2d553a407a8640438e83923ee0,2018-09-09 19:15:02 UTC+0000,eeb09c0b61bd43f091ff072c79ced389,36ff3b3666df400f956f8335cf53e09e,0,1,1,0,2
3921,b57dd0aa788a4347aadd9e010bcd9842,2016-09-15 01:07:37 UTC+0000,f2d200cafdd7402e8a6d2bbc508a294b,e3529e64e70643b6889353db79eeea3e,1,1,1,1,3
4809,b5829260c529464188d3964c0b6d7b54,2016-04-26 18:31:06 UTC+0000,c016e454fdb742e68d792f01d0b6c976,369f1c8646b649f6997eae7809696bd5,0,1,1,0,2
3034,b58a775c93054927b80b917af65e2c31,2018-03-08 21:23:30 UTC+0000,cb63869ced814ceca45c3c7c2e3b46d3,1ad13abd75b641198468b121e83e8706,1,1,1,1,3
5961,b58ad12554444ab4ac363262269b28e7,2014-11-28 21:36:30 UTC+0000,11b083f8f1fe4b0c82a34a10c72c94eb,3d8847ddc8d04185976a9e78b190ebdb,1,1,1,1,3
7880,b58de0d500f04cb0a220ba0bb638f445,2016-12-10 22:05:26 UTC+0000,ea605740598347c4abbd0b0fce7608cc,a1006e6a58a0447592e2435caa230f78,0,1,1,0,2
6060,b5902baddf38495389f8634bd4a0094a,2017-01-21 00:17:22 UTC+0000,cb41122a25334bb68b3c98350a7e2e23,13b55ed4834e4814bb33a4c87001063d,1,2,1,1,4
2397,b59582a5456544c6af1710be9db34cd4,2017-01-25 14:13:29 UTC+0000,b1d5989a41a842a2ab8e7f63a8efca55,e963b61ee35c47c49551d0b3eee97782,0,1,1,0,2
5444,b5997eb2b0094a978a9c1300295def8c,2018-07-10 21:20:46 UTC+0000,b9c9dda94d3d4394bffaec69a9200b45,5a007a6465af431b85e383c16be7a48b,0,1,1,0,2
7729,b5a1a4ac336a47f1b7ee90893191aabd,2017-05-17 17:00:11 UTC+0000,60586a0e85184a6085d0674000305470,e92e9126dcae49d68c1e88f325464f83,0,1,1,0,2
453,b5a21e2b21004a73ba1b490310c28eff,2016-05-18 13:25:19 UTC+0000,d850744fad78437a9a040b4fd2630756,b342ccddf46547bb924181e958432391,1,1,1,1,3
540,b5b2d13d521e4ba1b241fafab8a2a726,2016-05-05 14:16:24 UTC+0000,196575166ea1463dad249321da192764,58fa5e95fe9e480a9349bbb1d7faaddb,2,6,0,1,7
761,b5b54581bec14a43a18bfb91d2520aa3,2015-05-27 15:24:54 UTC+0000,48594bf0cda64aae81f4a762125a1e65,e3529e64e70643b6889353db79eeea3e,1,2,1,1,4
4290,b5c6ff7f705b4fb2ba6ab444a8ea623d,2018-04-03 14:08:17 UTC+0000,217ea1dbd8114ccea5d7e4888ae46c87,be5d23056fcb4f1287c823beec5291e1,1,2,1,1,4
6989,b5c706d37ea34fae95b0f5ec4cb63adf,2014-11-25 20:28:59 UTC+0000,638b68d55d6c4dc4bceca26cbd78e52d,4c321ecdb7f84364a83a94afdfd88866,2,1,1,1,3
1032,b5c790232a3a4fa8b83421c46655f9f5,2018-03-06 18:36:00 UTC+0000,25c1941eaa4b45c9a39942ec591827ed,5fc76ec033e2422baefbffa8183d0b30,0,1,1,0,2
2177,b5cbd33e83ad477ea51bd3af7006debd,2016-10-19 01:00:28 UTC+0000,46df8812db3540f4a1e58eb0afe72258,e8ced5223f0144e699d3f5672d1088ee,2,1,1,1,3
5653,b5d5082b25274510afd5ede1cfff5493,2014-04-08 14:28:15 UTC+0000,e0b5a820ae2347df90a4d80a838b9f82,5f4c8c5868cd442e8e0bc218b9a10e03,1,1,1,1,3
3185,b5e2ff723e2543b983874ebdfb8cf28b,2014-10-24 03:19:22 UTC+0000,835788318506483e98d5d54dc4d8ce96,eea91690141e4abb98d66ab65852acce,1,1,1,1,3
6702,b5e5ea3a1f194601bb3c81efc1365739,2016-05-16 17:03:48 UTC+0000,8c7bc31d163149acbccfa1d826c46b9f,04df52cae7db418faf5f9b285799ea5d,2,1,1,1,3
1091,b5e5fb426dc140e68ad6ccec006b206f,2016-10-27 20:56:49 UTC+0000,0490e7080f6543e2925938a67aae3ee5,f6d9369cd0a24b52877450757c451dcb,0,1,1,0,2
6322,b5f040bfa6ee4aea9b77ddd75b13bc2c,2016-05-02 23:58:44 UTC+0000,de0eb8c8478c4b68b4cb85fa37b4620d,49f38e98c0424e339c71dbd90eeca351,1,1,1,1,3
2892,b604f2bec1ae4db8bb9c877b8e951724,2018-09-26 19:50:30 UTC+0000,bdf77261f43d4e3eb67c91773db12b49,c71a481587c5459792384f19463bc626,0,1,1,0,2
5663,b61bfab926e3440db65fd984a7d561ea,2017-05-10 18:28:12 UTC+0000,751bf4ee049945ee8d8b4b67ce35b719,7e72a630c303442ba92ff00e8ea451df,0,1,1,0,2
5627,b647bead48e84e24a931c39baed72912,2016-07-22 21:56:29 UTC+0000,c440404905e24720aa847691bc55922f,8147e4d83ebc47b689901dc534981de8,1,1,1,1,3
3540,b648b2276a444097a4f2c5fce87873b1,2014-11-04 17:45:33 UTC+0000,a3451b977949475d83619c3e09aa4ce3,05444a2f42454327b2ac4b463c0adbe0,0,1,1,0,2
2652,b65165284bce4bb6931db4ec6b0b6e29,2014-06-14 17:39:20 UTC+0000,b5c72c0ddaf14ae68ea5144e6a2f1673,4520f122d31241f6b83e3606ae3a1922,1,4,1,1,6
4419,b651b293f11244558fdb58dee8e0d1a6,2017-10-25 18:21:19 UTC+0000,43e6b5d3a8da417fbbdded992a4bdfd0,1402116e41d44b129292af78f63b8f47,0,2,1,0,3
4826,b66a337d9b184ba4979b143070a7198f,2014-04-09 13:49:15 UTC+0000,3a78f70ab27c4294bee5247bca3cd866,2adab7916b3747af85b2d82e188c1dc3,3,1,1,1,3
5822,b67cdefef062427180a94e5940fb3a9d,2016-06-01 17:22:04 UTC+0000,78507302d14b40b8bbbb676a4366e143,bc46e3699d92477ba8c7aa723e54a151,0,1,1,0,2
5162,b688051e1fa84484800de3fa0dd7668d,2016-04-25 13:26:21 UTC+0000,dcf00a37b5d94749bafabb40a93006dd,7750ddc7ff9e4a2996309de7d474399b,1,1,1,1,3
574,b68d77249dc6488fbd0fc4a544cc99cf,2016-04-29 03:23:44 UTC+0000,b1fd8a4171214f7394cfbba955165409,c39329e6c790449f812590c3b897aca8,2,1,1,1,3
2375,b694b8bc7d844ee9aa55c3d5cf7a3c3a,2018-05-31 16:27:09 UTC+0000,9ade2aa0d48248439199cc3cd4106571,409e40f6708d4cfb9ba1804626ba8172,1,1,1,1,3
6034,b6aa709db52643ee9f7fafb637808f1f,2018-02-17 04:08:51 UTC+0000,15cf4f5734534f789adc4fd2b839ff41,fafeba89ca764bd891862fb8440a2962,1,1,1,1,3
652,b6cbd86ad14a41bdaef158196f6942dc,2018-08-11 12:28:10 UTC+0000,96dbe6dac0ed488cbd322d24f6bd149c,36ff3b3666df400f956f8335cf53e09e,0,1,1,0,2
7972,b6d2e800c7cf4d17a9036ea53fc81770,2016-06-12 01:39:16 UTC+0000,2c474c8ac5ad44bc8e628db4efe774e0,c232fdc3917c48ffbb7c9375a460d358,1,1,1,1,3
3469,b6e2312efe2e4f45ad2e270fa986080b,2017-07-09 09:04:20 UTC+0000,00cc6342efdc4404a3b840837e14dc65,2c97433ad7fa49fca1f7d07143a281ef,1,1,1,1,3
4534,b6ee47b6c04e45a6a2b9773379074298,2016-05-06 18:16:26 UTC+0000,76461812d43940c3bc3cc7dfe1aad49f,13b55ed4834e4814bb33a4c87001063d,0,1,1,0,2
1107,b6f1395785204f2787861533c85bef67,2015-11-01 00:59:01 UTC+0000,e24f7daf8a6942f0a82b74d581af0f49,9551b6c5e24046ff9e4f456bd53cb7eb,0,1,1,0,2
1868,b6f82f7d6d1c45d39c94a38bfb0dd0df,2014-03-29 21:50:34 UTC+0000,41b150969429443db1215178d11ce86a,861fca48f47c4fccae43a799f4442684,6,4,1,1,6
4939,b700a8c582064376b868cc88d1583884,2014-04-30 23:45:17 UTC+0000,561a7804e4d443b293e082c94d31b33c,fe4543418c0846e5a65fa22b4ad9a304,1,3,1,1,5
3663,b701f6a5c11949cf904b327204a6d84b,2016-02-24 17:57:45 UTC+0000,3d0466a37a7447ae9affc8b9d7d04d9c,7cce25cc8c1042b1b4f135bcacfdad82,1,1,1,1,3
240,b717cfefec22454681b233d4cbf351ba,2015-10-21 17:07:47 UTC+0000,fdacbd8413b84f1a994b0c9f7bc18a07,36ff3b3666df400f956f8335cf53e09e,0,2,1,0,3
5490,b71d56eab33943ccaa1c48b89ad2b5f0,2018-01-29 14:39:52 UTC+0000,70f3f4fb699f4e8f8f3bfc3d99dba013,887c5a142b42466fb74740d72989fc74,0,1,1,0,2
4850,b72c8ac7ab504290914cdf28eda829f2,2014-10-21 19:06:49 UTC+0000,9a0d38979c8b423a879966d06e3da7df,05444a2f42454327b2ac4b463c0adbe0,1,1,1,1,3
5683,b7508668b1b8461092815345b0d9e539,2016-12-13 01:30:39 UTC+0000,6908e6af5df64c108ef87833e569588d,36ff3b3666df400f956f8335cf53e09e,1,1,1,1,3
5180,b752950676e64ad6848586bc976e5c32,2018-08-29 16:41:30 UTC+0000,51dfc06dcd744aa280d0ec72936f1e08,98527a0ed93741c3b512a7127973b8e7,1,1,1,1,3
4977,b752bc5c7f4b423fbb2930515ed57062,2014-03-12 20:25:16 UTC+0000,22b6132d540740b1a3937c376e18892c,1fbcd8b315de45c29ff87cf912b535fc,2,1,1,1,3
7385,b753e3920c42498e8d27afe907bda0ad,2016-03-01 21:53:40 UTC+0000,290a7639948b4f019d0c185672f11a64,721c6bf35e2e469c8d93aef5a67c70c3,0,1,1,0,2
7748,b75431f36dd9474a80028a075dd9b0e8,2018-01-26 16:40:36 UTC+0000,f04ff26c4b9c44cb83589057bbdcde15,b6c50484f59a402c8a89a31856098d88,0,1,1,0,2
6779,b75a323942894e22a5637a3a1866e7e5,2014-03-29 04:52:17 UTC+0000,b5cb23a556f4457f8643b0e36eb24c4c,b688e766eed04a37b7abc9218aca1ce4,3,1,1,1,3
883,b768ba79ffa343d6a25d679271abfe95,2016-05-04 16:35:59 UTC+0000,30dfc9edbd3d49be9fcb7f1220b85eec,ea52277eba834e8e8be059f03c384f2b,0,1,1,0,2
7992,b76f699ca8e94c7ba4b2600d224fabff,2016-11-26 05:23:47 UTC+0000,0cfc41897c164629bf26975c5c7b92ee,41b3984603ec43bdba6404c675800889,0,1,1,0,2
5479,b7914550f3884300ab8f3a5d1e6872d8,2018-01-17 19:50:35 UTC+0000,7ac5a086e554446a8928fbfc57d7fada,835405d1ab964d70bb14a404262ba378,1,1,1,1,3
5896,b7952e5953b541d0a7ea836bda55a380,2014-10-27 04:25:19 UTC+0000,d40de19a0b6649a4be437757c5b28aa4,c32988d519b3421d9a1b724f48e28b83,3,1,1,1,3
84,b797069921834f2b88ac16cc5930dc93,2018-01-24 23:59:50 UTC+0000,d0ea0a8b13994c5fb273e0e0ed5d611c,f6b1efc0ed1a4889891b1287913db5b6,1,1,1,1,3
5681,b7a090375652468c9343fb4cc62691c6,2014-04-07 18:32:33 UTC+0000,5bb354e5343b4ad49229d1d0e8702ab6,0355aaad83704ad98e6d71b79db85849,2,1,1,1,3
1954,b7b019ffaa02417aaafb80c76519ffe0,2015-02-25 23:35:25 UTC+0000,287d469e9cf34d0383a4f3e30f5c6e4e,b9b4dd3e497548d0b5c2aba2b069430e,2,2,1,1,4
1448,b7bb7dce24f743748fe42662666e49d1,2016-05-30 00:15:36 UTC+0000,2e9c6b3a3cbc49199ced9146e6e6bb44,36ff3b3666df400f956f8335cf53e09e,1,2,1,1,4
6995,b7cbbfaf20004bdb9b4df015a7b86244,2018-02-27 22:46:59 UTC+0000,39ccdf8e7e774df8894860a01eff5238,5d431f8b7a0249679893c99f3c1cc75b,1,1,1,1,3
3763,b7de04bdb074473d89e8b2e46eb33a21,2016-05-12 15:18:15 UTC+0000,7809180ea4b046a28e20e7705d110dc0,e2941a700e1a47cba5b984fe17894aa6,1,2,1,1,4
4462,b7e8a97da6ec471fa40033e7a31c2d70,2018-09-25 15:31:40 UTC+0000,9a608a7a026844ddbb8ab4f6dd6a9a50,b7a7e0bef1534f12b59c05a0760186bf,0,1,1,0,2
1100,b7efed12ffc74f75972a4667c546ee43,2018-03-16 19:58:08 UTC+0000,b3bc44bcbc5f40f7b86a96c43275c832,1e3bcd9af1cc4151a481626129b6ad11,0,1,1,0,2
7840,b7f06e1e38464e8d940cbca95b76a64e,2016-05-08 06:29:08 UTC+0000,791d3ccc73b045cf80e2e170d5980f28,f1a64ae4e7ed49d6b2e04bf7e033bb4c,0,2,1,0,3
579,b7f58f2276f4487eb7a0a59d317f9060,2018-04-04 17:59:19 UTC+0000,5c319a102e8a430eab52792d5a855826,05ab77d4c6a141b999044ebbf5415b0d,0,1,1,0,2
6450,b8032fcacfb54302a2d7841ab763e631,2017-11-29 16:42:05 UTC+0000,1bbb9844e6f74aa5a16f218c3b7e972c,ffbcfa4902b143c388d378296c1ba697,0,1,1,0,2
4389,b80ccd6dec214231a9533c765566fdbc,2015-06-03 20:16:44 UTC+0000,65097825b7e545ca9b21549ac05555b9,369f1c8646b649f6997eae7809696bd5,0,2,1,0,3
3465,b81d6435c2a845dfbefa78221eb99ca4,2016-04-13 17:33:45 UTC+0000,d03773bcceef4def969a24d1846dd79a,d10ff3b541fd40afb27293de3c178804,0,3,1,0,4
1685,b8298c2de9444811afa40cf9927774aa,2014-03-23 15:44:31 UTC+0000,87341f6911b64b4aa6fc8378d7967dde,0eebb6c7f960452fa457747129577f85,1,2,1,1,4
3770,b8408b65992847d1af012a83c9178bf4,2017-01-03 23:50:47 UTC+0000,e9768c3b6de2435cadf32d9ee6e0b100,36ff3b3666df400f956f8335cf53e09e,0,1,1,0,2
4365,b85ba405ebaa48649aadc79aefa08f40,2016-05-19 15:32:23 UTC+0000,45c78b3757304eb98fe9021bbb16e4db,2c6d478b767046a1bec521546039b0bc,0,3,1,0,4
7867,b86fe19e2695411199fc4fa8685aebbe,2012-01-13 23:20:38 UTC+0000,648f5e941a5445d48a2a4c4f62326f09,1e4cc96c24344c8b806c26c3e6746167,6,2,1,1,4
7691,b878838750754ed8ac2001c6ef229e3e,2017-03-14 07:28:48 UTC+0000,167750d45ce641f893a749fc106c505c,751d8ab497b04dd5b71b94e20c072b0d,0,1,1,0,2
1078,b87c6fbdcdeb4265bb79a13b57daede0,2018-09-05 02:29:24 UTC+0000,3d419c2d1b6d4b72bed1771cfa7c2336,e02a6c85f6e04dc1b8623d5b7fccbe9c,1,1,1,1,3
4648,b87ffd8f989041ba8350d9ac170aa54e,2016-05-16 20:15:47 UTC+0000,49483e1cc55140c3a42a760738085053,4fae496418e543c3b91f03a19b12585d,1,1,1,1,3
1337,b883649f3bd045d78f98471c3b30cce6,2018-04-05 22:38:50 UTC+0000,4f95550e27ce45f8ac4eb491d7b3a076,1009f4edd679418faf1532a0b77733ae,0,1,1,0,2
3192,b8906aa424f34612916a9bc1b0b16af2,2015-10-28 16:57:40 UTC+0000,a3b6f0acc42d4d63a278cb5681de7257,a1006e6a58a0447592e2435caa230f78,1,1,1,1,3
5794,b8912248c7f145a2917d10e09529dac0,2017-02-15 14:52:16 UTC+0000,b7df9bae325c48e3ad78dd049b505ab5,d848200aaff4497bb2baa7f2cc3dd994,1,1,1,1,3
7649,b892eb9e98c840429264de274ea90c16,2015-12-10 04:04:04 UTC+0000,1f8a01c25b6842f2996b6e363679a97d,a61aa494aed848cc87ba745a24178922,17,2,1,1,4
5336,b89536efdecd4140b434f0a0321de4c8,2015-12-07 13:07:47 UTC+0000,a5dc4f1abd7e44aa8a2fd5bbff7e08f5,a1006e6a58a0447592e2435caa230f78,0,2,1,0,3
3063,b89652f1e5214901b73bf732e6f126fc,2016-02-24 22:28:36 UTC+0000,000c7b951e904453a0042df5b3b65b58,a1006e6a58a0447592e2435caa230f78,1,1,1,1,3
7263,b8a595d7e95a467a8f964d9819e9fd10,2015-09-02 21:54:03 UTC+0000,9269b23a46664264b69e4f084814acf7,aa916ae133d04bfdb7cdf610f7e7a745,1,1,1,1,3
7433,b8ab3e36e8944b11bc36946c02044714,2016-08-09 00:36:30 UTC+0000,05752e1fd54c4fe4845b7b5e996397ca,1dc4613a0fb34b4d8786586a3dafaad6,1,1,1,1,3
671,b8b0fb87580049e5a7cf2d0afbcb3086,2014-03-28 14:39:01 UTC+0000,0ea493a1055d46b391debdf3dbe5d048,953b8bd794124b7f81f1dc659640c9d4,1,3,1,1,5
5338,b8bec30e5c5a4723a9780247b7221e92,2017-02-12 22:55:59 UTC+0000,cc3eca0ec15141dfaa91b0c116b66074,f736cfda4893480ab4e71b5cca669d7a,1,1,1,1,3
6049,b8c9faa25d6449679cf451a0068dbc11,2015-03-20 14:59:22 UTC+0000,ad0bb06b4aed4ebeb6d1fb08f1665143,906722469a794a66afcdf3edda0d911e,0,1,1,0,2
7458,b8cf0600df664720a0a471ce989fc0f6,2014-04-25 20:04:20 UTC+0000,eb608003fd3943e783e9088eb4c18d47,fe4543418c0846e5a65fa22b4ad9a304,2,4,1,1,6
4713,b8d094d224a3432da6a9e9411551de4e,2014-05-28 12:36:43 UTC+0000,f25380893c344d63914ee7a5b7e8b686,95f1104e8b604c98ae237020a98921c4,2,1,1,1,3
285,b8d393b3a9534e178e7a79cf77170f96,2018-09-09 12:45:17 UTC+0000,aa5ef6c05a4f40f49719faf9ba735556,36ff3b3666df400f956f8335cf53e09e,1,1,1,1,3
5237,b8e9416586ac4701969e2778c1a91ef5,2018-09-17 08:43:38 UTC+0000,f8f6be3f9a354c088e769f07d5aad7b1,36ff3b3666df400f956f8335cf53e09e,0,2,1,0,3
5604,b8f92c26f2d64631a1868a66d74d1ab4,2017-12-14 01:11:10 UTC+0000,904af05378934b3f8d58fb31a8345743,ef8a09c1c2af45aab9f7cefc16f98cd5,1,2,1,1,4
3483,b912d81451ab4d5fb9723a4b35b92035,2016-08-15 02:19:56 UTC+0000,3d55d9bcca45474baebec70f0d9b814f,e589ea1d909f4eee9c85b936512dc9b2,1,3,0,1,4
5103,b925432bfe9e441eafef2be47789aafb,2017-01-30 07:06:53 UTC+0000,e53ac2c292e949af85fd2f22dcde3dfa,f4759af9b17f44c9865b041a0469dc45,1,1,1,1,3
3373,b92ae64096e2432aac64366845772d26,2016-07-17 14:13:38 UTC+0000,03b0fe33fb6040bd9309b9305249c9db,c39329e6c790449f812590c3b897aca8,0,1,1,0,2
2667,b937ad8aff1345f2aeca3b7257764e9e,2014-04-10 14:57:41 UTC+0000,1c9af3471e3643d8af6d0b1cff437f02,95f1104e8b604c98ae237020a98921c4,3,5,1,1,7
1212,b93810b40cc54b50bf1679e4dcb87ad2,2018-05-11 15:52:33 UTC+0000,9eacf68fa29846e4a45117dafcc2dd22,d38b9eb5ed5c4f02899d5e04dbabac5e,0,1,1,0,2
2318,b95c3e95c6cd417a905f2262f7f51081,2018-03-08 23:39:31 UTC+0000,f8f8108fe491462e8a09b0ce61279295,1ad13abd75b641198468b121e83e8706,1,1,1,1,3
7135,b95ed72b2f8748039c90f74af8f922df,2017-11-07 20:18:29 UTC+0000,42489ec04f37415b84e230e703cecce3,53e0062c6d2148adb3c707491829830d,0,1,1,0,2
3939,b96735af86584c08a76e2eb92d146563,2016-03-01 17:40:39 UTC+0000,ab087c5a187e49f08727981ed89716af,a1006e6a58a0447592e2435caa230f78,1,1,1,1,3
447,b990e2dd3ead454684358915e79a0cdd,2016-08-10 20:19:24 UTC+0000,736f4e44547b4fbcb34df570411b025e,36ff3b3666df400f956f8335cf53e09e,1,2,1,1,4
1180,b9a0297bfa9f4176ae72c7e38117477b,2016-07-20 18:32:56 UTC+0000,3f180ede8b9b448f97b3ebf2eb7c0d02,369f1c8646b649f6997eae7809696bd5,2,1,1,1,3
3718,b9a1e8acb53c40a892a3d96ffa96fc1c,2016-06-26 03:18:16 UTC+0000,aa06740340394932b9ac190901d1ca14,c39329e6c790449f812590c3b897aca8,1,1,1,1,3
1888,b9a86f6a97b242508315aa75a2482dc9,2016-06-24 07:48:05 UTC+0000,84c24110728044ea8a3b2c0bff861139,614ba4c0aa534b759b73e8473fd5ec88,2,1,1,1,3
3302,b9a9212d155c40ddbdd1bc324cca0681,2017-02-02 13:38:58 UTC+0000,ded5c215b44e4e7480fea8cd9642f54a,36ff3b3666df400f956f8335cf53e09e,2,2,1,1,4
7485,b9a9ad0edce646a1aee48c6da2387264,2017-05-31 14:25:27 UTC+0000,de49de131fd94c478ed2a5aa66fdc2f9,f64df9b489864952917cb631be1ddac7,1,1,1,1,3
7628,b9baede6aced4c5fa3fd1a3393190c37,2015-04-14 23:15:58 UTC+0000,ce4fa7fa915443088465811205af0b54,0355aaad83704ad98e6d71b79db85849,2,2,1,1,4
6037,b9bd128779f44bac80f32b6d078c3be2,2015-02-20 01:57:16 UTC+0000,1984087aa8f24bbd9da49775cc723812,c1341204dce1463dad3964c3f3f462c3,0,1,1,0,2
5480,ba01cb84af36449091e41c567156f6c2,2018-07-25 07:06:42 UTC+0000,be92726319224b3f9add88a737318b79,ffe2f26d5c174e13b565d026e1d8c503,1,1,1,1,3
1294,ba12001291c041f795babb74559b54bf,2015-02-25 15:25:22 UTC+0000,aa90121b16ef4cb081a79f9051abf407,369f1c8646b649f6997eae7809696bd5,0,2,1,0,3
1970,ba1353b17790444791524b7f0b5f5622,2017-01-24 14:28:01 UTC+0000,9e31bff02d124fa0b26a0c6b3b035565,30b1ef88592643dba57c33e4626684c8,0,1,1,0,2
4606,ba1a862d68534849a099e4fd6d84c6f2,2018-09-28 22:02:08 UTC+0000,3cc0f9d573294df184c60e3c64ae9e99,4c1333590d234f9bb0f4cf0eac4c6efd,0,1,1,0,2
4246,ba1b474c28b742fca9cd649f7dd96229,2016-03-14 13:01:21 UTC+0000,7973d995c00641578d6e98ac1a02f796,369f1c8646b649f6997eae7809696bd5,0,1,1,0,2
6535,ba23f731a043465a85401d30813a0545,2016-08-10 21:02:06 UTC+0000,924cb35315e64c369c82c201fffb7af8,dbfc21fbff414832beed41c7a5966096,1,1,1,1,3
2054,ba284aee7c944704800e9e657656b809,2015-10-22 21:35:21 UTC+0000,905c8747231e45439421c33c93476869,a1006e6a58a0447592e2435caa230f78,0,2,1,0,3
5302,ba4aca415a924eca82d5e63147d56657,2016-01-28 16:55:30 UTC+0000,c0b6d37e4c49417f98737218b23557ad,7919ea19db274c1fb862f3456cd25ac5,2,4,0,1,5
2677,ba4b1f61785549e89ab5ffd05220d30c,2017-05-31 18:49:51 UTC+0000,c20178b893504d18a5fb31cc84c6cfde,a1006e6a58a0447592e2435caa230f78,1,1,1,1,3
7462,ba4d902bd62b442cb24074553e79111d,2015-10-20 22:05:21 UTC+0000,febf0b7ec80045a4ace8c2e034e5f905,a1006e6a58a0447592e2435caa230f78,0,1,1,0,2
7094,ba5d5037adf9428696246dbb75655342,2015-08-03 23:30:23 UTC+0000,2b03a4424f384362aea2c8c74df432d3,a9ad3bd21f8b4631b18d6de7723d4c54,1,1,1,1,3
5248,ba6dbca92da54fb49244473e44f930b7,2016-10-21 00:54:45 UTC+0000,02f2ec19eb3242de97fba90eae49c525,a1006e6a58a0447592e2435caa230f78,2,1,1,1,3
4917,ba89b64e9efd4035ab16a26f01aacab8,2018-01-24 21:03:01 UTC+0000,182916f2258540358d1bccac15cfdb33,07c3bbf1aaf14e148c521245fd129eff,1,1,1,1,3
1844,ba91b31769ab4c0d94a86e5d065b9f4f,2018-06-28 19:56:46 UTC+0000,ab057c6394934564ab380068310617de,847f79ae984c43dfa7b50ea40b14e300,0,1,1,0,2
5446,ba9e95a4179a4313b2dcb298b1a2cd88,2016-05-29 01:13:11 UTC+0000,20b931043511462181464eb04e159281,58fa5e95fe9e480a9349bbb1d7faaddb,0,1,1,0,2
3,baa937b4cd184a22acfd76249d25042c,2018-03-14 21:38:57 UTC+0000,1011167b308b4f85a79038573b83f30b,714f9104e8b148c090e975f050946ff2,0,1,1,0,2
2575,baafd5fc6f454a1cad8f9626555005d2,2015-10-23 15:16:14 UTC+0000,3f223c7b7d364ab1b281f3836e1d69cb,70f812ce6f57465fa79531f8c56ecdf8,1,1,1,1,3
2092,babdcc271cad440c83de9adcc36f8a90,2012-01-13 17:29:43 UTC+0000,69409b8bbf4243ad80eae8e67551efac,392a273cb57b42389ec01a8fcdaff3af,0,1,1,0,2
7896,bae159bff2584d2d896e48e2a9c72dc4,2018-03-02 15:42:09 UTC+0000,c4a89de5a32a45ea840d4cdff048dea8,8ca0e5cb0ee743b792d90022587c1779,1,1,1,1,3
1600,baed98b1e5dd4e5e8a247f10551ab32c,2018-11-27 20:38:51 UTC+0000,286071c21932465a8e872c4f605b16d9,8319cd5b70d44d7fa5ab79c40c544521,0,1,1,0,2
3135,baf76b7cf5804811b20eac6a05a4bbcd,2018-12-04 20:01:18 UTC+0000,9d14ba5e1fcd4619bf561e5382f9378d,527bc8c35c8541f898bac819b29beea5,0,1,1,0,2
2817,bb08cb9f340d40079601bb4941406df9,2017-10-23 22:53:56 UTC+0000,472e004de4e44d49905a8540d51f1220,62df4121c5d64528a7ed438b9ad86d98,0,1,1,0,2
5095,bb0b3e3de16045cf82f1c1d1946cab3e,2014-04-28 00:30:58 UTC+0000,5232625462494880a65e9113bdcdd30e,fe4543418c0846e5a65fa22b4ad9a304,1,11,1,1,13
1562,bb0fc1b81814410abad5060bd0e0275b,2018-03-19 10:15:20 UTC+0000,393146e369b14bfe88ab764852119f57,4a764fa0d6284396b52929c04078df95,1,1,1,1,3
5552,bb45d04bc83a4e9da09591162da5a024,2013-11-11 22:46:42 UTC+0000,43e15800260a49b1b83818314290cf1f,4bce59e2537b4228adb73b856d2c6102,1,1,1,1,3
2497,bb4b384dc1684d4a94161e19dc4fe3f7,2016-09-22 17:40:31 UTC+0000,1a05369fde48429c9512cebe86e15f2b,373809641ef04ce68113c70f3d50ef98,1,1,1,1,3
3475,bb4c1a39d48d42dd80a268ed12e9c55d,2016-05-03 20:36:20 UTC+0000,f0140429d8974c8d87d3686600cfae2e,7bffa1792d474359b922e5de700d7a82,1,1,1,1,3
3856,bb56591d5aae4ddd836e58be1099fff4,2014-03-31 17:00:31 UTC+0000,68ee2d8067ca4b4889465279d497ab4b,0355aaad83704ad98e6d71b79db85849,1,1,1,1,3
3793,bb7492e136124924af6daf5faa230e99,2017-08-31 15:28:28 UTC+0000,3cc49c41c93040c5909009dc2f486222,258766b1a65f404a80044decd53e27cb,0,1,1,0,2
1092,bb7cb084b1524e52be168367a482dfdd,2017-04-01 18:30:06 UTC+0000,3d0fd591f01c48689554ad0c7da874a4,36ff3b3666df400f956f8335cf53e09e,0,2,1,0,3
1401,bb7df5f6ec514b0485deda392ec32839,2018-02-13 17:45:44 UTC+0000,e131419163e04bfea5b1f8a971e8de78,8ce1dca4e94240239e4385ed22ef43ce,2,1,1,1,3
3640,bb7f5ff2e3d34b13b43d3ad7a3edc563,2018-03-21 13:54:41 UTC+0000,dfef07d0c5eb479c9a544a120210c24c,c06cce1737744ea19a61b4c5f46b51f4,1,1,1,1,3
7205,bb83b410cde74183976cbeaa0ff4c692,2015-10-24 20:40:44 UTC+0000,41dac04315d94ab98068bd2a3a3d926c,36ff3b3666df400f956f8335cf53e09e,0,1,1,0,2
492,bb927c8db75d4f5b80255bb683007d2b,2018-04-05 02:45:10 UTC+0000,495de7d3b3a64cc69b978e0b88261069,96074d9b95094a7cad69b0e87ccc73f7,0,1,1,0,2
5460,bb970f8ada00459d8e87079b61be5cda,2012-01-26 04:55:24 UTC+0000,880b864feae444d6b3465556e4df1095,624194ea296c49a6a8ef1180787476dc,1,1,1,1,3
6010,bb9c0730a4234521afb6ced466c70fcd,2017-10-17 03:49:51 UTC+0000,165ac2c2fac34c81993e02198076d546,9a0f09620c6640718c1792a74f3b8438,0,1,1,0,2
6723,bb9e453a27e148efb7bf130c66a75d49,2016-05-06 14:03:46 UTC+0000,bd2bd3ae03bd49d48a4799e8b1b30a6f,36ff3b3666df400f956f8335cf53e09e,1,2,1,1,4
5628,bbaad0b1676345e590deba207b9f6bde,2018-01-30 22:22:55 UTC+0000,27c510437e824c61a3ea2f98d8e6b9be,d02f6d9faac24997a7003a59e5f34bd3,0,1,1,0,2
4288,bbd1d3f1299240a6addee8616a47da71,2016-06-27 09:17:55 UTC+0000,56a8a549044e44d3996e7803bef153f7,d635f511d63747238e2eb5376c76c3a3,3,2,1,1,4
3202,bbd847f9258c4b24ad42f02a715ab5d0,2017-10-10 17:19:40 UTC+0000,bfdde018a5594671b4767afa0a9db348,89b0bf5521a64ea5a8b56895d36a96f9,1,1,1,1,3
4438,bbe4999f1a5c4940bb1fe33c14648562,2015-02-20 14:36:12 UTC+0000,f825ac7c084742c8a86d41a873a5f10e,369f1c8646b649f6997eae7809696bd5,1,1,1,1,3
7199,bc0a26bf7a9f4d898f5edfb5bfcdda41,2016-02-11 15:03:23 UTC+0000,f6c8b25079eb4121810644fd6483ad62,96bbbdd06a334805a0501034d9df1aa4,1,4,1,1,6
619,bc0a682408544e228d57fb8a8fcb34a8,2014-04-06 00:52:05 UTC+0000,b8328b4214064a6da2c5eebca716ec7f,031c50365c1145c3a435627a74732fe1,1,3,1,1,5
2953,bc111360041440a3bd4e062d5d507104,2016-04-25 22:45:24 UTC+0000,5af9f5204acf4def8d796b7372f318bb,a266d892e8ec4dc9bc812981093b35bb,1,1,1,1,3
884,bc182ef255264f6996861bf7d38215c9,2013-08-05 22:32:49 UTC+0000,3bdc87536e8b4e7fa3a91464e0d82a6c,06bde59ab81a46978f3d8724b33e17fd,5,1,1,1,3
6675,bc222d684aab4a38880a8cbaf50f0c01,2016-10-06 14:38:44 UTC+0000,47931eac63c64bb287164d1eab4d591b,db1c8b6e2b3540bc832c67a5a27ef5df,0,1,1,0,2
2033,bc277e007443460a81b6d2dc3f561773,2017-09-21 17:51:23 UTC+0000,7b680e326fe64eefb772119a71a84708,fba595034c5a4f3aa27c3607b19eea39,1,1,1,1,3
4102,bc2bcb350eeb42c0a0d34e4e1a93219f,2016-06-24 07:42:53 UTC+0000,7e2285a2b1ca439d99c5f3b2122093b5,614ba4c0aa534b759b73e8473fd5ec88,1,1,1,1,3
386,bc3143bb37b14ea181b6c2cb1bd534cb,2017-02-21 18:34:02 UTC+0000,d89c203e24974f48b341ae6a2a0690dd,47ba124be5db44bd848ea9ce87f31a7b,1,1,1,1,3
1753,bc383f14aa884c15b88f1b65c91a3a4c,2017-01-25 16:54:58 UTC+0000,803aad0c66ae4938b25fc9092adf69fb,331c075b95c74215b0435818457f0324,0,1,1,0,2
680,bc5653ce1d44490584f515b622d32803,2015-12-19 17:38:50 UTC+0000,15441f7ca1f34b819d9dcd9614194f47,d954f43c12544dbc8cc5f2f30215ac0f,2,1,1,1,3
2050,bc5f36066b7a4663aefdc739513b27bf,2012-04-02 15:52:14 UTC+0000,dae15debfe204d3c908d91adac15756f,ee86609c6de843388b85702c105cf0d8,0,1,1,0,2
3084,bc6085e554444a58bead2c317dc79fe4,2018-05-26 20:17:00 UTC+0000,f0ada525bac64780be3cb34de1c6f5e3,36389a004e3d4ff3ae4992341e132449,0,1,1,0,2
5256,bc6b83a4a27c4c229dd386e7b51f3f2b,2016-07-02 01:54:25 UTC+0000,e2ba7a66ac2547858ce0cf212e214354,be5d23056fcb4f1287c823beec5291e1,3,1,1,1,3
1067,bc741bfeee0d45a38c493d00ffbcc584,2016-03-13 01:23:23 UTC+0000,19f5a97a77624011a49a706a79c821e3,bc2cdcb91ff3452d9ae443460ed3241f,0,1,1,0,2
5549,bc7bd05838b347dea079f15452d39c6a,2017-01-25 13:03:24 UTC+0000,615915313dd74e2cb4dfaf8b1f11eee3,cdc48d26d62049a0b99d73fa4f75245a,2,1,1,1,3
5949,bc7ce3d21ea5455591f3fa0e57779252,2016-03-01 20:31:13 UTC+0000,d2144aa1328d44c9b628d8a3bfa165ee,6ac46e8566b44bb393908601e5ca60e0,1,2,1,1,4
7139,bc83d24465d745cb968b2e2be5626861,2014-03-14 20:05:25 UTC+0000,dee6d866fc4f4fb8a0eead4bcd8212a0,7d425e8d7cfb4fe7b0702fff4d6d84e7,0,1,1,0,2
2194,bc8671a6bb054214b11cfb624e7aea0f,2016-07-19 00:33:03 UTC+0000,ca0f7d024f084f13b1a305bcf51adbf0,bc46e3699d92477ba8c7aa723e54a151,3,4,1,1,6
4031,bc962feb7ab94a5d90c3a2a6a75e776a,2016-10-11 19:45:23 UTC+0000,ffa205e66eb54cde8385f3838e73b7e6,1dd91f0c72814d29b73072cf3110c329,1,2,1,1,4
7517,bc9711f2b60d4fe5abb46acf22655519,2016-02-22 19:21:48 UTC+0000,46dd66656cd346ec85dc61c7fdc0eec2,a1006e6a58a0447592e2435caa230f78,0,1,1,0,2
1831,bca31921225246f0938ed4dee8a4d05f,2018-01-10 19:04:55 UTC+0000,8f723b1be0764651b5f7c174d756131e,eaabc3fb410648e1af6ad19b93e5f430,1,1,1,1,3
1388,bca7d3c4e2ba404b995f13c1e4283bad,2017-04-24 17:04:06 UTC+0000,a0ede3f792254faa941142d10d85a284,dbfc21fbff414832beed41c7a5966096,2,1,1,1,3
2319,bcaac8841a404a2a895755d9bbd869d0,2017-03-03 00:06:16 UTC+0000,f429ea92b8b246dca10d6215254b33c2,032c5cd6277e4b03bc9536b2b7974ee8,0,1,1,0,2
2192,bcbb97feaeb14894b694bd3d7b397aea,2015-03-26 23:26:27 UTC+0000,6c545ca28dce4828a89ad28bb78268d7,e3529e64e70643b6889353db79eeea3e,1,1,1,1,3
1237,bcc5d8adad0c463e9d9c48289e4e50b0,2017-09-24 17:44:19 UTC+0000,b265a85ee2094f93ad495630f49164ad,7919ea19db274c1fb862f3456cd25ac5,1,1,1,1,3
6159,bcce433fb8b24bcea1f257ec46a51f6c,2016-06-26 19:15:48 UTC+0000,f232069a6f6349ea917f7359ea027e42,58fa5e95fe9e480a9349bbb1d7faaddb,1,2,1,1,4
4265,bcd62a457caa4202979ad5d8dda8c816,2018-01-29 21:15:12 UTC+0000,1e22389c784e4fb3a17bfb6047d87d5e,a209eed08b8846adaf95f352b1325815,0,1,1,0,2
1503,bceb34433b944e7facfba3642888f5b4,2017-01-30 12:25:00 UTC+0000,8ae72ac5e59449bca8fc6b188d0271d7,36ff3b3666df400f956f8335cf53e09e,2,5,1,1,7
741,bcef1177017f4992a6da6bca9f87c910,2016-05-06 18:40:10 UTC+0000,eba3d0dbd4ec4eaea39413ea73c3906c,1272964da2504fe8a8a6400539cd8b1f,0,1,1,0,2
7323,bcf37b2c9a4a45288b6d90d062f8911f,2018-01-24 19:25:35 UTC+0000,45f339ed6cba46bbad6b6c04c593d472,8d44a3be2f91435d9349d29d83e2735e,0,1,1,0,2
2876,bd03caab5b9042e1bc4850abb43d3bad,2018-07-17 08:31:35 UTC+0000,8665d610d89a42b58b4f982a348952b1,706f6058c0ec4ea08cc4a591cdb7bd66,0,1,1,0,2
6174,bd27c702770e4c0bae5d6c793b4e6e7a,2017-01-13 22:19:27 UTC+0000,9e7bfc26d9384223becb1ea22251b58c,369f1c8646b649f6997eae7809696bd5,0,1,1,0,2
421,bd48e2ccfdce4cd68dff0769d6c0c4f8,2017-04-22 19:03:21 UTC+0000,4893342160e24b56bd66d74c639bfd81,36ff3b3666df400f956f8335cf53e09e,1,2,1,1,4
1030,bd49cd98900940f0a13c6eb134c36e53,2013-10-03 21:18:14 UTC+0000,41d209115d744c0ba8116daa373e68b7,949bc8e496c140d9b9f4000c979c5195,2,1,1,1,3
2280,bd643f64ce914236b07614287d647f85,2014-06-10 21:53:35 UTC+0000,45964c4121fc421fa4200307b6646f6f,8ce69f84a9e64cd380278f165b823cd1,4,2,1,1,4
6956,bd814b4d534a4870b779ec0076e59d25,2014-02-23 17:58:42 UTC+0000,c386f95a170e49c99d39adcd4131ab4b,2adab7916b3747af85b2d82e188c1dc3,1,2,1,1,4
3582,bd8741bd59d74d07bdeade9bf6e947e3,2016-07-23 12:38:50 UTC+0000,2f185106a25645d7a6b82fa3c692e3d8,3483a87fa53141339e10720095a20318,1,1,1,1,3
5919,bd8bc4d1a1ea4a9fb62c8a9df24a4d9e,2014-04-10 22:35:09 UTC+0000,f203e2eed20045bebf00bffe728faab8,6774ee9e8f9247728dbbe896726e911a,0,1,1,0,2
4866,bdafc686eafc49e99fb7c7bf721ecdb2,2016-06-21 22:53:29 UTC+0000,32d760831b01458ab4543461e616abeb,ef6678fa477d49f6ae3bfe4dcd9a0afc,1,1,1,1,3
407,bdc299e707204f0bb7732f6c93585a4c,2017-11-28 03:41:46 UTC+0000,7c5f574fbef44514bc58cdf625afe2b3,2b91603d3f704a6f8533d7e81d72c19f,3,1,1,1,3
7879,bdc992002a034b82a06541a69af0b813,2016-05-20 22:31:01 UTC+0000,f87102cdf104425a81d91af9df11227d,b7873ad20efe4ce9ac6926424becd33c,0,2,1,0,3
1063,bdd89ace1131470c9a07affc08a73c2e,2017-03-13 13:03:29 UTC+0000,5b1a816615bc45638cfb97500f500301,b1759ef11fcc4fa2ad9a58f4d9d9b52f,2,1,1,1,3
431,bdea7d9f690e47d7bf122e1e2ad0b0f3,2017-04-12 17:49:58 UTC+0000,e5b61a552b8545f3ab195842667040f1,2b1671d2c55942ffa33b95eafdccc404,2,1,1,1,3
6892,bdf059950f924132b957efb8cc4a0b71,2018-03-02 23:05:06 UTC+0000,150384cda07245eda80527fe6734fa8f,ffdccaff893246519b64d76c3561d8c7,1,1,1,1,3
6744,bdf280f06f564d78bbb3884aac486d95,2015-03-17 15:02:30 UTC+0000,b764572d56c24539a811b0431c541bdd,0db49ba52b1044ecb705d1eb9f8f6676,1,1,1,1,3
2267,bdfa260167a04c89a493ec57ae71bc15,2016-10-26 12:19:13 UTC+0000,5fec0321fc064ce9a1f799035280cf29,cdfe9b51ed734521a6e3193dba4038ad,1,1,1,1,3
472,be105d8f5ab2429fbf75876978d8128c,2017-04-28 20:42:16 UTC+0000,4d8788ce296a4a69887c7ea7466b9cc3,ddd2ab8af5594b41b03fd2b9b6a933a7,2,1,1,1,3
7343,be17f73d2370412e92c3dad3fca68773,2015-02-07 08:21:56 UTC+0000,105a978f9c354237a4364c9c1c148c86,de6aab0719fb41dcabba94d5cca74b54,3,6,0,1,7
4119,be1ee172be114bbdb9569de933ebfb18,2016-05-19 12:46:56 UTC+0000,9e9aee54640d496d95686b447c34f556,151749b9996b4e8480b5acbacccab542,1,1,1,1,3
89,be2bdfd9865542adaf441699ed127685,2018-08-29 17:36:26 UTC+0000,e315c0668f434a61be5dd9ab7168ddae,0beb82bfc52e42bd81250b7e4a504949,0,1,1,0,2
425,be2e9f7212784250bca72b7f925b386b,2017-01-13 04:22:11 UTC+0000,788e9c8af14841c7b9fc892f53035381,a72bde6ac9e349d195a6d356444c9578,2,1,1,1,3
3922,be30c7da48434d70982cf8bf6c524ce1,2016-05-06 18:18:42 UTC+0000,88d9a4da811145e7b1bf4df3fd019289,57cc7082c3ff4ffe83ee880e51314c70,0,1,1,0,2
7556,be3bd482e4994370bd8eb3b36ed559cd,2017-05-26 17:45:07 UTC+0000,6bcd4b81907b4954833b78c85e641040,67b802b7f38844da92eb67ef92696b14,0,1,1,0,2
7136,be3becd2ebab47be92726e3c24c1d7a7,2016-10-22 17:22:58 UTC+0000,a0c91e27d2cb419c834aafec1df6585a,4862d9b69b2c4f7f99da8fd235cfa3fc,1,1,1,1,3
4593,be3eef60cba741ee8036e7c85f7f8ecb,2018-02-28 15:31:55 UTC+0000,c8217d9a44294e35946c36149d4b07d3,5f5f9a00745f43c4b9bdfd12ae38810c,1,1,1,1,3
5107,be5de9ac6b89452bb68b56ec949ba114,2016-05-24 00:09:42 UTC+0000,f7910a75edd64e35b405ac7c3449b7b6,36ff3b3666df400f956f8335cf53e09e,0,1,1,0,2
7474,be6c9857e334442ab6de38aee6bd84d6,2017-09-29 12:45:02 UTC+0000,28540aa4277f4ff5a6a0fc51bbbb42d4,9d88c9d801364dd394036c67c3492a3e,0,1,1,0,2
1832,be6d8a4bd2d74115ab4e1715522b86b8,2016-09-18 21:05:45 UTC+0000,a30ff18f61a94f6b87709fe0b13613f5,62e26db7cfa0419da9e2ddc862f64b6c,1,1,1,1,3
2607,be736ee4204241339593e66bbd4aea00,2015-10-22 14:50:48 UTC+0000,f52dfd628c64459ca6ce101465fa3647,c1a24b8f746b47488da02a0e5044a7a9,1,1,1,1,3
4182,be80077a9cb94e47aaa017d0a0a4a72a,2014-04-07 19:42:36 UTC+0000,01706f047c26450cbe5df6e33797e5c2,c84b7719b1e14c80a5ad3ab52dddad3b,1,1,1,1,3
5296,be811e276dbe48d1a1ab261d07b1d384,2017-09-11 03:08:37 UTC+0000,37b96003d0fd4f43990a856607d1beaf,be5d23056fcb4f1287c823beec5291e1,3,2,1,1,4
443,be8468b58fd04edc92a2c3d0498ae2fe,2018-02-20 20:46:07 UTC+0000,aaa03710acd64bb1abfb13b198b73819,101f3856131d4a05a0471e1f878b19be,1,1,1,1,3
4331,be885150cbef450bbcbfca1cea883e2c,2015-05-22 18:53:16 UTC+0000,d360ed4d8efb4e63b66a3f0625588c2d,6c45a5332ff44c09b6c3dfdf53d2bc56,1,2,1,1,4
2378,be8a3bf914e244f6b9ac5bfc0c3e988c,2014-03-12 22:04:42 UTC+0000,f172d97a2b1d430a8e539e9ad3451c5e,23b6df4d73fb4d9bab3eafb6dd8bfb86,6,4,1,1,6
5643,be96fa0b92ec406b8d472e92bc69a418,2013-09-10 15:20:21 UTC+0000,befbea626c61462dbd585e46c80c1a55,8d525762ada04f7abea2bbbaece94be5,3,5,0,1,6
2422,beaa3e2348d54c60b592c8ea0bf562c8,2016-05-30 01:20:10 UTC+0000,fb00597f660b4fe5b2ad798496e11f23,58fa5e95fe9e480a9349bbb1d7faaddb,2,1,1,1,3
7314,beb07af5dfc74f35b8ec51a620c90587,2018-03-22 17:26:58 UTC+0000,f68c47aa12694792af14f77b31f79612,2ae1d3c1ab9b4bd1ba421ed5ffb143ea,1,1,1,1,3
4978,bec365e6af7749bca5064545021fc7c5,2018-02-16 15:35:39 UTC+0000,12da6109b41741b38087f04a238596d9,950898c71c6b4616b00b1d984ee71024,3,1,1,1,3
2717,bed2af0da0ce466ebac166feb1253e5a,2016-05-16 16:25:58 UTC+0000,77afc6430caf4c10b129ca5c959f40ea,8478c6985d1e4ee88086754cf6200ed1,0,1,1,0,2
6743,bedea1ca0bc54e9ea25239eb726179d1,2016-05-22 00:58:15 UTC+0000,8024e98eaa23465c928206c2413069dc,b953b3a5cd564558a13b7bbe04dd0fd2,1,1,1,1,3
2165,bef735f12070428f8bfeb4bcde47bde0,2018-01-24 23:23:26 UTC+0000,95874e9bf9214d62855817da2f5bcaef,d7f9afe721af42b1a03a993909e0568c,0,1,1,0,2
3293,bf29d5c265004a6b86933f340689bcb1,2015-10-26 17:38:57 UTC+0000,1d930b9aa7aa4254961733affbdb29c6,a1006e6a58a0447592e2435caa230f78,0,2,1,0,3
5110,bf2a2f9912714f288df7aefd4c9a5385,2016-11-13 22:53:27 UTC+0000,8b684919db7c4fc5ba29758a0c4a04ee,19cad786730a465ea80b22275fbebdff,1,1,1,1,3
2861,bf31f798556445569003019411ecdaa2,2018-08-31 12:40:26 UTC+0000,a7172e6befaa4d6db907f0f71d51ce81,7391990aacb24fe48e3f6a82a30a19b4,0,1,1,0,2
2081,bf3be38512cc401bb18ee7df1db97663,2016-05-21 08:31:13 UTC+0000,345ef7c968344fc0b4470b34807608c6,aa161927435d4c798bbb8b168663e664,2,2,1,1,4
5266,bf3fb82487204b78896a7ffc1e4b9fc3,2014-02-19 01:38:58 UTC+0000,9e394020e1c546b0b296dba7f8d3e75a,6fb945470e8247ddaf459f8643e6524e,0,1,1,0,2
3183,bf45fa5abd39476ea8e43b10cfaccbd0,2014-04-07 17:56:27 UTC+0000,d6377475c6c4435c8887eb6cd71c6e6f,fb55b95b86da4e7184c6abff35f432ca,1,1,1,1,3
6570,bf4a3332f68949f0a7af085b330abd37,2018-04-25 10:04:08 UTC+0000,52dd92e869a24d78bf5396492a896b05,c44a6a7eca4545c6b67cd5450758aaa5,0,1,1,0,2
7149,bf578574bc0e48b6872561a061b27656,2018-01-24 20:06:56 UTC+0000,6417216da6484307bb1c0dc4e2c5035e,9a1d143c7f604d04bafb35117a4d3c84,0,1,1,0,2
971,bf64dfa3a0fd47d7a9a5c2a9814c2a54,2018-12-15 11:02:11 UTC+0000,2e635650e19c4b65999c61eb0c7e73ff,6ee9c20eddbe41e890dbde50fbd63f44,0,3,1,0,4
1227,bf6e98c98fbc4b01b42a38f34fe5f6b5,2014-10-19 20:38:40 UTC+0000,f94b2343f07a4671aa5468c46149a1ce,05444a2f42454327b2ac4b463c0adbe0,1,1,1,1,3
1859,bf8c8286d25d4cf1b40f1fbf09bba4a6,2017-02-09 03:00:28 UTC+0000,e28b017d68014cf4ade5b5cb9006cab8,6806eb65d3714622bd3b0c47bb7e9342,2,1,1,1,3
6044,bfa1f750ed3b4d00a193f347b11cdc7f,2016-10-29 12:45:53 UTC+0000,3d9650537a894ef4a8db30b5bb70ee96,7f92fe26fd5d41668f84254bdcc99697,0,1,1,0,2
1974,bfa915aa1a7746b192f66a1350b9eedd,2018-08-22 15:13:28 UTC+0000,f6882b9d59df4d06b8601e5e83f75a81,be5d23056fcb4f1287c823beec5291e1,0,1,1,0,2
3062,bfb337cc34674129b49c9626832b8bab,2018-07-16 18:55:47 UTC+0000,edcf1b515fef46c1b0fc4fa3e15e08b1,85f378f43eee44c986addf5fc27038ce,0,1,1,0,2
141,bfb5d4ebf8e94c59b9555402125a356e,2018-05-30 00:47:21 UTC+0000,dc013d1166f64c8888b95f585a6e5004,d9ee4b1f242d4bf2a395b278faa56de4,0,1,1,0,2
5463,bfb6d862f62f40628967df7cbbfc0d48,2015-11-19 18:01:14 UTC+0000,b839ac4003684a20a473d8b467df05ae,ac81f47e8afc4c1db391ea2a65f21d77,3,4,0,1,5
5120,bfbda759fcfb4741aee50473ce786878,2018-02-11 00:12:09 UTC+0000,d71a26a1cc724da0b4b0712c52e0cc5c,5bde22f47cc04936a9d90e5ea2fa458d,0,1,1,0,2
1266,bfce2ca0b9544d6db5e99bbefbfa7b91,2016-04-27 15:01:46 UTC+0000,1ad4248d80954289a00e72c6def172a3,67950358756c416aa5dccf1dac9ce313,2,1,1,1,3
5877,bfd0b4770b09455fa2175cced1f4d0ee,2015-11-09 18:04:01 UTC+0000,d20dd11f585741a7aef56d353e29eeeb,a1006e6a58a0447592e2435caa230f78,0,1,1,0,2
821,bfda858600344f5fb93f759990635a47,2016-06-24 23:36:41 UTC+0000,5ee0c97aa42a4937acfbcd532377ac66,6ea2a8a29d904015959ae16913092ac0,1,2,1,1,4
2812,bfdffe56bf454eb683f582772ab4aa60,2014-03-11 23:00:08 UTC+0000,03b0ffa36e314b998108b8e60cdee129,6b9b3ac403544af6a6ae76c3dadc939b,0,2,1,0,3
2257,bfe97a2f376d4f96a84175514932dcfb,2018-08-28 11:26:18 UTC+0000,3fe1924f12f94280821c776df481c638,36ff3b3666df400f956f8335cf53e09e,0,1,1,0,2
3378,bff150b302154714af3ed36031f39923,2017-01-25 12:58:00 UTC+0000,10e6c12ed4a84230b1eec716b1fe7585,03c6b003de0b4a02bd363c8f52421e33,1,1,1,1,3
5902,c0027974e4e840e8b64473049aa7fd18,2016-04-17 02:14:00 UTC+0000,f348acaba6174fec82ad20aa5a67e447,58fa5e95fe9e480a9349bbb1d7faaddb,0,1,1,0,2
1152,c00b3632276b4870bf629dc19f52eb03,2016-06-23 01:59:50 UTC+0000,19eb560a42ac4841ad1c752d727f1c4e,06eebab6ea4f421daa1c7ebfb4467021,1,1,1,1,3
750,c01c076feb664c809a6ebd217124864d,2016-07-05 07:24:34 UTC+0000,c4702881af4145d28ce25d243df677df,35896fffa3e847fe8700f9d52c5d23cc,1,1,1,1,3
5842,c0221f6dfba34a8a81a8be9e5118ec04,2016-06-24 03:00:44 UTC+0000,8aff6c15a5f9455d9c3976f9bdafba5a,06eebab6ea4f421daa1c7ebfb4467021,1,1,1,1,3
4267,c02b0f0c302948d096cb1bcc45e245d6,2017-02-09 23:59:49 UTC+0000,76ee8bd248f9499d890a9708c580304c,ef6874da18704019a8c2848b804d41d6,0,1,1,0,2
3245,c03e425d783c4eddb851b3392785952a,2016-05-17 22:26:30 UTC+0000,69dbd467c6ff4e43b8503a4b76745f9d,a488b31881134e9e8a607dcb03fac41d,1,1,1,1,3
3729,c04ba91f8c2649a0b50036357a744948,2015-04-07 16:35:24 UTC+0000,c41a50a054d049d79a751889cd782ddb,6dfb300f92094ae19956f4cba56bfba5,2,2,1,1,4
4388,c05fea30faa741ac9b857badfe634900,2018-01-26 04:15:38 UTC+0000,e8dcff0572c34ea68524c87484ccd232,95afc7f032aa41809195d0d1f989c9bc,0,1,1,0,2
2513,c06021d589d24e8bbbb6b84a6073b20b,2014-12-03 17:20:19 UTC+0000,de9ca380fbd744c4a8f00daaf7ac9e61,4520f122d31241f6b83e3606ae3a1922,0,1,1,0,2
2074,c0646acfc63641b38b66823277b639ff,2012-01-10 04:44:32 UTC+0000,0b4b7391a9ff412c81f33e36ffb52bb2,392a273cb57b42389ec01a8fcdaff3af,7,5,1,1,7
2239,c08b077e53d1415686ffc8147027ba41,2016-06-08 10:15:55 UTC+0000,0a242cd7513c4c239ab9582c206f06e5,9ba4bcd9f0a84119826aa976b9424d43,5,6,1,1,8
3817,c09a603b818c4681a0b94285cfed46d0,2014-05-30 19:16:51 UTC+0000,68accc06df104e579266b9e4a618d119,ba94e0e8349f43b582de19ad7d190518,0,1,1,0,2
5422,c09e1d019d8645feb5b1ac71764dfb8c,2018-03-20 15:24:54 UTC+0000,c1ef95a8b09b4870a6caa9c60465bcf8,f221bf19f433493b8666e093c2365e54,1,1,1,1,3
628,c0b03aa5376244fc961fa4d0c2a07ed4,2016-12-19 01:32:51 UTC+0000,de053eea23df43debeac7d30466ff672,65f4cd631e95448f9069fc99f004714e,0,1,1,0,2
6681,c0b086b512d14c2781fa67856d7d9fdb,2016-06-06 13:58:06 UTC+0000,7ce9701c2c624e9eb3b64b620e9fd7ca,2a07d7129e754be9b5ce0cc7839e0159,1,1,1,1,3
7144,c0c440a9b8674109a2951f6488373e00,2015-01-15 06:40:25 UTC+0000,ef9c1d13d2a343fcbdc66d6abf824d76,93acc65fba694fb5a4a9e590dcd81c68,1,2,1,1,4
2483,c0cb21a0aa114081b3d7b7c67b11e918,2018-05-21 16:05:56 UTC+0000,c631386291ea4bda8a63ddeac373f906,899144674c394f31acf3aaa93c998099,0,1,1,0,2
3377,c0cca9e19ff9471aa097025db4385736,2016-07-20 11:27:20 UTC+0000,bd81ed07573e4990bc69a2aafc4ca83c,36ff3b3666df400f956f8335cf53e09e,2,2,1,1,4
2628,c0dab878297b4c2692204c63d798c4a7,2016-03-01 19:35:40 UTC+0000,55025eddaaea4e6aaac2640c1807b331,bdd28bb878494d4bb10e7ae0afc3ec0d,0,1,1,0,2
1948,c0f4f2050e384cdeb88188cea7ae4170,2018-01-16 17:53:14 UTC+0000,c6a938e6a90f42bbbad7f4fa37991bc1,f46b9949552c49fcaea5c9aa624e2ddd,1,1,1,1,3
3263,c0ffb45083da42c3971aac8da3b747a5,2018-03-03 19:57:52 UTC+0000,a202a5ab84004bd68b4ada1744232907,05ab77d4c6a141b999044ebbf5415b0d,1,1,1,1,3
1359,c10577fcba7f45a7ac53e05b69127bad,2014-03-17 01:29:39 UTC+0000,31b73c79aeac47c68a57ec5086d2905f,05444a2f42454327b2ac4b463c0adbe0,0,1,1,0,2
4898,c13414cad121485d872fac3fe00a8f3e,2014-10-03 01:54:50 UTC+0000,e5227de3a62e4fdb86ae87e315ac213c,3a86463d20df47b1900a5662ca715e2b,0,1,1,0,2
4136,c14357e6d9954b8192e6b99a7ba8a3c8,2014-03-27 18:29:25 UTC+0000,bd936d9d57384bda9c2b9d5e0b1ac952,cd33fd35feeb42c8a8683c74dbe0894b,3,4,1,1,6
3144,c148927a65dc4986bbdc5c1e62a2d29d,2018-03-21 22:42:22 UTC+0000,26d980f4e3b948649f3e977eb2852327,887997922d0846cdb8d91e371a4dc69e,1,1,1,1,3
6239,c14e4e9738904a538e24322739f65fd6,2017-01-12 20:11:09 UTC+0000,5c7fd0a7a240418a97a2c399b9d79f79,fafeba89ca764bd891862fb8440a2962,0,1,1,0,2
336,c15403d401274f638180461393f96dee,2017-02-04 12:36:08 UTC+0000,898599ed244441358b97ad1f84b269bb,d9bae0de3da04c7ebbe0879d410a8179,1,1,1,1,3
327,c15625684b994836b3c7446eeca9fdbe,2016-08-08 01:31:59 UTC+0000,808493098c3b4f17b4d0bc1965107d0d,a012826fa7334445a232ce054c76d0e5,2,1,1,1,3
5174,c156fa6bfa3341d2abd21b2fb6cb1781,2017-01-17 07:33:09 UTC+0000,934d9069c51a403399101de7b840061d,9496418c2b6a4c059442c81cd73d55e1,1,3,1,1,5
1778,c166e723c96348778b7942986419efb4,2014-09-09 16:49:06 UTC+0000,82d54fda817846498fbb4b9097b7a1f2,97f3d6304ba849058b5d3f9053c939a6,2,1,1,1,3
7923,c17130be7a8b48f6998b667f06f397c7,2014-12-03 01:34:44 UTC+0000,ec3e1717253a466bb44090a48a9e473c,f821c51a97fd49b6ae9104a65fa63d8b,2,1,1,1,3
4751,c175645c2a2b4a828ea5cdd2a14b4913,2015-10-16 13:33:13 UTC+0000,98dbdf31ae644544946d104a3ba65d6e,bd14d936ea3640d48dc0f8af58dbdbac,1,1,1,1,3
4987,c177a08b702d4f2a8f9f77ebaf023ebe,2012-01-15 17:09:20 UTC+0000,b8321456238e45428e0424a638b553c6,a71fdedfdb8a478cb19f6fdb761da215,5,1,1,1,3
4489,c1795b5ae22043cea52d2420a596c149,2018-02-02 21:38:13 UTC+0000,a7a8b06bca0c4c118928e638cae16701,1b7b629021c845be82787bb98eb81962,1,1,1,1,3
3842,c17a628452e14b0083c1dee11a2049c3,2016-07-01 18:38:34 UTC+0000,0e36d99f90594f4f965ca6765301dbd4,b472644419d141c79fbb3b3745750ed7,1,1,1,1,3
879,c17b3d6ee81c433ebd3e4fd4fd9df240,2018-03-05 16:38:24 UTC+0000,31f85a81b3eb43ae847c019494f86da1,f1cc078488fa49b2827a9671ab1cc582,1,1,1,1,3
5042,c19fd6d2952148ee8187f4c4138f13f4,2017-09-12 04:46:41 UTC+0000,52fb921c77ad471bb927ef755555ec14,89136201df7f4ef0950a9a7454839181,3,1,1,1,3
4636,c1ccdae21dbc4b9aa663f13af8be6556,2016-04-26 02:21:05 UTC+0000,979a21a617324d0bb359f4e9d3b15ec7,58fa5e95fe9e480a9349bbb1d7faaddb,1,1,1,1,3
5849,c1d4f4d4f32e42be9b09f1904fe083b4,2015-03-19 22:01:34 UTC+0000,924f21dfb4f643e5960dc47f53266861,24e8fdd2e4694913b2f5965608207dc6,1,1,1,1,3
5750,c1ed473b17ad4c7288b390920493b82c,2016-03-01 15:55:02 UTC+0000,571d7fc129324e29a12e6f16689b2078,1fe1ac082d054b62a494abb56dbbb793,0,1,1,0,2
6227,c1ee611ed50449b1a4c79e707599f59a,2014-11-25 15:36:04 UTC+0000,bdabb5c7c00143baa5f0c85213242d9e,64fdb079c8bb499896c91874764b6910,2,3,1,1,5
3315,c1f3225191df492fa630befa4c922d59,2017-02-10 16:32:41 UTC+0000,0f1f560c40c04cd0890b61a38ca9f00a,03b94ff8a7df4b77be80a051cc5f8f27,2,1,1,1,3
2704,c20867b3088b49959c65c3658dd10363,2016-05-19 17:28:55 UTC+0000,66ba5180401c470a8b686054d1055a47,ec0668e9a3384d13a03c4330639302e5,0,1,1,0,2
5906,c22ab85ac83044ae815664018ae47fdc,2017-05-30 17:04:22 UTC+0000,928db8cd52594d1cb0db2fe7444a9943,e6401f1428d64f559d67f1c96ee34733,2,1,1,1,3
6090,c2303333ed4e4df6a2416108d683d3a3,2016-05-03 02:51:19 UTC+0000,426859cf2c144d1db22b08527a8862df,3fb1e23be8b34811a8ef2f271867c425,2,1,1,1,3
769,c23416b2fc84483b8b0a73fb06eff4c7,2016-08-09 18:28:04 UTC+0000,501899026d3642c6bc5af155cff42803,369f1c8646b649f6997eae7809696bd5,1,1,1,1,3
860,c243b19e8c5848a0a300de89f610e67d,2016-12-09 21:16:34 UTC+0000,2bbfef5fb1e9473a8ef5926a5ab55c64,c4fd2fbe6f1148f9b56b69b0de48caf3,2,1,1,1,3
4361,c251e9b91d2945cdb0cb11c5ec8aa8e3,2015-05-22 17:01:07 UTC+0000,7a2de4cff65f47e38b77166105229af5,c1341204dce1463dad3964c3f3f462c3,2,1,1,1,3
7689,c25c3a8558f3405ab8df5375d235fbe7,2018-01-24 21:35:26 UTC+0000,f8242078e92642b5b1e9101ba432893c,02fa095b47fc49e3b7cef7f5565015ea,1,1,1,1,3
978,c26831cbc6c84a5fbef876591ce021ad,2018-09-04 12:35:12 UTC+0000,926da9f3f5aa419d81eab563f89d2a51,36ff3b3666df400f956f8335cf53e09e,1,2,1,1,4
4065,c28320840a574e6ba72dbc3e61125d53,2017-11-16 10:57:40 UTC+0000,7b042ce7ba504e8dafd28fe3bb4b5223,97da3942e54140a5b8fd088267b7482c,1,1,1,1,3
3747,c28b7191e4894eada748b31a763ed9c0,2016-10-10 16:30:12 UTC+0000,e9d8ef52cfa14037ada30296b5609501,3d9d9f1eb2704467b3cd76f9cc2a75c6,1,1,1,1,3
5662,c295f34c69874b4a86b046bb17c7c6e9,2014-05-01 07:57:05 UTC+0000,1d32d57fe75849d4bdea26e737b1d037,6e1e1d5a80de4601b300307d68733c22,2,4,1,1,6
7929,c29e31d911ee41948e9da980babea379,2012-01-09 04:44:41 UTC+0000,94d60cb0ce784925812bdfab21152798,05444a2f42454327b2ac4b463c0adbe0,1,1,1,1,3
2337,c2a24f0a9d434562a84017b9f807685d,2014-11-15 00:02:43 UTC+0000,60863299bbb24acdb5e28977d8e6bc4e,55b940e77e854835b366a776d61b2fa2,2,3,1,1,5
5660,c2a5ec739ea1480a80931557f867411d,2015-10-16 00:04:45 UTC+0000,6858785418644642873c6eba02fa3890,1731d1ea92604b7ebc5fbf15a221cabb,0,2,1,0,3
3668,c2aba68b1e194db2903340bc313e921e,2018-01-11 06:14:12 UTC+0000,b59b2008a085412084e6a3737d13948f,598351eefc5d436dab91070c7a0e6ba1,1,1,1,1,3
3358,c2ad62538db94e1ab7c13b45b15c7490,2014-11-25 19:37:53 UTC+0000,a236b69d18cd4ec3afafc2e637d4e6cf,017948229ced47b9a630327ca84853ae,1,2,1,1,4
1877,c2b48a41f28542e4a2ec50aafd0101de,2018-11-29 00:40:49 UTC+0000,9eb9599f169e465084d191ff77319286,cc797f0504b547fdb1e0d4534f9d0b50,2,1,1,1,3
7696,c2b86f7001214d4b8908b5f8fc904421,2014-05-01 01:11:37 UTC+0000,729c5c06b0b64bd99158d84b1cfa240a,fe4543418c0846e5a65fa22b4ad9a304,2,2,1,1,4
5516,c2c627a427d3491ca81d0adf3cbbb401,2017-07-08 03:50:02 UTC+0000,7d1f22062d7a4e8386ce7fdf3a1a5794,81fddcb0d4fb4a18a313aa8c3c23cfb1,1,1,1,1,3
466,c2c7b2a54fb54b5c849c98f6d52e1bc2,2017-11-09 18:53:57 UTC+0000,24b52aa908174a2e80454f01fd6be072,72a2081293cd4bbcb6075fef60600ec1,0,1,1,0,2
4948,c2cef8895c1a4a8091dd3cc7eca09b27,2012-01-22 19:04:48 UTC+0000,85ea56d377344ec1aac5312c6e675c69,6b4fe248200749bf9e9a6474309d012e,4,3,1,1,5
5164,c2d250bc6f2b4ad5a303f1787a33d628,2016-03-19 00:55:23 UTC+0000,1b1159e4fd3444f7a2f583a0a07a72ae,58fa5e95fe9e480a9349bbb1d7faaddb,1,7,0,1,8
2879,c2d815012c104091b08295fcd019ef4c,2017-09-03 20:12:48 UTC+0000,e19162537b4a4b038c6b671bf618b58f,e1d39b665987455fbcfbec3fc6df6056,3,1,1,1,3
1805,c2f2793adda6415fb4b83aaedea7a984,2017-07-26 03:54:46 UTC+0000,b3ec650302a64013ac85c907e8fc41cc,990fff7d49a945ce9b84be1a3558643f,0,1,1,0,2
3862,c30275d02c3345c6b8ca0f332e0a254c,2018-09-04 18:36:28 UTC+0000,1a654cc8391b47e5b4b7f5b125966756,be5d23056fcb4f1287c823beec5291e1,0,2,1,0,3
7670,c31152ccd4a147069fadb3a1db76c5a9,2016-10-24 13:19:55 UTC+0000,3ac2c84a6e594908b8d96757cd672a95,d67ce930870945109a7ad86d29ba2035,2,1,1,1,3
2080,c3196e8e7e6649e989f27ebc246abcb5,2016-06-24 19:06:44 UTC+0000,cb1b0b8d27e14258803ead561827608d,b7ad4a96122b47fea182dea5cc86da3f,4,3,1,1,5
912,c328788c959b46ab83ac743d2f51d3b8,2014-03-06 00:12:44 UTC+0000,d9fae8e3bb2c4645b7154085a66011bc,3d8847ddc8d04185976a9e78b190ebdb,1,1,1,1,3
3439,c3409c88fec246a7a00a8ed163515a5b,2014-12-02 03:53:47 UTC+0000,1d5b2b2008894ffe8a413f873675748c,220268291a10427aa820c1768f225934,0,2,1,0,3
6786,c344860f48b84ebf90fd0aa78cde4b0d,2017-01-17 07:31:37 UTC+0000,8313e2b28a5a42589726aca00a889078,9496418c2b6a4c059442c81cd73d55e1,1,1,1,1,3
3637,c34a5e8e9fbe41c7b8afb71dc831c092,2015-10-26 19:28:20 UTC+0000,5c4b12c32ba34260a99d48b8d705ee50,a1006e6a58a0447592e2435caa230f78,0,1,1,0,2
1151,c357b8de9af84f77811e394f46ec8ef2,2015-05-20 14:46:52 UTC+0000,a36951e935734c2c9e99c3c3819c7a0d,88a5a403a1184b23be37d56f0f042fd3,0,2,1,0,3
4030,c357da7b98704951bf92232fe1e7b67a,2017-01-05 16:34:54 UTC+0000,cb9bc4855f7749638aca31b1c0d1f8aa,a1006e6a58a0447592e2435caa230f78,1,1,1,1,3
3370,c35fbcf19b0e49b4b0000fcf2aa474f7,2017-03-22 00:12:26 UTC+0000,281437ae5afa4c5a8d76db81ec3bfb2d,6e0742bf65064a1e9a01f4608138a9cd,0,1,1,0,2
8016,c363746bfde9436da3130a6495e351d2,2018-03-16 18:21:57 UTC+0000,4d939311039c4d08bfc527d54fad1d44,ffba48ec9c234f918f563f2b93d4927a,0,1,1,0,2
4304,c366956184654672a2bd9badb4c99c7b,2016-04-29 03:37:02 UTC+0000,5ff47b5eb47b49919669262e45bfa52a,c39329e6c790449f812590c3b897aca8,1,1,1,1,3
6031,c36887e512304cfda09262ef1f19d416,2016-05-07 17:57:54 UTC+0000,be50d0a47c6a4b1590c2baa215b244df,58fa5e95fe9e480a9349bbb1d7faaddb,0,1,1,0,2
4399,c36c7c892af946ac817af510ee7624e7,2017-01-12 22:39:48 UTC+0000,f725c88a76fb4d4da47dbcea6bee3f2c,9496418c2b6a4c059442c81cd73d55e1,0,1,1,0,2
1450,c3911074d539482ea88cad1506f8f4e1,2018-10-17 17:34:36 UTC+0000,3194f1d31bbb481a815704a9d8473d18,95bf1a3ddaa24e68a153984e081b7b58,0,1,1,0,2
6298,c3ae0a3ab08b44ac91e43dcfc826ee04,2016-05-12 12:15:25 UTC+0000,07946f95609644a9a324eae22f888956,f61bc43a3d7947bf94991fa475ba9a88,2,1,1,1,3
5562,c3b11f421e64446b8d88ab565805ee43,2016-05-11 13:19:32 UTC+0000,f9055b5c60ab4a5693f1b67a7981c902,01220b6acf574fd0b61d197a7c358ef9,1,4,1,1,6
1629,c3d0380ea4984804853c778782f40992,2017-04-05 20:52:39 UTC+0000,30436f6244a243a9a0d8e9b583c3219c,49432ef112b540a3b39e95f9e6eee6ad,0,1,1,0,2
5972,c3e6e57cb27b4134be9b8608a711e2fc,2015-03-23 23:18:15 UTC+0000,022e9ac19c2a4548b068b2c44c0e4f79,5fe1c1ebf97d43349c1ea42ba3cbc0e4,4,1,1,1,3
7576,c3f1b88579fe448792357e44395e1a19,2017-09-20 23:13:13 UTC+0000,1edc522402c54e5eabbb22a81abef4b4,87fc9db7d31344689956a7dcc746d0ca,0,1,1,0,2
6363,c3f34144efa7491995fd84ae021d895b,2015-05-28 18:55:36 UTC+0000,922aabd74d8d4003a28f6a1e1cb9b7be,7aab6fb9a4ae4d0197fd2bc05960ba56,0,2,1,0,3
2143,c3f76844abeb4336ac172a4ccbc753a6,2014-05-16 15:53:30 UTC+0000,1f08260ac70f411587c578e14a086db2,d8294027cc374787bf0cd8e25ed6d202,3,1,1,1,3
3838,c3fa51ea93b84d9b9b44f3cff366c87c,2015-04-24 00:18:32 UTC+0000,8d0864120ddd447c91e6a413c0c7e761,1b4459e849e74e21beb4c26417b0f584,2,1,1,1,3
3709,c4012157bae440889ff2e4d6073d9082,2017-04-05 22:28:51 UTC+0000,1a9ef6b1ce4f42bbaf297e9fe4f11412,5361e4e6be2d40729ec52dfbd5d5ecd4,2,3,1,1,5
4218,c4065607073a45609a36f3bd4e164636,2016-10-28 09:41:04 UTC+0000,195c584ddcf84553952b23af4eb8bd63,28ca854bc69c4630805fef5d6cad0ca4,0,1,1,0,2
6114,c40b3ef9128d4c1181cf7be68e326a79,2012-09-09 06:44:57 UTC+0000,6560187121384a9b86c53784b5d50637,f05b33a454c048f3bbc73f5f3f7f5127,1,1,1,1,3
2218,c40f0b995ab344d5a6c038c5248cddcf,2016-09-09 16:22:12 UTC+0000,bcd3da94278e4db4accd0677a1ff84ef,a1006e6a58a0447592e2435caa230f78,0,1,1,0,2
2367,c43585b6ead140c09c76b665818e9baa,2014-07-18 03:26:02 UTC+0000,8b6b3529188840b0ab46f2ed9a63d380,d6ffa381611e4bba9f92d7a5b188e195,2,4,1,1,6
1836,c439647e646b4169ba3381b49781848c,2016-05-05 15:51:04 UTC+0000,33c18bf3cd3c4ed387e372ab30aaf7f0,96bbbdd06a334805a0501034d9df1aa4,1,1,1,1,3
5246,c4445a8823fc419688c84919bc93a641,2016-11-12 00:00:03 UTC+0000,b946cf176d1044539cb9f7718b77d097,fafeba89ca764bd891862fb8440a2962,0,1,1,0,2
3847,c44d4657dd9e4cee9c440f47871545e5,2016-10-06 14:52:27 UTC+0000,e5fe313f0bd14043a62313c34d825fe2,4dc04945263c4e13a43025ab8e5a53c8,0,1,1,0,2
79,c46c70ba9a1c463c9aa1371d29133f54,2018-03-16 18:01:08 UTC+0000,e8ee3344efed46268ffd6178fc222db9,d37d66f0e4394ab695b8d7587299d7cd,1,1,1,1,3
332,c490d4c45f4c493aa83a19a3981dfa6c,2014-03-26 19:15:31 UTC+0000,ec498d08aa9b4301bdd83804810d7b8c,c9d16317cc454afaa2833bdd14e0e67b,2,2,1,1,4
2516,c49511395db2432a8cd01bc92b2ad562,2018-05-17 18:35:33 UTC+0000,495a3267478c45c8b1d3550bee48e8f4,9eaa05d297f547838d7bd3450c7c0383,1,1,1,1,3
5109,c496adfbceeb43cb8e501741d2cd1db4,2016-05-16 14:03:34 UTC+0000,d26d215de7534c0cb66d337dbb7c784b,81c4329d8d1c4f499575fcfa99e8cecf,0,1,1,0,2
7913,c4a43aed47da41dd963351a92b10c774,2015-10-09 18:22:57 UTC+0000,c3157d79bd5547f98ea8360610a29a32,8f80d9dea05243608687b7e131144469,1,1,1,1,3
201,c4b6f5efffc44b93af8a9f11e3fb1514,2015-08-03 21:13:06 UTC+0000,cbc93e2fedce47d783cd2e1857464519,e3529e64e70643b6889353db79eeea3e,4,4,1,1,6
5498,c4dd4b22be7041da9e2864fea91deb3d,2018-03-06 23:02:37 UTC+0000,11056a2006a74cafbb1227a9bbada667,887c5a142b42466fb74740d72989fc74,0,1,1,0,2
7600,c4ed36fc8b184d079323fbb6ca3a7d6c,2017-05-13 14:42:16 UTC+0000,2732dd2ecbe64ee98cc4de34af499727,fc4e5c87831e4ff8af6e112982d23f35,0,1,1,0,2
2136,c507f92c115a40e4b46c23daa12ec2df,2018-02-14 18:32:44 UTC+0000,c39d79af4fa84bf8a97cb8873e035a75,a7add7c8b1a145bcb15361436b835a7d,1,1,1,1,3
4353,c51117408a34402c8ee9c2e69acaf8d1,2018-04-12 13:50:11 UTC+0000,b8854162a28f4cceabc6bad922db3cb2,a7730a0f42cb4cd6805cecc03ec2df0a,1,2,1,1,4
1321,c51b2225dccb4f349bae370f914cc149,2018-03-02 22:09:10 UTC+0000,671335d9bfbd4255a0b1b7cbd1af340c,81aa977a2179486bbd080a00f114d9f5,1,1,1,1,3
3920,c51c8fda59e24bfe80c764ea0b24c670,2017-02-22 17:14:47 UTC+0000,22c2a6ca5ecf45a98b3a8b1b6c52ae54,9e0cb2a2914c4d05be76c85e7ca356a7,1,1,1,1,3
2134,c51d843cf9514457bd8156205a1e5406,2016-09-12 09:39:39 UTC+0000,d00ea6b1142440458a1e11e278b70355,dc76158aa87a4d6fb6bda6d2752216e0,0,1,1,0,2
4404,c53cf80a2e1b4bcb8a76052238aed123,2016-11-28 22:02:31 UTC+0000,f7d3d2c3f9924221a86a192957ebecbc,0deede9656b1497e9067b3b7d68a0006,2,1,1,1,3
2244,c556dcb2e98e434bb66cb42d48635e16,2014-02-21 18:19:11 UTC+0000,0325cb913c6f4e818eccb81104699c0a,5ea0c9a96d0f40cc8d29aa1250d08b79,0,1,1,0,2
1646,c55e783d6fc94e198b58eef703d4e18d,2016-04-15 20:36:30 UTC+0000,4a2405e406824159a5e256ecda6a4937,36ff3b3666df400f956f8335cf53e09e,0,1,1,0,2
1827,c56a321330074350a373a69450ffeb3f,2017-01-23 15:45:16 UTC+0000,ef8dadb139bb4781940bc4c13dcd3ee5,3483a87fa53141339e10720095a20318,0,1,1,0,2
2841,c58ecad99b6a4420b65547d9e4d86c60,2018-03-23 02:56:53 UTC+0000,7888c0d29adc474bbde67b8f9744b563,720e334c824e48fa914ccdd60a8ed706,1,1,1,1,3
1739,c591cfd5d0a94d9d8c6e06c3c1ac96e2,2017-12-14 14:25:13 UTC+0000,5b2b8153856948f2bc27c9d16fb8fc37,887c5a142b42466fb74740d72989fc74,1,1,1,1,3
7297,c5a36e755eb54aae925eb81cd0923d84,2014-04-25 02:52:18 UTC+0000,aee9d18be8f340e8baf673a803b9eb3e,fe4543418c0846e5a65fa22b4ad9a304,3,2,1,1,4
2693,c5a7aaf5212a42b5adea21d200c6f086,2017-01-26 05:49:14 UTC+0000,8d47f932b046437ba0c8da03347cc9c2,665a4dc589d94329b7a752ad551830ba,1,4,1,1,6
5926,c5aefa0ad0af496d99b22b4784d38a78,2016-05-03 15:25:39 UTC+0000,aa526078c9f940ba93d6524b43a2941d,52a3c36946ef43c3bdf0b128c0533234,1,1,1,1,3
7831,c5afb54ff64a48b1a494101835e6f1e9,2015-12-15 23:10:14 UTC+0000,1c72685d77154c0bb0f28dacee0c5adf,52bef8bad59d4aeda57b312edb6c23b4,0,1,1,0,2
5543,c5b3c84889ec4161b271c90e4ed3f4c9,2015-11-09 21:16:00 UTC+0000,466a2a32a0154de4805053805bf4c135,c0f7489f842f4ebfa548af41402d9571,0,1,1,0,2
6524,c5bf324b69bc46edbc04bc61873f4132,2015-03-24 19:26:15 UTC+0000,6e0ec980c43f4688ba3a927ef6d861d6,97f3d6304ba849058b5d3f9053c939a6,0,4,1,0,5
4039,c5c925dfbbbc4de9b85ae7f6be8abc84,2014-04-01 13:45:41 UTC+0000,ad8c13d2ad284466ab2ba178fc341232,0355aaad83704ad98e6d71b79db85849,0,1,1,0,2
7950,c5c9f44013c54b049a5e1b213552075a,2018-03-01 22:17:40 UTC+0000,1e2df0e063c44724a24d160a6c9ce9cb,8e198b70fa7c4eb6b3cc9d247beabda1,1,1,1,1,3
6210,c5d03acabe974ad6b306f42529c62fc1,2016-10-31 16:15:45 UTC+0000,3424dbabd83b449e947c76e28b2a7f66,29b3359530e448c9a5d229ddc4aa2b4e,2,1,1,1,3
2164,c5e8f5367747463fb8a15d7da82b55af,2017-12-20 17:31:07 UTC+0000,0b603ef37a0f4624b2351699d4bda059,d76a64e53aa242bea01e3c51310745d4,1,1,1,1,3
4779,c5f3b7f019eb424a809e9c5e6e076074,2014-09-30 14:59:21 UTC+0000,3b1fc9ccd2df41ff93b91bfa0d0650f5,8161b71032f34a6c86e13b5c67d81c8d,0,2,1,0,3
4521,c603c77f9ad247db86e9870f61200443,2014-03-26 21:32:22 UTC+0000,448da2ce5aa243ba96fafd256d9edcfe,3d8847ddc8d04185976a9e78b190ebdb,1,1,1,1,3
4735,c60901f6cdc74adaa56b036ef01210df,2018-05-17 19:37:29 UTC+0000,f4e9d3d8022c490683bcf5e0d5e173c1,511b829793e848c4b39b0b5e0b75c4d0,1,2,1,1,4
4807,c61f848b80de4bd4a16dcda2370285b7,2014-03-05 22:58:37 UTC+0000,121df73b957c4352879102d6be6e9169,fd17b2c99949412999f878ca3e777c98,1,5,1,1,7
5430,c6319b893390467d86c0477382f138c3,2015-05-22 15:46:45 UTC+0000,4a06e4171c4b4d6c9b497f3d9e219c34,e3529e64e70643b6889353db79eeea3e,1,1,1,1,3
6326,c631ee93f9f844ac8162e115834cb24f,2014-10-10 17:33:17 UTC+0000,77d90dac51f949388498137f1d6fb782,74a0de42f3ea44b8b21db0bd1f09d7ac,2,4,1,1,6
2966,c637162ca8f948e28555175783a837cf,2014-04-09 04:50:51 UTC+0000,b9aa153e464945dabd7af08f104e1792,6774ee9e8f9247728dbbe896726e911a,0,1,1,0,2
2146,c63e551daf78473e813b8518a95a8846,2017-09-01 01:27:27 UTC+0000,800f2ffce824425a935a84b03fbe1ae9,78b5f45dc5104ac6be1862e9ff8b5b1d,0,1,1,0,2
2176,c64da61b068e4a339abee79445c74711,2015-04-26 22:13:17 UTC+0000,03209d67d01945e0a05a6a6f8e2d41dc,7aab6fb9a4ae4d0197fd2bc05960ba56,1,1,1,1,3
3380,c654d806479247bcb67e9f2becf65889,2014-03-22 10:32:46 UTC+0000,d537f210882b40f988814dc4f421f8f9,f33a960155944fb781de493e371ae46f,0,1,1,0,2
3224,c656fe81a84f4c49ae3ce0c5ea3f8a68,2018-02-12 06:38:34 UTC+0000,4d42c8f7665b4ff389ee5a1be56bb5a5,3ab86281ac254f53b12fbe039856c5dd,0,1,1,0,2
2813,c6609425cac64edf8bf86d9d10a45a8e,2018-04-24 01:34:56 UTC+0000,7d6abae4955840c88887f5061a4368aa,e44c2855fd6649ae869fe145d167cbe4,0,1,1,0,2
6549,c6621d0cef1f4a1f9ff533ba8c5fa676,2015-06-09 14:57:00 UTC+0000,7faa36ccc66d4c4a918092b11b850881,f7aa93b664b547f68bd8a375175410ca,2,1,1,1,3
6957,c6654e5b70db4f1d98d0b350a38a1483,2018-02-16 18:29:44 UTC+0000,b479696bc6b54355837bdb148ab6cdf2,62d2f8f17b09408c8d3a034fdf1d03f8,1,1,1,1,3
686,c66cc064516e4a7b8286118746bb0e59,2016-06-26 13:15:32 UTC+0000,c6a5029047bc47f59be67e7b2fb3ab0b,7bffa1792d474359b922e5de700d7a82,0,2,1,0,3
2933,c66dcd237f01444385ac0aac8782df8f,2016-04-13 14:39:41 UTC+0000,b17da161bdfa46979a508f6b9389dc8a,4bf1020c28714181b8d47bdf4246f134,0,3,1,0,4
602,c675179c9bbf423cae1d0836f586193c,2018-02-19 14:49:17 UTC+0000,720b9f7eb89e45359e23459c79a528c8,be5d23056fcb4f1287c823beec5291e1,1,1,1,1,3
3100,c67e382874454ff5b11125e2bb9135f9,2017-01-30 19:58:43 UTC+0000,b68d0c91ed434212b2a7134c3d478139,2d7ae1af0e3c408d85789cac65998bd4,1,1,1,1,3
3081,c683f01b184645fc8d7a48fc5a3e5c74,2017-12-13 15:01:21 UTC+0000,40306ac75ea8451d8fa6ac1257b00051,887c5a142b42466fb74740d72989fc74,2,1,1,1,3
5731,c68d49565fec42c38b18ad0264f95bb3,2017-02-13 12:40:17 UTC+0000,9be57a87c5104b689cabe1a4fb9a8689,be5d23056fcb4f1287c823beec5291e1,1,1,1,1,3
588,c6926a34c1d548929cb36c7788a078e1,2017-04-26 19:15:16 UTC+0000,a2e5c465492d406ab29edef9b6affbff,36ff3b3666df400f956f8335cf53e09e,0,1,1,0,2
7890,c69585e298ae4ad09a38715ac6de2520,2016-05-02 23:11:16 UTC+0000,0319979bc91b45879342ea080b3d2cca,59ac2a7d9ced4de3998eeebbbe412707,1,1,1,1,3
2802,c6ac57861924408aa81327344b9f6ffe,2016-04-28 17:15:53 UTC+0000,dc732021e58b47e8b657936eef2bb6eb,677f47d4daf5467f9ce9b5a0611d3ffc,1,1,1,1,3
1929,c6ad635df58e446e9dd2ec143ddfdb17,2018-03-21 18:23:52 UTC+0000,aad5464c18d5462e852a9372ae31660b,fafeba89ca764bd891862fb8440a2962,1,1,1,1,3
471,c6c2df27d9e34026ab671c1e8b11e5db,2016-05-02 13:08:53 UTC+0000,c67e6bcf68654960ad8f37e71961edc3,0a429e7732d64e68aab95e7a4ff6e8d4,0,2,1,0,3
2826,c6c40aaded5a44769145db5ca9d20ad2,2017-03-19 20:35:13 UTC+0000,de98709af0b8420a84cdf1caac72847e,7068c172e93d46aea3eb38810394c295,1,1,1,1,3
4572,c6d4680067ef4de5ae68c4464c3908d6,2017-03-16 23:51:13 UTC+0000,eb06bc2c1055424a9f3d0661c0dc0faf,4510051bb5c243dba36c381313398e3c,1,1,1,1,3
3026,c6ea95442e9d41ca8b8db9ad55a343db,2017-12-14 07:21:50 UTC+0000,4b4248c325b84034a83f87515bac3dda,33ddd48bfdf34a6786eb50f236c96fcd,2,1,1,1,3
7862,c6ec742190e5439083882aa07d857986,2016-06-20 20:24:08 UTC+0000,3ce9f698b3e5481b88ab6fedb4d5e9a7,ff506465780c44b8a1a662517ca7b04f,0,2,1,0,3
373,c6f14f2053264d888027b47172f3d319,2017-02-02 00:25:26 UTC+0000,adcc4be2f3c541038b1a2d76eef933d0,a72bde6ac9e349d195a6d356444c9578,1,1,1,1,3
6948,c713a08ee6214a9d9d6ef3dfeeda62d3,2017-12-13 23:33:12 UTC+0000,a6448cf8a37c4d13abd724be79958b60,92f97ef5c47b4362852a654ddfc4676b,1,1,1,1,3
5102,c72978ebd5ba433dab1248c7ff9988e0,2016-07-20 00:30:28 UTC+0000,e8a9deb0c7f346cab428f9fe5daa1202,436070799f1e4bafb97a3b5c29deefe6,1,1,1,1,3
830,c7338c5db6734cf5a3dcf43d5799a39b,2017-02-13 00:44:59 UTC+0000,beff5c9d584649b78149f8e30c199ef1,1806af6b93c74d159c7aad68c6e7a35e,0,1,1,0,2
4248,c733a80a97c841818e7d3dfa898a241d,2018-03-15 16:05:27 UTC+0000,4cf98e9e361743a994b977c21108cbc7,0ec7bfd68e2540c5a17e1b506a502bf6,0,1,1,0,2
6740,c73a124c05b14e01aa9001fa519d936f,2015-05-24 06:13:53 UTC+0000,3233bb0531a04cfc888b029202fd820d,9a0f09620c6640718c1792a74f3b8438,0,1,1,0,2
7682,c747618c21f0405daf5b94e7b1dacb20,2014-03-05 17:43:49 UTC+0000,f3f0425fdbbe4fb58e4b400ad93b480f,0bb524b973644409bd8e3c8ccfe4307d,0,1,1,0,2
7058,c75897c39103472f851424a94bb3aa3f,2018-02-20 21:42:52 UTC+0000,6b458e80de9645678585b9ed03819a88,fd03a32d6ca54a018b9c602b9ed1aea2,0,1,1,0,2
1664,c75c6476d3984d869b8174ace2636891,2016-05-13 00:45:28 UTC+0000,681c4d98f7e6485e9cc60273522f9015,08f4c4808d8e4eb1b9b287cda01beecc,2,2,1,1,4
6832,c773cfb43153467095de1e42007647ad,2016-06-24 16:11:41 UTC+0000,da3bc0fe1133449880053b2d44828bde,f4759af9b17f44c9865b041a0469dc45,1,2,1,1,4
934,c7750b87935a4e9787bef1632f02f216,2016-07-25 10:56:47 UTC+0000,1e0d5e35e0c945c1a240660340d44a0f,36ff3b3666df400f956f8335cf53e09e,1,2,1,1,4
4356,c78c951fc71d4675aeaaa22e55590281,2016-05-04 21:19:02 UTC+0000,e687f402fc0d4dd99375035c254b77b7,5b5c939dbeea4bcd9b3b761add21d247,1,4,0,1,5
5210,c792c211f563400388b54c352d7c313e,2016-04-14 14:06:02 UTC+0000,633604b01cf74290bb3515ecb236116e,4bf1020c28714181b8d47bdf4246f134,0,2,1,0,3
3646,c7a00df673b94c9badbe3c4df1870a19,2016-07-12 16:37:31 UTC+0000,b452665010b24e14bfe803034c56ecf2,12e8dea2f3534f6dbc31701cf64f9a4f,1,1,1,1,3
7270,c7ba10e4d4094709affb5eecfc228d8b,2017-02-02 14:21:04 UTC+0000,c21d80f7ffe54414b2723deba150ea47,36ff3b3666df400f956f8335cf53e09e,0,2,1,0,3
4830,c7bbdb64e9544478bd8741db59fd72c0,2017-01-12 22:38:05 UTC+0000,d0862ca2893d41708ec52180eb244722,9496418c2b6a4c059442c81cd73d55e1,1,2,1,1,4
653,c7c33684a6ed456b9027ca6555171917,2015-11-02 19:00:07 UTC+0000,5fc20d4564a043e4a26381c628883b9b,c1a24b8f746b47488da02a0e5044a7a9,0,1,1,0,2
5790,c7ec22a2c6e34296b003853ad56ce6a9,2017-04-26 06:42:39 UTC+0000,944ed72112c64b8795a233287ee52590,be8b5083af6b47fa8a9705e8f127ef5e,1,1,1,1,3
1187,c7f23cf4fe564484af11cd28fd709bcb,2015-06-21 19:18:02 UTC+0000,bdf39fdea0e3485e914b5909204371a0,bc46e3699d92477ba8c7aa723e54a151,1,1,1,1,3
6053,c7f745c16b04432081437a8f6f7edea2,2016-03-31 14:25:32 UTC+0000,8f4eb46a247445dc96a8e0d0adc7a67b,b2a56907564346cc81ab17c689c5adbe,7,4,1,1,6
2273,c8078c82e54147a4bcf6ff2ca3dfa001,2014-04-08 19:23:25 UTC+0000,7c323b52308147df8c256eff172c02f3,3409d2ee250545558ea03bfdfd8da22e,2,1,1,1,3
5599,c8158137fdd54973aed441a4b0b2e655,2016-10-24 14:46:30 UTC+0000,57a95809ec7c4a438b34cd356e1e26de,9a1d143c7f604d04bafb35117a4d3c84,1,1,1,1,3
3587,c818b638552f4dd588336764a2d48d8e,2018-05-14 12:34:43 UTC+0000,5fc4d73f6d474b54ba229819f2c42d1a,5ec9d442785a423ab4c0bf1dd110071b,0,3,1,0,4
3254,c82b7a1396644f3398c1ef70d06aea85,2018-02-28 02:42:41 UTC+0000,0fa486353ac14c96be2c5fba3c05a06a,87a657338ecd4e2c96d8ebec233c44f7,1,1,1,1,3
6101,c831becfcb2b43238ea940c685e4fea3,2012-02-03 15:02:37 UTC+0000,aaf3ad4278f44929a10b00e4863538b8,4dbdd4b99f80446798b3ab477f049285,11,4,1,1,6
6674,c842280421b54dfabbacf2b3bbfc62e5,2016-09-18 14:16:54 UTC+0000,7e8c49c525d740a993e837f79a662195,58fa5e95fe9e480a9349bbb1d7faaddb,0,1,1,0,2
4634,c84a508a1d4346d0a809cd60f3b7dfa3,2015-03-04 09:26:28 UTC+0000,f50dcdd996d14baf9c8145af1fdc7057,9a0f09620c6640718c1792a74f3b8438,0,1,1,0,2
5278,c84f649b125b4da39e094f500e6d94f4,2016-05-27 10:44:32 UTC+0000,df5fa66b7935493fbe7fdee06fe1029d,8f12ab673d6e452d99acfbe14dd3ba68,1,1,1,1,3
1583,c85e86f6f4894e2eaf22fbffd1c20818,2014-03-06 16:01:34 UTC+0000,6eddf83970e746149aa7116d571b3cbe,2a8328f6ceb548699a64293f986f3d19,1,4,1,1,6
7596,c863857c3d8343ee9934137f66871718,2016-05-15 22:07:13 UTC+0000,66ca9568d27048a4bad470170305733d,21a570faf4cd4ccc80c0cfb8f1ddcc94,0,1,1,0,2
1421,c86d7941909c4b58a362bda56aed96ef,2016-03-11 21:46:17 UTC+0000,d8d73cdac66e4c6abf166486f512717f,36ff3b3666df400f956f8335cf53e09e,0,1,1,0,2
961,c872dfc5a4af48b59ae9be330e5ec03b,2014-04-23 13:31:37 UTC+0000,e0775e3c2ff24a54872b692bea2a8a54,b688e766eed04a37b7abc9218aca1ce4,0,1,1,0,2
5728,c87948c84b6c4d71a2e59ce0f5df486a,2015-03-24 14:48:52 UTC+0000,1a90427eaeda4a888f514229781af410,c1341204dce1463dad3964c3f3f462c3,1,1,1,1,3
6583,c8a1b4ead01a4aafbb865ce05fd7cfa3,2016-05-24 00:08:56 UTC+0000,5615597dcc1b43aaa5e19ba5eeb10d87,4e0f0fffe8c941ee844e650082267fb9,1,1,1,1,3
4049,c8a5cc870c794092a9457e6b4874a004,2018-08-14 00:52:17 UTC+0000,d3ee5ac64be44e6da3543c7afae2ae98,cff9a9679be1434f93afd0caadea94bd,1,2,1,1,4
2124,c8c6b4f21a494fe48a64f59dde222dcd,2016-05-02 21:57:12 UTC+0000,280a21ccebfd4139a07fddb8d37a3826,fe95342734e04864a7923f6da4351ac8,1,2,1,1,4
5762,c8ce4a9d11414a8792faf425e8ca358e,2016-09-16 20:41:04 UTC+0000,0520448fea6d498da83ec7587d117a40,bb4fe08bb5424f08972927d90bad9642,0,1,1,0,2
176,c8e4178889384616b66ba95072367c22,2012-09-07 19:37:42 UTC+0000,a071915a90ff42f7a06cd861a4ac81be,7d425e8d7cfb4fe7b0702fff4d6d84e7,3,1,1,1,3
5935,c8ea3b27318f4dd3896e5919632af482,2016-12-19 01:16:26 UTC+0000,41762767370345bea0243582b63eaa44,a1006e6a58a0447592e2435caa230f78,0,1,1,0,2
5689,c8ffffae80004540bc2bc58beb2f4cf8,2015-04-08 20:07:25 UTC+0000,2c2e1a87c18e404f9b1c1824c45664c1,42deada7c50c4859a34615d70193317e,1,1,1,1,3
6243,c921221a5ef44cd39e975b0508864d8a,2017-01-13 20:59:12 UTC+0000,5900486369bd497788381aff34579e19,9496418c2b6a4c059442c81cd73d55e1,0,1,1,0,2
2484,c9270f3045c34590ae4ef504c80151c5,2016-03-01 21:48:29 UTC+0000,d9e1466f17d34f0499b96552565cad8c,96bbbdd06a334805a0501034d9df1aa4,3,2,1,1,4
2379,c92901d3177543269aea5e7330040ef0,2016-06-26 01:40:51 UTC+0000,493002184b8e4adeb038152b8d64fb51,8aa7ba4c38aa4a2e88872c1fdad7d068,2,2,1,1,4
1630,c92e347b6fc24d5b8cc5f2fceddbe007,2018-04-04 00:31:40 UTC+0000,97cb2b65430d4f96a37f62c58af97ec3,b1488415466948b5bee3896efbc31fdd,2,2,1,1,4
644,c93868ba332a4a85824ddb29febfe8e8,2017-01-24 16:06:00 UTC+0000,663a38b0bae54b0a9c916d7ccb0f0e8b,84e08b7c127e4e309a0f9853f5e0ea1f,0,1,1,0,2
575,c939faa4d3df41c8bb12e1bcd4181765,2016-05-29 21:36:03 UTC+0000,6316a7f581b2452dbb890d8ff30356b5,58fa5e95fe9e480a9349bbb1d7faaddb,0,1,1,0,2
1494,c946278c51e14152b45a4807ea1a86b2,2018-01-18 04:26:47 UTC+0000,af6094a4a6a44cba882c876091c007fb,cf4d747b013247c08775128477da5502,1,1,1,1,3
2141,c94d4ce4dd9c492eb15502afdb019a66,2016-05-10 02:39:21 UTC+0000,02d415e577f248c7921433e967339e9e,e6ae38ca62d5423daa34d7088f4295e4,3,1,1,1,3
6381,c94fe8612af249098132f2ac70c50d51,2015-06-08 12:34:19 UTC+0000,f9f25892e80748768a317d8f1f1b7bb3,a718cbdccb2a42a58ccc0e2c0b449ed5,0,1,1,0,2
7257,c950a7d1efd045838b06095c1f3989b3,2016-05-17 23:49:12 UTC+0000,22c69f7a2fc64f8faa4f522c1cec0245,4dba67cd990a4b5a9336d0eba88babdc,1,1,1,1,3
1133,c9799fe132194231b0090df5bff932a6,2018-08-11 03:54:22 UTC+0000,4db69a0b44d9496abdaa189b95d1b07e,be5d23056fcb4f1287c823beec5291e1,1,2,1,1,4
7148,c97ce79b68364bdb9c06864846ca9060,2016-05-17 23:45:30 UTC+0000,0a7c3601708440c0a45a8097d513a237,4dba67cd990a4b5a9336d0eba88babdc,1,2,1,1,4
4632,c981c63e2c714890a786600cb6d0b23c,2016-10-31 17:21:43 UTC+0000,e95416a431514abbbbeabf6fac324c8b,a1006e6a58a0447592e2435caa230f78,1,1,1,1,3
4351,c9948e1b3d704d3b89307a4d55067512,2015-04-10 05:06:37 UTC+0000,a6579e4159f44656b2a52b5cb6cabba6,6c45a5332ff44c09b6c3dfdf53d2bc56,1,2,1,1,4
3129,c9961baf75b0400ca2d1d75cb40bce85,2018-02-13 13:41:56 UTC+0000,61aaf7c586694776a1cb59cbdff815dd,3a4320efb9244ad086043cf82ae2b96a,0,1,1,0,2
2553,c9ada9c7d0d4411eb40a950b3d62af9d,2017-02-04 20:28:43 UTC+0000,2e8a6888692948258b3c8ab763e945a3,75aa2ed8a80443968b6b7b41d6026026,0,1,1,0,2
1398,c9b67c5d13154559aa8d887e804a3202,2014-04-07 18:24:12 UTC+0000,0c4a4fae88b241588828ea6cc5e4469d,4c12084bb3d7494e9ca78f55b1432db3,0,1,1,0,2
6455,c9c471bd6a5d498485cad8fb45cbeb23,2017-11-25 17:21:45 UTC+0000,8eac14b94b0e44d3a28d161671775b11,a1006e6a58a0447592e2435caa230f78,1,1,1,1,3
6058,c9c779c2061248398799761617f25c17,2013-10-22 20:51:55 UTC+0000,df0eeac6921f423cbc5b2f6e52f43f23,a5806385db1845cc996f66a99cc19dab,3,1,1,1,3
1098,c9cb8efbe9ed47f1af7a22fcbf4313c0,2018-03-31 20:56:09 UTC+0000,1c6119348fa94ff494ed00f98e6a6094,36ff3b3666df400f956f8335cf53e09e,0,2,1,0,3
6598,c9e3de6275934e9b9f038938be2dbeb3,2016-05-12 13:26:14 UTC+0000,7de01ddb9efd4ae6a8b235d916642f60,a620860fe2e044a2bad3ed0b3ef8637e,3,1,1,1,3
424,c9eb6e3b80e049f39eb4828cddc23920,2014-02-11 21:57:06 UTC+0000,5043b78a14a24b8d9100acceb461d7dc,77200939a3364defa9d96fe838f7b71f,1,2,1,1,4
6062,c9f96dae11934d67b66447104221dabb,2018-01-24 21:21:12 UTC+0000,3a1c2a83c11041a5811383b500b1998c,369f1c8646b649f6997eae7809696bd5,1,2,1,1,4
6342,ca0ce01d9e6b4282a60058b553007c35,2016-12-15 18:47:05 UTC+0000,2b279185705b428b947cd1e009129dd7,369f1c8646b649f6997eae7809696bd5,1,1,1,1,3
286,ca1aa87edb39433f81e145b0a31848b8,2012-01-26 05:37:48 UTC+0000,f4b052b884df4e058abf457ceb885755,0c9a2748560541be9fe2df0d7be88282,1,1,1,1,3
6600,ca47a41f52c4486ca6b218393c19b284,2017-06-19 19:16:38 UTC+0000,dbfa0c3cd3bc4a6f9f0b17a8c0e3bbe4,416321b48a634ac8a53602625f0a5d40,0,2,1,0,3
6685,ca4be79bf63a4a6a87549d0c347d3820,2016-05-09 14:23:36 UTC+0000,55c018195c1f48e4bb39ab3496d192b9,16b3e5364ceb4e3faa6bed5e51a2ccba,0,1,1,0,2
2698,ca7c85d66742467ca9214b9f9df942ca,2018-04-20 13:51:04 UTC+0000,c56cb5a8101047bbb1ce6e69078901a2,e9c78f9fab1140e3bef378d1c79efbf7,0,1,1,0,2
4699,ca932055ee2446aa91efbc419ef9696e,2015-04-01 15:42:31 UTC+0000,475795249d55485cb42ed35b8add0c27,369f1c8646b649f6997eae7809696bd5,1,1,1,1,3
2896,ca97d3a2ae6d49f8945ba65fc696e355,2016-05-10 02:57:48 UTC+0000,0a50693ff8504c1a8a50c8d900b4619c,93ed4657cad64344b6740f2ee4e42a0e,1,1,1,1,3
7405,ca9c56f9c07c4970b4f72b4258e394a2,2016-07-23 14:52:57 UTC+0000,8c05c225511f4690aa850f0b0d4f4fbf,b31cc952965442f7a593662c0b5bda8a,1,1,1,1,3
4476,ca9cb988f6c64cc399d71c188514292f,2016-05-16 16:38:21 UTC+0000,8bf219ec41444b86a81dec4165935b3b,a14d2d2cc61d4275a722eeb7204cda90,2,1,1,1,3
7730,caa451ead26a4d6aa27164ddf16b1451,2015-10-22 18:22:00 UTC+0000,ab75fccef5184c5b9ed693221c1aa4f3,bc46e3699d92477ba8c7aa723e54a151,0,3,1,0,4
2149,cab74539220e4bf99e85924f67c255dc,2016-08-21 22:32:38 UTC+0000,50c0ac416a2e427ba0110605228f7c4c,58fa5e95fe9e480a9349bbb1d7faaddb,1,2,1,1,4
6961,cabcb6ea845f4cf0ae9d4c79b6927b6a,2014-10-09 22:25:54 UTC+0000,ca6755b21d07473f8b94339157ce1b6d,2796213fb0324530bb206915156dd136,1,1,1,1,3
118,cac2ed3dc07a46fda031d4cda344e85f,2016-05-10 14:44:06 UTC+0000,12a7444551494a6c941821b742855e53,9637a0f19f8f4d8e900443f4ca040ca4,0,1,1,0,2
802,cac3e25c757e405cb7f3ac1eca0beee8,2016-04-26 02:13:41 UTC+0000,bce0d4efbe4f42d7b9c67d227419ed12,58fa5e95fe9e480a9349bbb1d7faaddb,2,1,1,1,3
5920,caca9ab7e13d4297a82b9abe8f11f0b8,2014-04-09 13:20:59 UTC+0000,aee9f9b8428b4ed8aaf2bb61a3ba2f65,0355aaad83704ad98e6d71b79db85849,1,1,1,1,3
2690,cace3492736641c793978a21301ba346,2016-05-05 14:44:16 UTC+0000,ff889e90b0384066bf3a63bf4d099892,8f44237ddad84f2184cfe4182fbf1105,1,1,1,1,3
1914,cad20e9ee2fd41d8b91682f75d7a8062,2017-05-18 13:13:28 UTC+0000,a977e194fc4849e18fd2a77a00c75522,d15c75fff5e04aab8b69e864f9cc5125,0,1,1,0,2
1898,cad47ccd43304a30bfcd4ff29a755c56,2016-10-30 01:42:00 UTC+0000,9c67e47dbf8d481b89c82fc13326c3db,36ff3b3666df400f956f8335cf53e09e,1,2,1,1,4
3874,cada53a4cc9d4b7a97de4b0c61f36735,2016-05-14 21:12:00 UTC+0000,6e10059d70814a108f2f2e797c01be66,58fa5e95fe9e480a9349bbb1d7faaddb,1,1,1,1,3
6713,caef65320d2746b980606b9c508a60ae,2016-12-28 15:00:41 UTC+0000,fade3de8fd854561a3edf9721031ffb6,98f1818a32c947a6a8abbf8c112b4d33,0,1,1,0,2
5388,caf7221eed7c4f948804692f0aef75ee,2015-06-03 16:24:19 UTC+0000,78b24429801f4a929c6f50aa1f8b6fe3,04b72521eb474b8bb79f7bd95e8b637a,1,1,1,1,3
3605,cb0104ea63d8429c8ae7f288e0fd092c,2016-05-29 18:30:34 UTC+0000,d858c348678a4465920c951adfe696df,58fa5e95fe9e480a9349bbb1d7faaddb,1,2,1,1,4
5309,cb078130eaa4402d92bd262ea026e62f,2016-06-24 06:45:02 UTC+0000,ef0099eb6fcc4d65957b01062bd3292a,614ba4c0aa534b759b73e8473fd5ec88,1,1,1,1,3
6846,cb0a06ce2afa42e1b7ea58ddc7624d90,2014-07-16 17:27:28 UTC+0000,427884c4120e4cc9b0d941f16185549d,b45e7851aded479a92282ea3c66300ab,2,1,1,1,3
1402,cb17b7ffa5d445e3af2b29b41111f6dc,2016-05-11 00:15:55 UTC+0000,29e229bc07dd43ed988681464cc7a60f,de51e745b6354185a0ca5d02dc628416,0,2,1,0,3
7072,cb1b1b5cea8f462fbd464661f5273e98,2018-02-16 13:44:29 UTC+0000,a183c0095f8c4f15b0e040ad8c11aefe,0f0d050807914b11b16ba75743543025,1,2,1,1,4
3316,cb1faf3e0697456b9009bf782a6af73b,2012-10-01 04:24:08 UTC+0000,93cd781b567b4bf79407fee147a72cb9,f05b33a454c048f3bbc73f5f3f7f5127,1,1,1,1,3
5144,cb21931c2fbe471aabcdc2cbb98ff24b,2018-02-05 14:44:55 UTC+0000,60e51acbdcc44b929bd04e00526b7c04,be5d23056fcb4f1287c823beec5291e1,0,2,1,0,3
7938,cb21a793b4854088b2af7f584afff7be,2014-10-31 20:36:31 UTC+0000,d854dfda064f4f7bb2d006d75bc2a7e7,77e2af08888a4965aad9689d9b9b34a1,4,4,1,1,6
7735,cb2e569d7ff9474ebc598107e7bd363f,2018-03-29 21:45:38 UTC+0000,c5b878c04a7f4a5c8d1309200f990a11,691cb918820d49f28902155b8a24633a,0,1,1,0,2
1934,cb43ebee01364c68ac61d347a393ae39,2017-01-30 17:53:44 UTC+0000,74db711d53d54844a90287273e210109,ce39261edec04e28ab87463fe827d659,0,1,1,0,2
5325,cb443a0cb9364c02bf56cd6290cdcb9e,2011-12-30 03:45:47 UTC+0000,387c8b77a2cb4c13b79296d201a6dacc,8e75aca48b434c79b8b4729ef871cb50,4,1,1,1,3
7724,cb77402ea78f43239add0eacc2806ddf,2016-06-24 17:43:04 UTC+0000,f1d8073312c947a6b6ee8ffb007570ab,58fa5e95fe9e480a9349bbb1d7faaddb,0,1,1,0,2
3410,cb7a9be170d04666b4b909cf9f16c4ed,2016-08-09 14:24:24 UTC+0000,95727d7abb334481a66b8d5aa1815c49,9bdbaf3ee9a94722aadde5363b007f39,1,1,1,1,3
7198,cb7d6e9748794768823bafcf58caa025,2012-02-09 00:51:39 UTC+0000,cec793502ef04f1e91f7080477756eec,4a71c85e58dc4c1a8546574188582a92,2,1,1,1,3
4468,cb8f4828a34b4addb8ee8676e71c703d,2014-12-03 18:20:55 UTC+0000,4ea2582dc2364d4583b7b62d05e8584c,d2d9a74a3a0c49b4afadbb332251dc6c,1,1,1,1,3
3220,cba1e4d0090d43999349e57e7dc48bdb,2017-05-10 19:57:29 UTC+0000,dbb38b8a046d489bbbde32bfb2c69ec8,b583de3ec79b4bcd992b09a087df1f36,1,2,0,1,3
1938,cbbbc984c7374deb8c92e0a61516a860,2014-02-21 21:31:32 UTC+0000,f271a1cdf1cb49cf91445e32c2aa8acc,1a6b0dabecda4cbab3cc70a9ad8f9947,2,1,1,1,3
3090,cbbeb2633d3c4b60a30cc2c8347baa40,2017-06-06 00:45:21 UTC+0000,306701e8ee3a420995bb94c144eee89a,11fd0a6612864f0eb53ca467d2e002e1,1,3,1,1,5
5793,cbf1ad2f77134387bc4e413145d7d381,2018-02-22 04:13:52 UTC+0000,dc9c85acf74f4b0186aea70acc9f2d26,ff2723d4ec9c4a96b4a2df2bbca3db98,1,1,1,1,3
7355,cbf834e5a2bb46e7a5e655db8481100c,2015-10-23 17:30:40 UTC+0000,de1bb47d9e1541d9bc9cd188e51c0939,f319c1c9280847f48f6d703aff76b4f6,0,1,1,0,2
7302,cc00b0a7f9074cb1a762dccedf6c639d,2017-09-02 11:34:34 UTC+0000,caf22475646a4447b8b279d996489e84,e1d39b665987455fbcfbec3fc6df6056,0,2,1,0,3
606,cc2159967ee84d449732c8d23c02be7c,2018-11-07 00:21:02 UTC+0000,f47d5d09b5c64eefbf163f6380075220,242543c453024d65bb8e9e8c7108a46d,0,1,1,0,2
5861,cc274b5a92d240c9937d4baf4c6c11e9,2016-10-11 19:58:17 UTC+0000,1c6e6b63be374dc9beb3de6e135b4d2c,1fa1dd90262b4db1bb9ef9d59d43565e,2,1,1,1,3
6906,cc32d5aefcf445869f91908c26a48351,2016-08-19 13:33:21 UTC+0000,2e0a605b6b234af891b9f53894c30b11,130251de55ca45da80ed121e76a74fa0,0,1,1,0,2
2020,cc32e5d31b3d44b18b6d84f6d4089457,2017-09-30 18:03:30 UTC+0000,92693b1c2b634caeaae8b8f94dc2cc58,dba349aa27914b1daf8f0d85b34a6334,1,1,1,1,3
5990,cc42dcf03ad348fe8ac0bc4124f1d2db,2015-09-03 19:37:14 UTC+0000,13da9b89c3444abca55c3cbe3e64b04e,f1ca9370286248aba5aae737f92a07dd,1,1,1,1,3
4132,cc44c6efbf094f47a65cff3613576864,2016-10-27 09:28:58 UTC+0000,40f5520fb4a241ec942c777c92ab0b6a,2954640149c44018a7b203aac25aa2d5,2,1,1,1,3
5965,cc57d7d1010149f788608f759ff59afa,2015-04-28 17:38:42 UTC+0000,eb6b0c74414842478250ffb62e2ce145,369f1c8646b649f6997eae7809696bd5,2,1,1,1,3
5168,cc6dff434db44f9fabc4fedea1669fc4,2015-04-06 01:09:01 UTC+0000,c3f5fb2e670544f19809ce67748f1847,198ab88e6873420cb781f1c7f041c1cd,0,1,1,0,2
1194,cc779a9660ad4880b68040b93fdaaaed,2016-10-21 14:03:47 UTC+0000,b2c6f8b25d4e405d8d1a9529297ac24a,d1dc7e671e05451bb4b4c19db0e9d48e,1,1,1,1,3
7169,cc77b7e81c2f4d05bebfcbcf8dd22370,2014-05-02 19:43:55 UTC+0000,9297b3bafc334fc2b59c2a1992613882,e4e7cc05a0b64cd6b02168d404a45d4f,2,3,1,1,5
5715,cc7f010547324c1ca6eef076a223296b,2018-03-01 23:30:20 UTC+0000,2868775e638a44d489745a17a4bd7d7e,13b55ed4834e4814bb33a4c87001063d,1,1,1,1,3
3466,cc80368f622a4e48a508213469aa945c,2017-01-04 17:47:40 UTC+0000,a3d8bec8de9941c183a83ab694e01a5c,bb4fe08bb5424f08972927d90bad9642,0,1,1,0,2
3713,cc83f19c73694fc6ac90e07261a8af6f,2018-02-13 22:51:20 UTC+0000,95f71ec11d8444ac83607889504244ae,a6d33c38902546849c36ea7e9e9f0870,2,3,1,1,5
153,cc8b86696e8641d986ab14a0d357a4e6,2016-05-07 03:32:39 UTC+0000,61ec7ca88e334f799f1a306371b3cf75,4d127d077c1b48a7a9571457a67ccec8,2,1,1,1,3
6030,cc905fb0a6a7489097b4529af4ec327d,2014-12-03 18:40:14 UTC+0000,f9bfb6eac00847e0a47e90b8b7494260,d73a8432a2934ed8907cdc79e4c62ec8,1,1,1,1,3
1912,cca75ca47da34294b4467170c312e656,2016-05-18 19:41:26 UTC+0000,853c656aa05240a49a801ad211964a19,7667c23d26ab409ca3e49758f5367925,1,1,1,1,3
1885,ccab956beef84170a5fd1d4f72eb6433,2014-04-04 21:07:05 UTC+0000,63508efb50714adaa6dc872259bb58e4,6774ee9e8f9247728dbbe896726e911a,2,1,1,1,3
1282,cccd235f330a4154a844fc417c134871,2016-07-12 00:38:56 UTC+0000,ec18c3d1a96e49a7a98113cf2cacede5,fbfffdeaa5b24cacb0a93a00f93dd54e,2,1,1,1,3
1235,ccec36945ebe4cb182dae828f0fde868,2015-05-15 18:11:26 UTC+0000,93a15442a19b404986f002e440b36d16,8fbf00c7f4f9487da45edfe7eea92591,1,1,1,1,3
3974,ccec448fb01e4cb280e1822c9135022e,2017-08-08 03:12:23 UTC+0000,6ecad53a60214a3bbdc356fb1eaf40fb,0bbc2911f67241378419f63ff59d5b9a,4,3,1,1,5
3986,ccfb748723b14d699acc29fe1e2332c7,2017-02-14 19:11:01 UTC+0000,7d2043c69df0469eb3af75d4a55492d5,49432ef112b540a3b39e95f9e6eee6ad,2,1,1,1,3
3630,cd00964f581140879152736d70426e1d,2016-06-23 17:54:57 UTC+0000,f26d687654304b41bf91f75af1a70fcc,139ba2489ea44eb7af5fdbc63e19dcca,3,2,1,1,4
5625,cd1dd0b7801646b58c7b95f2b9c0d80e,2014-04-09 14:25:14 UTC+0000,1f3d735ad511401dbf51616f2a58a46b,0dc4c381bda94701a967703ccec5c676,2,1,1,1,3
5358,cd34b3632bd34f1db1e6def306ea6c5d,2015-01-02 22:06:25 UTC+0000,dc0ffadf7549492e94f7b30e52c8a40e,b688e766eed04a37b7abc9218aca1ce4,0,1,1,0,2
6472,cd367cd3fce841038af3809845cf4b6b,2014-10-02 14:04:21 UTC+0000,63bcc9d33b6c48dcbc27e6088ba2dcaa,547122349484428c885dd9d18051b71e,2,2,1,1,4
1558,cd3c3cfd732141b3a497404af6194c78,2018-04-06 19:47:06 UTC+0000,ccc0be06e0a947b093b74709721559fe,950898c71c6b4616b00b1d984ee71024,1,1,1,1,3
2370,cd45d5d8055f44ce8e1ffa1abc314760,2017-03-08 19:12:22 UTC+0000,05b49b9569214aefab21805c7e27f027,96bbbdd06a334805a0501034d9df1aa4,0,1,1,0,2
4467,cd56c4b4f85b45ef93533093930488e1,2015-01-30 16:56:54 UTC+0000,07fb549a8d8242128e5d50b1fa5335c0,05444a2f42454327b2ac4b463c0adbe0,2,1,1,1,3
5244,cd64bd9cf40d47349d98aab5cd5e17c9,2016-07-12 16:41:12 UTC+0000,be7332f6ea0448c0a7e513722c765f0a,12e8dea2f3534f6dbc31701cf64f9a4f,1,1,1,1,3
2371,cd6e778eb5d0484c8e0393f5e0f22ff4,2017-02-07 20:20:50 UTC+0000,c80530f226fc47bc866a50d65a576639,7256648966a140d0a89ab476b438b67b,0,1,1,0,2
7035,cd6fd71746684fb5b7f063eb33e92bf2,2016-05-06 04:16:32 UTC+0000,5c8ef52367fe4247a728b46c5baed89a,016a39b2253648af948d915ab30520d2,0,1,1,0,2
6663,cd745ae82c454ce1ac51e8269147088a,2018-01-27 17:08:50 UTC+0000,7c5ec7e25d6b498cb908fe8d87375797,ac83901fad384461ad33630aa2d823d7,0,4,1,0,5
2729,cd9b75b5eede4f79a8e9b6f9de26bd2b,2017-04-05 18:08:09 UTC+0000,a32deace054e4287b308865891444aee,488032a396dd4be89f745cdee0a4cc91,1,1,1,1,3
1479,cd9dca34bea74de89e2466c43a496569,2016-06-04 19:11:24 UTC+0000,907d428ca54744ed9a4a38729ce5b52d,58fa5e95fe9e480a9349bbb1d7faaddb,1,2,1,1,4
4247,cdae2711ab7048218abddba9561c6248,2015-04-25 23:15:13 UTC+0000,0721b0f0f04e495182f86c1f5b8ff00c,7aab6fb9a4ae4d0197fd2bc05960ba56,0,1,1,0,2
1476,cdaf064ef0f84cc9ae51a15b544215c7,2016-05-20 20:42:20 UTC+0000,990ba3125ebb484987f9b1cf36f37f8f,0355aaad83704ad98e6d71b79db85849,0,9,1,0,10
3050,cddc0d4aa26c42b480a3dc60fc0b3e42,2017-08-30 21:17:08 UTC+0000,5acf56e87ff6457b899ec5570ecefacd,c5c2ca95fcd3463a8852b8bc9d636313,1,3,1,1,5
5569,cddddfcb2a544d31a0dfdc90622d333e,2015-10-07 20:30:12 UTC+0000,cd2338b0dd2a4e689729f7b6a387a40a,fa52bb8a7ca24aa896e26887c75e702a,0,1,1,0,2
5216,cdfb864b725b4eab8830399b2e367e02,2016-10-01 13:56:34 UTC+0000,04cd8024b7c64384b229d28661a291af,8cb2172df4944ee3a9ebc09817dfee52,1,2,1,1,4
4410,ce063956708042f3a5f2ca7d1c96a47c,2015-05-07 15:45:46 UTC+0000,5e40a4fadce84a5ca9c77bfb30c544e6,f319c1c9280847f48f6d703aff76b4f6,0,1,1,0,2
2174,ce0b1dbaf1134991adecd87e00ad9f63,2018-03-02 18:00:38 UTC+0000,ea884b13165744088774b2a80c7f3a1a,4dc61581ec7b409bbd037e483f53ba0a,1,1,1,1,3
8038,ce1ff7a035d74721a5b7d21105f9ddb6,2016-04-07 01:38:55 UTC+0000,daf0a78073924205a19eb6bfa1034d99,f1ca9370286248aba5aae737f92a07dd,2,1,1,1,3
3541,ce20647f4071490a8bf36b97476874ef,2016-06-12 22:06:55 UTC+0000,07f5ebafd04e44859faf6a0991db7a69,58fa5e95fe9e480a9349bbb1d7faaddb,1,3,1,1,5
7760,ce2255300d02426cbbbd4d01b633a748,2014-03-26 00:47:27 UTC+0000,3624254c304d4877b3c3731dbdab9f78,6cf6e21fa65948e98ec28bc6c16c1dd6,2,4,1,1,6
6928,ce3497dbc4f848c78f4c0dd13b38115d,2018-03-03 01:22:05 UTC+0000,3fd4ecd9db2648d6be1db20eb540b27c,5f58059585ac45e5833219a8d3a92fe0,1,1,1,1,3
1712,ce39f713de0a47a9930ac211f2c5fc24,2016-05-13 22:03:15 UTC+0000,61c5c4af0610409e9260c8083a514f06,7667c23d26ab409ca3e49758f5367925,2,2,1,1,4
1791,ce4ed4ebe9a44c85b56ac7c32ab81f30,2017-09-04 15:36:40 UTC+0000,52a3fc78347344b28d20028fd1a02615,733003960d17445eb214ff8529b10c48,1,2,1,1,4
3988,ce64e106a3ae4489888d46da9f004151,2016-05-10 19:42:36 UTC+0000,6cb4b23237ce4644b5aad104f1b733a6,69cda8e3737f4520b7662ae09c650747,0,2,1,0,3
6646,ce765b17298e400594780a0630f12602,2015-07-06 18:59:17 UTC+0000,3cb4351bf816401a814e6058f10a27cf,a1006e6a58a0447592e2435caa230f78,0,1,1,0,2
3928,ce78747358544d788ecaddd862e09afc,2018-09-02 03:49:10 UTC+0000,3acb9b9036924d2485fad7e8c0d43e85,e61e9040ccb644a39cdd3133f0729161,1,1,1,1,3
6628,ce7f3394c1fe4385917ec339bf7ff908,2017-02-06 16:14:00 UTC+0000,f8265a7d9a594b41883a7396b9391776,ab0b1c1190a64715b0433885d5c88df1,2,1,1,1,3
820,ce8b41aad44c43d581795a83735f0893,2014-03-17 21:35:52 UTC+0000,96532662d3b84c06bbadc415f513a669,1fbcd8b315de45c29ff87cf912b535fc,0,3,1,0,4
3788,ce8fa2dd90dc4396869f7b559dcfc263,2016-12-09 21:17:28 UTC+0000,3abd41a1ecef4afdbe2e458fce249cdf,36ff3b3666df400f956f8335cf53e09e,1,2,1,1,4
1239,ce99710d0e3e4e54a06bf130a387fcff,2018-06-03 11:18:53 UTC+0000,0f318d5091794516b5924111ac571d41,8d63cf34213f45189a5a8eabd9d71529,0,1,1,0,2
4481,ce99d06fe27d43daafad733eb7e36258,2016-03-02 17:47:14 UTC+0000,88e5c239e0a54589b03f2829b67e64da,989b5cb9d57e435aaeb10cd0b25f3477,3,2,1,1,4
4549,cec0c9bbeb324f919d96bfb4c8566d87,2016-05-19 14:18:47 UTC+0000,f796f308c8c24d87a01777042b53acd7,9b42ab65e8214132809e2863a7bbd054,1,1,1,1,3
7434,ced4f5a9fa21449b93113d6cbf70016e,2016-02-23 05:39:33 UTC+0000,cdef159a297c456d93647b25845cc179,2e77a7e4d0d34385bc175a9efb61408c,6,5,1,1,7
56,ced62980cfb34156af5398eff7baf598,2016-07-19 16:53:26 UTC+0000,9228e75b5e4e4c209071c05a4b2ae1df,b037355697ed40e687368bb233060e50,1,1,1,1,3
4170,cedca326b04c4223bc49e278f3c12693,2018-05-17 19:40:38 UTC+0000,820e0198506f498d870fc871863658ac,745be716f58544c5afd699fc3fc6ec33,0,1,1,0,2
3310,ceed61d5565d41ae8b1352ed7655ef3b,2017-01-26 18:21:28 UTC+0000,3660cbf1fc8d4886b55c28fb22ae0cdb,5688325ccc864f5fb814dbb388f83411,1,1,1,1,3
1484,cef6827f2f14475fac07a082530d6288,2018-02-16 02:37:06 UTC+0000,93dd9e5d0d134ff98330d4e3a5208b0d,cf25cdcc5ddb41909236e56887c9902e,1,1,1,1,3
878,cf0b0ddd0d964a009e7407faae544c38,2017-01-12 22:42:10 UTC+0000,3ec8587ec6af4171b83effc98e6c966e,9496418c2b6a4c059442c81cd73d55e1,1,1,1,1,3
2154,cf0fa55997da4bd4a8fc59da8a30c65c,2016-04-26 02:36:45 UTC+0000,41c1707123064290837cb4a9d54043ef,a203d27f5d054ffd829771ac7a2fe4a4,4,2,1,1,4
4305,cf114a397f174b59a7fe9c136d45efcc,2015-11-21 20:41:27 UTC+0000,a08cb8d40e0744619c6a5ffcd9ed5cae,a1006e6a58a0447592e2435caa230f78,3,1,1,1,3
4311,cf146a33264c41118cd2bebd5f5363d7,2014-03-17 21:27:16 UTC+0000,0bea3cc63d044b5489a16e3f6ac97a5b,78ee65a017dc4700a8286c649114137f,1,1,1,1,3
3140,cf184ceed0c545dd990f566bbbf64260,2014-04-09 14:08:15 UTC+0000,6be640b5afbf4fc1a9334a4646c230ad,fb55b95b86da4e7184c6abff35f432ca,3,2,1,1,4
3764,cf2f7ef298524849b4e3dbaf79738101,2018-05-10 20:38:20 UTC+0000,93223e2f359d4febadbcff0b1d2b00cf,4dc61581ec7b409bbd037e483f53ba0a,0,1,1,0,2
7065,cf33fcc37ce7421c8ebc25f739cb92de,2016-07-12 02:14:01 UTC+0000,b5dcc60b63ad4576b2fcf8eda6b3fafc,88b24847ca5746969e040efed10a807c,2,1,1,1,3
7665,cf365b5955d04e23b597cac08b17be11,2016-09-24 23:50:02 UTC+0000,c25b3beb5c05468686aaff3d6a241eb0,9015cb6141cf4b9781791244ecfbc286,0,2,1,0,3
5740,cf3bda9e7ede4da7878d0d8faa47f93d,2013-03-14 20:41:20 UTC+0000,667fb7cfa5ec43b89bd31d220c82ce64,736f5568ea5b43f59076dd81455141bc,4,3,1,1,5
2343,cf3f1b5cf9824b849a3d2b2e0fedbd5d,2015-08-23 19:19:19 UTC+0000,3ab3f83b979a4feabf5a6baa7cb1c28c,a1006e6a58a0447592e2435caa230f78,3,1,1,1,3
4325,cf40cb4e9af34d1db139dd503127788a,2016-07-12 17:44:35 UTC+0000,472f96b692c94f3597d60276e7f4f0d2,ad741868a4494cf4852e40afb02d7956,2,1,1,1,3
6315,cf48ea663f9e49879ecdcbbc85158664,2016-05-10 13:56:48 UTC+0000,fb54b3ff1dd34893978280056ff3c3d7,f3625d8f4cf242eba824f905a15568a4,0,1,1,0,2
4904,cf4f03b5447243aba377eb2d13e32299,2016-05-12 16:22:40 UTC+0000,7c94b13d23784f7ca00ed25f2e120521,655cb4965f34469897b44a86f516f3cf,0,1,1,0,2
323,cf5bd8f5594b42f4a02fa6580948eb6d,2014-02-09 17:49:51 UTC+0000,3a339b136f3a4e5fbe5190e26c65d47c,77a65aed859f4b11983cd07399f1e3b1,1,1,1,1,3
6897,cf5d51385b1648e0a74ab951a3d47e27,2016-06-29 23:49:04 UTC+0000,4dbbd901319e4d4580a37f438c7c6943,e3529e64e70643b6889353db79eeea3e,1,1,1,1,3
3018,cf6b6255d7594ca9945e15f5a801152b,2013-04-07 23:19:27 UTC+0000,867ef0b571c54d43b40d3aea8756ed69,dc5f831501f546f5b758b477e5893f85,4,2,1,1,4
5763,cf6f4da4048b4c19ae6ba792f12ebebd,2016-04-28 23:01:10 UTC+0000,0bdd336c334f4d39bf7d2d83a4a3b300,10005df177a444198e4a6052d8ac7502,0,1,1,0,2
5397,cf7fe56cf43842ee89d77f069419e895,2017-05-31 20:02:41 UTC+0000,dcd0869033f34d22818b527702a8a75e,d67ce930870945109a7ad86d29ba2035,1,2,1,1,4
919,cf8eacf128734d8881a8b35a7cf147d7,2018-04-25 00:48:06 UTC+0000,d3bc56175d144eac8f8a26b4bc648feb,9421dd803d164e5da26436a01a92ce13,0,1,1,0,2
5941,cf9c38565ce04cd5b74de934bbf4c7f2,2016-05-21 14:49:38 UTC+0000,219716456a5145fea6efc231a53fab3f,36ff3b3666df400f956f8335cf53e09e,1,2,1,1,4
1202,cfb4970fc5394c70a9e4ab736f53a5a0,2017-05-23 19:25:31 UTC+0000,157e043eebe647858a7e23e651d28ae6,75b168e0dc4e4bf28cff7754567ad415,3,1,1,1,3
4920,cfcd952709b34f3f80811ca5e5886dbe,2015-03-09 13:09:21 UTC+0000,c46d2317a2f94c81b3e524748c5517e1,369f1c8646b649f6997eae7809696bd5,1,1,1,1,3
1816,cfd155694c2a487a9faadd362e0d586a,2016-06-23 12:21:02 UTC+0000,af91890dd20c4c2a8979fdc01075f4be,60f7baaeb98b404ca65663154ab9e538,8,7,1,1,9
6539,cfe6d7dbc82f433099f509a371ff4b71,2015-09-02 21:27:13 UTC+0000,bdd11f7cde1d4b26a4e3a7198fd5fec0,369f1c8646b649f6997eae7809696bd5,2,2,1,1,4
6025,d00a3dc1459844f88c360fefd0bb7b56,2016-11-16 15:04:54 UTC+0000,3fb9ddbf29f2408fbc60fec3d073eb12,9383f1caac6746e7b084179b3a383708,1,1,1,1,3
1203,d00bd77249a64a2a811081b6e0c7ee76,2016-05-10 16:42:47 UTC+0000,3f44e4720aa743db93ec61ca439252bd,34df64a2783a4623b22b4f3afff97d28,0,6,1,0,7
2711,d0116293141f47a896562ba287c31568,2013-04-11 10:53:56 UTC+0000,1800b3dfcf214faa81991192f10fecb5,19b824743da84c8cb65e812c70ebe2a1,3,7,0,1,8
5923,d045844586d148bc9fd28e644064a6d3,2015-10-26 22:10:57 UTC+0000,eae3b1ba768741f9b902fa009721afa0,a1006e6a58a0447592e2435caa230f78,2,5,1,1,7
7307,d07903281ce24ed4a787d22330c769a7,2016-12-22 23:11:21 UTC+0000,c9cab7a3c33d4a04bc9947c3ee5be90d,36ff3b3666df400f956f8335cf53e09e,0,2,1,0,3
3931,d086f344610f4b0581d4d85d2b1c0722,2015-10-13 07:54:26 UTC+0000,db782979984842bea117d84c7a1c817a,e1dc844efa124290b064ef439c704c1a,2,1,1,1,3
1082,d08c96858eea460db3fd1c694956bee6,2018-06-05 08:59:25 UTC+0000,3aeef0203c2145fb96839cde384e89a2,0c1da6b3b5d441ddb4760a3a5f1246c3,0,1,1,0,2
6978,d08f4271a3b440f3a1da2b8959b992b9,2018-02-06 01:42:14 UTC+0000,28b67264a74c4169bb0b956edb7984c3,a6d33c38902546849c36ea7e9e9f0870,1,1,1,1,3
2578,d09cbd2b76ad43498d19a6370ac762b9,2015-01-02 21:40:42 UTC+0000,b44d48a15f594a50b504d23938001f08,b688e766eed04a37b7abc9218aca1ce4,0,1,1,0,2
1596,d0a03325191c427f8cccae72d7af7c96,2016-02-24 20:18:22 UTC+0000,8079917e346b424a8b33ea1f217f5d03,ae692d5321cf4c9682ea5ac86956bbb1,1,1,1,1,3
6069,d0a86be17a3f42dea7336ba5eaa71075,2015-10-26 18:35:22 UTC+0000,3a6460f4cd0a4512ba07a2dd79cdbc73,a1006e6a58a0447592e2435caa230f78,0,1,1,0,2
692,d0af5980d35740638a367ebe59206b4b,2017-12-18 16:53:38 UTC+0000,feb03a4e7f5c47ff987c0a590b5335bc,2b91603d3f704a6f8533d7e81d72c19f,2,1,1,1,3
1198,d0c851d2a72741028cc483735c401983,2016-05-18 14:22:01 UTC+0000,f6405d6580184ac78d0b86505b57792c,d4d75c13e7a847d288e0ab58fa7cad7b,1,1,1,1,3
7545,d0ca539de6fb444283dc1a7cd7c70a6a,2016-05-03 00:35:15 UTC+0000,6210a5d8c19546e99ef0456c9f23a0b6,20397ef7d30443eaaa3ab464d6f14b8f,1,3,1,1,5
2209,d0da1eb342494941bd9f4c5aaea65a30,2018-03-02 01:39:00 UTC+0000,0f4fe3183d44423599b2bc3c4be7e23a,9f824229b648477f9eeea194f293cf60,1,1,1,1,3
4734,d0fff27129bc471c962e3ea578ce5ad8,2018-01-26 20:36:18 UTC+0000,d16c5999680449199d5a91d3c93770e1,9a1d143c7f604d04bafb35117a4d3c84,0,1,1,0,2
558,d10b3c1a464545d3a782b662734a3bde,2017-09-02 12:23:22 UTC+0000,e4637ec70cfc41ed80c66a615ce71bf6,8d63cf34213f45189a5a8eabd9d71529,1,1,1,1,3
5476,d11ce97509fa44ef9aa3a505d6f578e5,2016-06-22 11:51:32 UTC+0000,f20e209b581a4ec494f932a513915e1a,d81411783267490199dbce248c16bc01,1,1,1,1,3
1688,d129667ffd004f078e4625b3fc18b60b,2014-04-08 23:11:21 UTC+0000,77884edccdf747cda58e28dea8cc8ee9,fe4543418c0846e5a65fa22b4ad9a304,1,2,1,1,4
3335,d129d9ee1718407b862bf39010ca4f42,2016-06-24 04:06:30 UTC+0000,057feee2861243f7a2a0d5b5a452e562,272f2e9f95b24fc694af3a8bc74ed52a,3,6,1,1,8
6927,d12ce3acbb3648a29c169cf41b4698dd,2017-01-16 02:27:15 UTC+0000,7005f0b675fc4a62ade15d0b0d9a4a89,a72bde6ac9e349d195a6d356444c9578,1,1,1,1,3
6652,d13204c67ca7489c99515719806b42b0,2014-04-07 13:10:58 UTC+0000,4f264f5f925b4299a191dc68d59c02d4,95f1104e8b604c98ae237020a98921c4,1,2,1,1,4
4880,d135987511de4ae79c58dfb60b33228f,2015-03-09 13:12:41 UTC+0000,d2840d81cca44646a85fa86d133e8a22,fe4543418c0846e5a65fa22b4ad9a304,0,1,1,0,2
4558,d13a116ad0ab4457b2c1a6ac2d3df9bf,2017-02-22 21:47:03 UTC+0000,93418b3b40b24b37b3cda804bcbcdc6a,9e0cb2a2914c4d05be76c85e7ca356a7,2,1,1,1,3
1667,d14bfb91bf194f718eb40e1afd98f858,2016-01-06 17:32:24 UTC+0000,9a04acc4ac0f4bd091f140d652260f91,d0e9cfdb8d3648b6ae667fe95aba76a3,1,1,1,1,3
2909,d15bc07f76da49f2aa6fd6110fe330f5,2018-04-03 18:28:51 UTC+0000,8179f50b4f964ad4bfc9dc348d124a25,96ed93bcfb6d4a2aade68c91520b9994,0,2,1,0,3
4982,d169b29d67a84ae9970ab990545261ff,2014-04-03 22:39:13 UTC+0000,795e612a691c46aa911c3f7a8b42288b,97c796d58f794825b1a9ebd02dd96f34,1,1,1,1,3
4214,d17215b70e534d4ca5642bb91b72595d,2016-03-11 04:01:51 UTC+0000,ca8cab10e65f48e38fa27d9130f1ccde,426d1afbed2b4841995ceb2d6f18d687,1,1,1,1,3
7819,d18eaacbbdd04793a978fbf36079170c,2015-11-08 18:46:41 UTC+0000,8cdf0cb46610406bbc1cf1f4eaa85094,a1006e6a58a0447592e2435caa230f78,0,8,1,0,9
2448,d1b4aec06dbc4b23b4336985d4d3f459,2016-12-19 14:39:59 UTC+0000,dd9d70ba9f0748c8b921dc1da4d6a777,81a594b683d54e6dbb4b04ea00a5e25b,1,1,1,1,3
7004,d1bdb1f1b65548c086d449f0c58212c5,2014-07-18 09:59:32 UTC+0000,402ea7249afd45d5a042fb3d15c2700b,50cf3d2dd2044152845aceed66b48c65,0,1,1,0,2
2159,d1c3be532ab2411590b8910f33f86a41,2013-03-27 18:20:22 UTC+0000,93e0747fe83c473d94725fb2f44c625b,2e80f4e84caa4dbc94e7e5311d3bbcd2,0,1,1,0,2
3642,d1c851bedfe945b780a32ed999369d1c,2018-04-04 19:24:53 UTC+0000,be9884d455ab412598e9dd9274d1ce93,a884bb3578c94e7893185b7c43723b63,0,1,1,0,2
1922,d1e69c7b39d847d29ab1a34b411a01a9,2018-01-26 04:30:49 UTC+0000,0f7912c355d34d739b56dda4b5980180,95afc7f032aa41809195d0d1f989c9bc,1,1,1,1,3
5555,d1edf8d5d59347a885d8362c764365af,2016-05-02 11:50:18 UTC+0000,2666097e08a94583bee26b8d88637e6c,36ff3b3666df400f956f8335cf53e09e,1,2,1,1,4
3010,d1f9da7a48284d07b5db99139c3b3db3,2015-01-24 16:50:51 UTC+0000,c6a1c3acf3064555a09f180ea536b611,ca520a7f0df34ced8ab5cf25c8e0a2ee,1,1,1,1,3
6468,d202e6ba41d5456cbbddeecb9d8fadf7,2014-03-29 04:38:04 UTC+0000,121a04dd524244d5b875c5384bdc945f,b688e766eed04a37b7abc9218aca1ce4,1,3,1,1,5
1560,d216c07dc72c4cff9928a899d8c0eb72,2014-03-15 23:19:41 UTC+0000,bf05f06f01a7421dbe1e5a3cbd9091af,f33a960155944fb781de493e371ae46f,3,4,1,1,6
4766,d21f1d8163354b5f9dccc8deeb5a919b,2017-03-07 16:43:56 UTC+0000,e78e822c30904b58bc7e67630c6189e4,a1006e6a58a0447592e2435caa230f78,1,1,1,1,3
3983,d2224c5597694a539d7e115bbd526f00,2014-05-19 16:16:05 UTC+0000,2a5481c92a724222820d55303aa16430,e4e7cc05a0b64cd6b02168d404a45d4f,0,1,1,0,2
5239,d22af9fdf6ce42d585487c0e80c0ce1c,2016-03-09 19:21:34 UTC+0000,d068c4b4cff6443195270a2e69b1342d,c5c2ca95fcd3463a8852b8bc9d636313,1,1,1,1,3
188,d22ebe7949cb4ba786da046758f08625,2015-10-21 19:54:23 UTC+0000,5a37b0c3b74b453187515b6c81e975c1,07237f90a48d447ca6754504a07b6891,2,1,1,1,3
455,d2527e0116f94368907f6bffd396e6e2,2016-05-13 19:46:47 UTC+0000,ceaeb61d6dfe4998b21e46a381dcc4f4,63aca8fca6f349b8bb2d7d1bb3c5b0f5,2,3,1,1,5
7245,d25b3ed921754f8997c178c6f2a5556e,2016-05-18 20:26:27 UTC+0000,9b81c7868ab046c88041c33dd4e3eb0b,7667c23d26ab409ca3e49758f5367925,2,2,1,1,4
3216,d266e4e68e9a46288022c8023b7d3b1c,2016-05-09 15:52:00 UTC+0000,7ded6aca3e3e470394bdb6c0a5c61c61,20ca3782a8ba41289484ab2e8a8e1fea,0,2,1,0,3
7164,d27b34063d0f49f0a69488a8852a639b,2016-03-27 23:03:54 UTC+0000,53c1f98c8f5e4b9c81cef3d28cade23a,0e554cf6fcad45ed9b0110e494fa563a,1,1,1,1,3
7017,d27f6d97bf7645c08ec74e78f6992e31,2016-05-28 16:41:45 UTC+0000,9dfbfc7a8c604d7e8632788e9e495cc4,c232fdc3917c48ffbb7c9375a460d358,0,1,1,0,2
3436,d2899382b67146aea9465e90ed2e89c5,2018-09-17 13:26:38 UTC+0000,b3076b09ebf947fb90fd8cd419cfef98,be5d23056fcb4f1287c823beec5291e1,0,1,1,0,2
4990,d2a7306d51df47f98f20ea9579c245a6,2016-09-13 02:27:56 UTC+0000,66c10d4db6374e4eaeb28427478cef0b,58fa5e95fe9e480a9349bbb1d7faaddb,1,1,1,1,3
6605,d2bfd116a57a4fdc84f28cea8455d048,2014-04-14 18:04:33 UTC+0000,1a9f49afb3154d73be6ae7283b34dc93,0355aaad83704ad98e6d71b79db85849,1,1,1,1,3
137,d2e7869caf494b5e9722e5ec35bff99b,2018-02-20 04:02:31 UTC+0000,fe66c25a4ceb45039a805d5fb8036ebc,41ddf161ce604f54b8a11627a0fd1698,1,1,1,1,3
3264,d2eba579f10c4ff7b976977ab8a04606,2012-11-13 15:46:51 UTC+0000,4f7043058c3c48649fd9417d251aa600,68ecc66323b8418092fdd724aaf5be94,4,1,1,1,3
2046,d2f3225552fc48eba9bc98a82773044a,2017-01-18 00:16:14 UTC+0000,06c3126487ce4c03b0b00a48811442e3,5f95b0ac821e4e8e9b4fa9fc8eb9ff61,0,1,1,0,2
6879,d2f4d580a75a4e29a3ee225722622044,2012-09-09 20:37:25 UTC+0000,9006ffcf0f9c41c68e25472c7451f3fc,4a71c85e58dc4c1a8546574188582a92,3,1,1,1,3
6022,d2f511aa40a64eaa8658346cca51a923,2016-05-12 15:02:23 UTC+0000,bff789c02ab542f4baa13a8aab068191,06eebab6ea4f421daa1c7ebfb4467021,2,1,1,1,3
2891,d2f79c36cc4d47bfbbdc8c5b85f148df,2014-07-18 08:01:55 UTC+0000,b42c2436053c4531b7c76d8f42ac886c,73022306c326418a8a67b7d101273e1f,0,1,1,0,2
5635,d2fa737334e44681802cf70e07a4a78e,2015-10-14 19:53:13 UTC+0000,dde4b693c4064c4e9a8b24b1f5ad3b6a,aa916ae133d04bfdb7cdf610f7e7a745,2,1,1,1,3
5717,d307105a6e5b45a9b969184ac7069135,2017-11-11 20:36:49 UTC+0000,41136a04afe0406791fa93436448bb6a,4dc7d9040592416f98c0bef1ad2c31f5,1,1,1,1,3
818,d31b8349ebee448b844d1efe709c07b5,2014-11-05 01:44:44 UTC+0000,902683aaba094f8dbdd26b194a927c02,1d8d4ea9cd03402cb4b34aa41ad9f3a0,0,1,1,0,2
2200,d32153b103614508893ea6de276aeacb,2018-04-02 18:04:12 UTC+0000,553921556453409a87147ffb8bec2f28,488eeaf529f64deba84c60f87e47ebc7,1,2,1,1,4
1209,d321ebcae06548ce81970f9df33ba5f1,2016-06-25 00:23:32 UTC+0000,400e179a560e4017bdf0d0ea6d81c44e,6ea2a8a29d904015959ae16913092ac0,1,1,1,1,3
4800,d3266b8c75434f8e926a1535cdd8fc13,2013-03-01 03:08:36 UTC+0000,8301d6d161ba442dbd9ffae0401d5052,05444a2f42454327b2ac4b463c0adbe0,0,1,1,0,2
6985,d32a42c6cd704be2b0867a31d3d24b8f,2014-04-23 03:02:29 UTC+0000,7ea3043bf4be413f9b5aa486f6e720ef,fe4543418c0846e5a65fa22b4ad9a304,3,1,1,1,3
6911,d33fa6ba663d4ef79a8ebb97e588ec2d,2012-09-17 03:56:27 UTC+0000,eb40db65615c4dabb886d3790e32e278,8442ddfd38bc422fb4677785db0630e6,6,7,1,1,9
6759,d354ca1482de4453b79f8a88f7aac887,2015-06-04 18:11:51 UTC+0000,5233881d6c164829b772392e956240a3,05444a2f42454327b2ac4b463c0adbe0,2,2,1,1,4
5532,d36e575b8ec44c149e0c54f53468126c,2017-05-17 13:50:39 UTC+0000,0afdee79a1264014b0eeb82408a9dac9,d5b9fa528f464fd2a7bfc4a8d2a70203,0,2,1,0,3
429,d37095df5bbf44cbb24fd8d893e9c349,2015-05-07 14:45:17 UTC+0000,68fc262e01ea4998b3174f4a4fa1f630,ad3e1c5a466e4e6fb9aa281783c2d676,0,5,1,0,6
6276,d378901952f44e1b8aa64cdde824b441,2016-11-16 04:22:54 UTC+0000,644eb75cbaa840e393f70503a90c515f,c7174378cda74e0886100523dde4913a,1,1,1,1,3
7939,d38c5cd19f584c358ec103f5c1c17526,2017-05-10 15:13:30 UTC+0000,b526a44910ac4e4aa484d4bb81c87f80,5a4ed8583c7049c4b95a44ecfadc4403,1,1,1,1,3
5183,d38df3a496df447b981fa23d51db224b,2013-10-01 18:13:00 UTC+0000,f224211c877c49c6bb5983de1738bd96,207c8c62bcaa4033885a24a8a5a10d51,2,1,1,1,3
370,d3b5bdc6296b413c8b09cf1ec2f8e3a7,2017-09-18 02:09:10 UTC+0000,771a0324d4f646f3b86dd244317cebf7,4e0f0fffe8c941ee844e650082267fb9,2,1,1,1,3
5125,d3c07016a6fd4e8eaeb53a02e1899a18,2016-10-03 14:18:05 UTC+0000,a0eff4b7353544c9ab246304d3e152b6,d922b841ceb545d7b5ce7bb066ef96ec,1,1,1,1,3
5791,d3c5694fc0214e359c9ef95f1af48f0d,2017-10-26 21:52:09 UTC+0000,8951c20be3de440e9c4801bd7004a0c5,e2039230a1f94abe8b8d4cecd4bfb069,2,1,1,1,3
547,d3ec454ccb9546efb6085d83674d1413,2018-03-22 19:13:01 UTC+0000,cd39183bd20449e5acab515f6f994d1c,751ce59fb621448093996a4cb9a6f88d,1,1,1,1,3
2073,d3eea3319eda4ce1972f46fd3e278c6f,2015-04-03 14:36:25 UTC+0000,d507df447be84d52ab9eedadae87a096,0895796423534563adcec1c208e9e0bf,1,1,1,1,3
2868,d3f959994769450cb9e2a592d1073869,2018-02-01 09:27:39 UTC+0000,47e30cd894cf487fb59ac068e98c91b6,c34d17b9958f401586f3ee72ee01382c,0,2,1,0,3
7789,d3ff3c29d5654afab2810c3a9d694857,2016-06-21 04:49:59 UTC+0000,b3d63cc90a91459eb671e833a3ebce42,0ba84d7198394643a9bcd5231080fe9c,0,1,1,0,2
3338,d40252146c4248e8b90d772d8049cbfd,2014-03-11 22:04:23 UTC+0000,47b32adecb73422c89e3fb93034b4d02,564ef581bed64addb3cf0ff0ab652ffd,1,4,1,1,6
3732,d40aa06485f040b19b67f71df166fb0b,2014-03-17 13:08:05 UTC+0000,03b03a8f5b5f462db7294a3b3e81c44c,79b841ed883c42c8a943f673a161f097,1,3,1,1,5
7060,d4406d04dbcb4caab75b7871a9d4f916,2016-08-29 03:18:37 UTC+0000,0f6150b540a74b9683077b7f506b8c36,819f3ed1c1da40488a9d0c794d4daf61,1,1,1,1,3
2653,d44cb7eb0a744e818553b3484d432e11,2018-01-04 18:18:27 UTC+0000,82c0fc999f2f44ce9e6fc5d38bb6e486,4d9079c15bd94726b57d4ebdb63cc0f0,1,1,1,1,3
5124,d451b3f27d744f7d9176eca611fc2eb4,2015-10-28 04:28:56 UTC+0000,a8cc49b8de694e1ba8acd420dc31083c,8435fd16c86e492885acc2cf5b6e372a,2,1,1,1,3
1956,d45cc8a013924e46bc31d7e00fe401f1,2015-11-19 02:57:55 UTC+0000,5709928265994dc18594cb049e86ee66,1bb341c8874d4dae9235cb6480ef7d57,1,1,1,1,3
3213,d45ccefec4824de899c3e9044bf359b0,2014-11-11 11:23:54 UTC+0000,579dbf0fff6a4bf4975b29c723afc35b,d1f04208de3643c088f4a25e57f1cb2d,0,2,1,0,3
6201,d47ceb06a65b45269a59cd9825236a78,2016-04-12 15:15:29 UTC+0000,0cecf1020fff419786c6d6deb2de7bdf,4aa4d50a631d474c87a549318670f30f,0,1,1,0,2
993,d481c55b6e5b464cbfca17f9d2ac0fcc,2017-01-20 04:52:59 UTC+0000,22c52b6212bd4d2ea5239a8d1df01b97,a74ba70531b64e52b075caad8f45bdd4,1,1,1,1,3
6149,d48523f2a0824a4fab80a5b0299d5930,2017-04-20 13:13:26 UTC+0000,6a74a5a65fa145d395d66dc223bf271c,e3605142dffb4d87a0f8b950da727f73,3,1,1,1,3
7490,d48aeed9e142426598ac40fd61007c78,2017-09-28 19:52:38 UTC+0000,02976524611b4eefae137ea53050883b,8022e3cb63e840c98c27148713777ce3,0,1,1,0,2
6245,d4972a610b4e4526a424a9742e573ac2,2015-12-10 21:05:02 UTC+0000,6527ad81fb254a80a740c19ee8211f73,a1006e6a58a0447592e2435caa230f78,0,1,1,0,2
945,d49f425650864399b9452e933a91fe41,2018-11-07 14:05:03 UTC+0000,a51222fec8734dbf95ec9404982dd3d0,be5d23056fcb4f1287c823beec5291e1,1,4,1,1,6
5776,d4af18f0db264f5db8b0b7cb2c50499d,2017-07-10 23:11:14 UTC+0000,f154697fc1ed4dcf9c56c6cf9a60bcf2,a1006e6a58a0447592e2435caa230f78,5,1,1,1,3
4125,d4b7cedb06c34f8889e9e332471de729,2015-11-05 15:32:52 UTC+0000,3ac0c67f6fbf4dccb3408823ac9bcb7a,a1006e6a58a0447592e2435caa230f78,0,1,1,0,2
532,d4bebb3a0409410c9fe2273e485bdae8,2014-07-02 15:41:44 UTC+0000,a89bedff874c49d28bcaa4ea2541a63d,4f6f035eb0a2470bba8472cc73f6d8e2,1,1,1,1,3
758,d4c1a41d455e40ce9d0d033ad7a10a87,2016-12-26 19:53:47 UTC+0000,afd9afc332d64ddebd4a672f062ce014,36ff3b3666df400f956f8335cf53e09e,1,1,1,1,3
2820,d4d53c1c81b541de8629bb1a126e2cc5,2016-07-31 12:00:32 UTC+0000,188be3b54bb1489787b20213a0fdd838,a1dc1924560646a08734c54f0306d668,1,1,1,1,3
2493,d4d9f470a71e44f79bfb33dcacd41ac8,2017-01-13 02:38:25 UTC+0000,345c3a03a02a4508a58284a03b2111e0,393bb163114340119a88944a061c397f,0,1,1,0,2
4012,d4da20e800494a1dabca3dfb6fb2a1a1,2017-01-27 00:14:26 UTC+0000,b71b2df4e5ee487a9f3280ac78893ee9,c32d749c57ad4c388aca1197452b1188,0,1,1,0,2
3256,d4f86a6b267748b8a03e71676f264a82,2017-10-14 04:04:36 UTC+0000,f8dbef073c314fe0b00d99d86911a8b0,80432b3d99d249f0a9589ac1ff392004,0,1,1,0,2
3500,d4f9d6412f014171a79cf60af97baee4,2015-12-10 21:12:47 UTC+0000,21f84994d2b842df83eb2809d17feb5f,36ff3b3666df400f956f8335cf53e09e,0,2,1,0,3
1380,d5011f842f2c4ed1a73a952440c8fb39,2017-10-09 00:06:04 UTC+0000,92154b80c56e41829c8dafb062f1e4cf,f5ef6f60687c441aa2f0c2c1922c3f50,0,1,1,0,2
3905,d53f4d3823fd47d99a09cb19bfb8824a,2018-04-10 00:48:34 UTC+0000,818c116498434985a6023356a8fda524,209fcd55fefa4fe29ccedcdc26bd5d89,0,1,1,0,2
5395,d53fcf9acbbe4b2caa2f9591287c3932,2013-12-04 22:53:45 UTC+0000,c89dd9fcdf76440a9b65f1b3e9fdf02d,05444a2f42454327b2ac4b463c0adbe0,1,3,1,1,5
7261,d558a1d8e51242d9823f29ce72030c3b,2016-04-26 14:32:35 UTC+0000,852f2850df05422883fe6189ad4ed2d2,7d425e8d7cfb4fe7b0702fff4d6d84e7,4,9,1,1,11
5707,d57dea48dc474ee3b89ae92fde380e05,2016-05-16 17:19:39 UTC+0000,70770d8cc63c474691b1f2d19c64f45f,f440d21deb594b43a7b8b9051212fb2c,1,1,1,1,3
3374,d580d897915340799ab9970be739d733,2014-03-23 01:50:24 UTC+0000,ca3e704788ca4c899c77d0eb04527e7a,b688e766eed04a37b7abc9218aca1ce4,3,2,1,1,4
3285,d58e85ff900b4ef4948c51e12658fc40,2018-03-22 03:20:26 UTC+0000,455f68c80c684bfcaafbc81d5db7d8a6,cd4f4383de19482d9b82a43f452d58f3,0,1,1,0,2
3666,d5a36b0ea571470f8387afe5d10c829a,2015-01-26 21:49:11 UTC+0000,d09bc029f55e4ea59451f2282f785d6c,f39d1cfb0d11492d8e3291943674ace2,3,1,1,1,3
2737,d5a6bed3f4c846b4b70b80213d9a4c78,2014-03-04 22:55:44 UTC+0000,e80ea407da874c0194592a86591f9c56,23b6df4d73fb4d9bab3eafb6dd8bfb86,3,5,1,1,7
7048,d5a7ce6e21f04eeeaf424488e2866d50,2016-05-13 11:26:04 UTC+0000,a9097f92cb9e47599a8181f2e7d622fb,e1d39b665987455fbcfbec3fc6df6056,2,1,1,1,3
2545,d5afd853e20b4a798e9ca5a694dbb495,2018-08-18 23:47:48 UTC+0000,4734a42259a2480298cf818582dcd55c,36ff3b3666df400f956f8335cf53e09e,2,4,1,1,6
5959,d5ba53ca1b384eb984442a43f1c2363a,2018-01-25 21:22:12 UTC+0000,d16a023cb518416bb5e59c6761aac665,98cbceefad3e4f7db812f5d2a963db3f,0,7,1,0,8
966,d5c4b214c6794302bfa223f2eaed85a7,2012-09-09 13:37:37 UTC+0000,64e04f13472d4db390dc8b7f47c7dde7,b1776598991649088c0a00a6e0a2c766,2,1,1,1,3
4837,d5d52a58aeac4188919ac77db7293c3c,2017-03-20 02:19:08 UTC+0000,6757250a54ac425788371c0c4241eaa2,6624dab5dbd441b3b2bd61dec51a09f3,1,1,1,1,3
5282,d6242bb41e794a48a376fcee20d6063e,2016-04-24 21:57:54 UTC+0000,5ced23b9b2274e03bc624b3939d852cb,58fa5e95fe9e480a9349bbb1d7faaddb,1,1,1,1,3
6775,d62b25e62a1d49ebb8c86fc8ed7bb74c,2016-05-22 12:37:38 UTC+0000,20df4e9b0974420fb491f83d7a68ce73,8d63cf34213f45189a5a8eabd9d71529,0,1,1,0,2
4546,d639f8c688b64600a6566705178cebdd,2015-04-10 04:44:22 UTC+0000,c93921b05d8846c0a32da1d3f968d5c5,c21a79774b2344af83661db9c2eb368c,3,3,1,1,5
2838,d64d7634b6404a60855791dde3a28765,2017-08-30 19:35:53 UTC+0000,8b2525f3be71412f8a5d179fa0b27a18,43e6219b519c49ff8006964d0b456297,1,2,1,1,4
3324,d64e0001257d452a9b780c1e876e1c8d,2018-05-27 21:11:28 UTC+0000,abc3399d2bd6429db2519eb403e54c76,6b06376c7a904cea8a89b7b9609021a0,0,1,1,0,2
2055,d6539f70e73d498c949014b369a7e3f1,2016-05-18 15:50:25 UTC+0000,3f5138c0e75e4d54b8c9a4d88ca9d3f8,6e084b12afff46cda7a474e651a56d08,0,1,1,0,2
5356,d65519a775524ee585f030c1f5c48949,2016-06-24 13:08:49 UTC+0000,8f350cf34b7849758176170da3b1e9da,8cdeec41de5d4893925deb57220a6d2a,1,1,1,1,3
3512,d66b4554894d4113aa598ea9f31796bd,2018-04-03 13:31:35 UTC+0000,9a36ebd352b34081adffb6e69bb77258,be5d23056fcb4f1287c823beec5291e1,0,1,1,0,2
4863,d66e3f3c00b743f58d4989a6b4f3e20e,2016-05-20 02:22:49 UTC+0000,4c1978a91cbd46d592ee823627c093c1,ce4132b1842e41edb9a830f591f2bc39,2,4,1,1,6
7320,d6ac3d459ab546afa3f399e435fa5b03,2016-05-20 01:51:11 UTC+0000,63352ea11d244f668dd169d0d05e721e,ce4132b1842e41edb9a830f591f2bc39,1,1,1,1,3
7047,d6d93b47e0b24ebd91dc062ef8d2ea5c,2016-09-13 03:12:02 UTC+0000,543914f6a2c24bb8bf70c8fb32900880,58fa5e95fe9e480a9349bbb1d7faaddb,0,4,1,0,5
4556,d6d9c19cd3934207a25eada0953c45eb,2015-05-07 16:20:26 UTC+0000,64869da09abf46e8ae97d03079adc501,369f1c8646b649f6997eae7809696bd5,1,1,1,1,3
3909,d6e020a10cd8495e8d87a688b382bf7e,2017-02-04 12:25:09 UTC+0000,c46f9814d33f4374bb30752a8ce0397a,81a594b683d54e6dbb4b04ea00a5e25b,0,1,1,0,2
7607,d6e4042c9a8743c9a4d4d1494d049689,2017-03-05 19:50:36 UTC+0000,305f356b3ea04a2db51a84f4460d481c,a1006e6a58a0447592e2435caa230f78,3,1,1,1,3
2328,d6e50db15f5c4a38a3a589be1f069664,2016-05-06 18:54:01 UTC+0000,1dc17b839e8945b7b53cc7c17b284827,1272964da2504fe8a8a6400539cd8b1f,1,1,1,1,3
7778,d6ee47668ffc4309b276e80b6e574328,2015-06-29 14:12:45 UTC+0000,be178304e61948249af14262fc939c63,05444a2f42454327b2ac4b463c0adbe0,1,3,1,1,5
3985,d702e5cb91464a0b81c28d8e8b12976d,2016-10-22 06:17:20 UTC+0000,7cd54907a986415f9d1b468dacebc71c,dbfc21fbff414832beed41c7a5966096,1,1,1,1,3
4268,d70471b9effa4a6caf0dd8669cb83646,2015-05-25 18:20:50 UTC+0000,65cf8d00f0774cb28614125a0d836dbd,a1006e6a58a0447592e2435caa230f78,0,1,1,0,2
1794,d704ec8e048a42ecbf3bdfa08f7818fa,2018-10-06 01:45:45 UTC+0000,d84274cc2ce94f59a197956a50bc858b,5dbc7aa1edb94ad08d48d5b4829858ac,0,1,1,0,2
3238,d717534a8cb741ff9e00fadc18025399,2018-12-16 11:56:22 UTC+0000,e5bc79dac4934d7e8d91bb295de77653,6ee9c20eddbe41e890dbde50fbd63f44,0,2,1,0,3
3881,d72220ec30724198ad25927175e7d06e,2016-04-29 23:44:15 UTC+0000,61b98422124d4d56b61574a33a732c1f,fe5fc534894e45c191e87f8c2ea0c6bd,0,2,1,0,3
5710,d722b179781e4a7a99278e0d33a5ee68,2015-02-28 00:09:19 UTC+0000,9839ab6d394242dfb99aa1eb50c63a4c,3d8847ddc8d04185976a9e78b190ebdb,1,1,1,1,3
3115,d72a07c126c44f4d840a04b77a31ee7a,2014-03-18 03:37:12 UTC+0000,fa6d8d9f374a4fe88ebc2b9ccc397445,1fbcd8b315de45c29ff87cf912b535fc,1,4,1,1,6
569,d733d8b5ba4e49239937d954b532ae7f,2014-10-29 01:28:19 UTC+0000,d6d0dadd566c4ddbb187cf859a32a298,b82bf33d61f242409123d2fc58776ed4,2,1,1,1,3
348,d74e40eb51e641709cd1ee8508caff65,2017-01-30 22:06:13 UTC+0000,0a6d3e70be244864bd0c7f8d1c297478,036358eed7044c66a6058d1006fedbad,1,1,1,1,3
4505,d758a46d7e3542d8be38877e9e1d98ac,2016-05-12 10:14:27 UTC+0000,b8bb8050d78a47358765ed3c730c7671,96bbbdd06a334805a0501034d9df1aa4,1,1,1,1,3
2342,d76067ac65fe47b7b10c2faa261b2af5,2018-09-07 21:39:34 UTC+0000,b19a03da322b41f2b87a8f31613b1c53,edd1943f61c4455ebc214b4ca9649bba,0,1,1,0,2
2606,d76cdc00060740fca58ce677545085e2,2016-06-25 03:45:19 UTC+0000,f156d2d19b984709bd410c97667c5e76,58fa5e95fe9e480a9349bbb1d7faaddb,2,5,1,1,7
3759,d79910f097924da3b03071f9c65c0633,2014-12-05 19:26:58 UTC+0000,ae16a690cbf3436aa9303df92cf7a7e0,908851a577b14d88a65dbc87e8c74123,6,1,1,1,3
4337,d7a925766f0d42a9be38256f9fd41c64,2012-12-10 21:28:54 UTC+0000,357f1e344b854d74ab0a159481424972,9c5803ae43ca4cf6b27ea85871625116,9,4,0,1,5
6849,d7bc1a21d5e949bd98d671746b5a9e3d,2014-03-28 13:38:23 UTC+0000,30c45248d4a44eb395f0224a74e0b74c,0355aaad83704ad98e6d71b79db85849,4,5,1,1,7
6158,d7d808f6c9e2484cb99bbfe82fd9825a,2015-10-27 05:02:46 UTC+0000,e0855a6860c946d79b9bdd059153735f,1731d1ea92604b7ebc5fbf15a221cabb,0,1,1,0,2
7549,d7dc41b29fb74c5493900734eb5fd826,2016-08-17 20:09:09 UTC+0000,e624b6163be84f14a974bb71cd79cb6b,aa8a5de667484f499386e42400f6b298,2,1,1,1,3
1395,d7f88d72c5684ffea6801b00f547f311,2015-09-01 17:13:39 UTC+0000,b082eb2e7f2f477fb6682d078c1731de,a1006e6a58a0447592e2435caa230f78,0,2,1,0,3
2153,d7ff6748c90c42bcabb8741d49a2771a,2014-12-22 19:50:48 UTC+0000,5c513dff5cbd439f9825b9208bcb0866,2796213fb0324530bb206915156dd136,1,2,1,1,4
2893,d807e5e34b0e4670a490ce9ea21b8f75,2017-02-06 17:56:05 UTC+0000,91d96027c6d04c78a7432429ddf5f87e,36ff3b3666df400f956f8335cf53e09e,1,1,1,1,3
1225,d822f416c85f49eb8fa6c1b52d06be15,2017-04-01 17:10:05 UTC+0000,c5ed347619ec448b904a5743384de317,ac83901fad384461ad33630aa2d823d7,0,2,1,0,3
4281,d826126a211a458594eb17261cde905d,2018-04-18 17:14:52 UTC+0000,9193af10fa7f424f96944546a30ecccd,882b6170c15343418b19ffea4bbb668c,1,2,1,1,4
6292,d8492925839e493a805e51cececbad82,2016-05-07 16:02:17 UTC+0000,e1cf6d091f6046caae7dbda3bc47d2d7,58fa5e95fe9e480a9349bbb1d7faaddb,1,1,1,1,3
2348,d85d47f85f51470d829c2c65f062784d,2016-03-27 05:32:14 UTC+0000,018ad7ec93a04ed9be6c80fe03e0edb1,58fa5e95fe9e480a9349bbb1d7faaddb,0,1,1,0,2
2726,d87bbfbe3cd045d9838be74dd9540b86,2018-08-26 14:34:27 UTC+0000,67dd5cd0367642b3a5270ce34fb617b3,36ff3b3666df400f956f8335cf53e09e,1,2,1,1,4
6045,d889a94b4d284226a817a24ba8ae2a56,2016-05-30 22:35:15 UTC+0000,bc8983c5db0c42f69d1f344db03c0438,a488b31881134e9e8a607dcb03fac41d,3,3,1,1,5
716,d89320c3576141b58621932a38ef7232,2018-07-09 15:11:12 UTC+0000,b0d1a651886145529b3ab0f4a8f5a442,950898c71c6b4616b00b1d984ee71024,0,1,1,0,2
2684,d8ad5cfedbd24dbeb6cfe1462793a9ad,2017-02-15 14:51:12 UTC+0000,e5cd9f8f92e441aeaf830269229a875b,36ff3b3666df400f956f8335cf53e09e,1,1,1,1,3
4501,d8b7287871804155a4764077326fe336,2013-10-05 18:28:19 UTC+0000,7dbe49a191e643f98b391757295ea890,3bae570ec5244e3e95625da04d57f7a4,7,1,1,1,3
6314,d8b974e01bd044dfad0eb138ee739434,2016-06-05 18:36:37 UTC+0000,71a2b5e73edc4edbb79430d9342cbfa6,be5d23056fcb4f1287c823beec5291e1,1,1,1,1,3
3697,d8bf424560ce4843a08299e4ae735554,2015-10-21 19:42:03 UTC+0000,69921831d5834cd7b32c55832b32f864,721c6bf35e2e469c8d93aef5a67c70c3,0,1,1,0,2
7046,d8c0fd8f1d7a4a5e9ded2050f9d8b214,2017-04-11 19:58:30 UTC+0000,76ceee7f9e5c492ea59974469fdc3600,4e9fe7ffb54c42eba0987c6119da9975,2,1,1,1,3
5525,d8c8e878bf3147059fc50d87bef23e24,2014-04-08 23:22:25 UTC+0000,e7c59cbfaafe4cd89ad5543ea2c73de5,fe4543418c0846e5a65fa22b4ad9a304,1,5,1,1,7
4458,d8cb50ff8ade43649047f8d456485c9c,2015-11-18 21:14:10 UTC+0000,7dd44589775d4040aa36eced051c8846,a1006e6a58a0447592e2435caa230f78,0,1,1,0,2
3727,d8cbe093085b4ae4a9d07a73a066c2d1,2017-03-09 14:20:33 UTC+0000,96ac1deb00f34137b06f9f3ed22a77cc,b6116727c43a495f829303ab4110afc6,1,1,1,1,3
4172,d8d58d32613646f6b0e72591eb0a0ad7,2016-06-23 04:29:38 UTC+0000,fa66a52b6693479fafd3c29d89de1a72,f4759af9b17f44c9865b041a0469dc45,12,13,1,1,15
4989,d8e9ca0fccea43d69a476147c18572af,2018-04-17 20:25:07 UTC+0000,24737ccd7a294587b72f48f644e79c0e,aec1ba560b43461cbfc71e94d4b90306,0,1,1,0,2
1268,d8e9cd40c4904638b00741dbebbb59f5,2016-06-26 22:30:29 UTC+0000,363ff3e90e004a2fbc692af501cd6d6f,58fa5e95fe9e480a9349bbb1d7faaddb,0,2,1,0,3
2104,d8f0c08520bb44a7b682c80f5aa1b313,2017-09-28 12:04:06 UTC+0000,a400384e1b3048cbb12895e7480e8be4,e1d39b665987455fbcfbec3fc6df6056,1,1,1,1,3
2999,d90b11b1181d41929657798db659ecbf,2016-05-27 01:00:12 UTC+0000,b1d3b7ed5fda48b99d0b711abcca4c64,8c135c634fc14af2a15eb06303ca1f0b,1,1,1,1,3
1866,d92ba0070fb84288bdf46ec6d8844bc1,2012-01-18 04:48:05 UTC+0000,4bac995c4a5a4df7a8851234798a592e,05444a2f42454327b2ac4b463c0adbe0,1,1,1,1,3
444,d9322917364849719071c354e0ad1d05,2018-09-02 23:20:31 UTC+0000,08953f08b23d425da8b8b2b303923477,36ff3b3666df400f956f8335cf53e09e,0,1,1,0,2
1021,d935172b61e642ab941bb998d5d19e03,2017-08-10 19:03:15 UTC+0000,934d235f40a8405ab680b610d1533111,f9a9c08f5b37482b8f21c4e740572fa1,0,1,1,0,2
6087,d9379d2fdfb34d3b9bbdd014a99417a0,2015-10-09 18:19:46 UTC+0000,569e296128284debb8e1dae12ba0d7f2,22356c4db9a740678fc80974e929ab4d,1,2,0,1,3
376,d94a5c18a1894e6b9b7541af39868c86,2018-06-09 18:13:43 UTC+0000,1d7926fb15f849599605c96b5e2a6980,be5d23056fcb4f1287c823beec5291e1,0,1,1,0,2
712,d94b0bf8a4bc401c8de26a6a20f36774,2017-02-17 15:49:36 UTC+0000,da07a5dbc90e4a4cbcce8f4f08171220,416321b48a634ac8a53602625f0a5d40,0,2,1,0,3
2581,d95c950196b14fa4837180b0ed6fc4e5,2018-01-30 11:00:31 UTC+0000,a5065fd8ec864fa9bc89f9c4098df952,7f9e620f5e664221836077036ec84397,1,1,1,1,3
1787,d96477cdebc447c0b439ca4d9ce07fd3,2016-09-02 16:50:48 UTC+0000,740dd3ac1aa14723a0aeb8f6c85f708c,a1006e6a58a0447592e2435caa230f78,1,1,1,1,3
2978,d97c3d7a3a6d44b98133bccba5d7c2e1,2018-08-07 12:43:44 UTC+0000,0ede4f02a1714ae4869d6cadea9dc3da,7a034885d8d14531bb715bc1b9b5f8e2,0,1,1,0,2
5712,d98717b213984ed1a715bd88367d6258,2012-10-01 04:48:31 UTC+0000,a836064f4eaf491eaeb4142e8d4cd752,0c673e046d824ec0ad0ebe012a0673e4,3,1,1,1,3
1218,d98e670f4b6748a79aae164ba9400a8d,2018-11-28 22:00:36 UTC+0000,68d70028331e4b89aded345b62713fe9,be5d23056fcb4f1287c823beec5291e1,2,2,1,1,4
468,d99ea085a19e47f2a91c06827f6c2974,2017-07-31 09:00:55 UTC+0000,19c78f5576eb44878247aeea0ac9a560,a2b49c84ad60493d9d49a57be6dcd5fd,0,1,1,0,2
4802,d9a0d575e40b4ef6bad6c918856a4566,2015-04-10 14:47:41 UTC+0000,51f64c75f5a24cefa4b47d4c92ed3a21,2adab7916b3747af85b2d82e188c1dc3,2,1,1,1,3
2418,d9bc425ec020472ab6a6897d08eee522,2016-01-22 01:06:26 UTC+0000,1cca452fc9be41b2a38308d915e6502d,82d744719ffd452a8b1bd62cd17e5056,0,1,1,0,2
5713,da1e8aec3785447ab5098ea9e494b55f,2016-05-17 15:36:41 UTC+0000,50f9ad472659426796b56ae41d0d3dab,e96e56b600fb4b7f9c5a3d044acc9981,1,1,1,1,3
4523,da5782a8633241c2b85614f8dd37b333,2016-05-24 03:13:37 UTC+0000,868997fb372045cb8c763736f95442e9,fafeba89ca764bd891862fb8440a2962,1,2,1,1,4
7842,da5e626dafc0496c99865563fc45f5ff,2017-11-28 22:33:23 UTC+0000,ddebac72b0034ba2b2ff8e94ac6d9946,ff6f69708a854b5ab0925cb55a146a66,2,1,1,1,3
7239,da5fac5e34cf4a03b6effeb92aa9a116,2016-05-29 22:38:58 UTC+0000,bcb78684844048c7b8e9abbac5e4c202,58fa5e95fe9e480a9349bbb1d7faaddb,2,2,1,1,4
4161,da6c7c995e6c4c2097460c4559f1b29b,2012-02-20 04:03:00 UTC+0000,e2c8b65b597240dc87ab0e25d61159df,23dce13ca6164a73aec7a3cd56a4884d,13,5,0,1,6
6923,da9d36b79bf349b2967397c9dffe15ce,2015-07-06 22:10:27 UTC+0000,2c9a3c42ed844dccbd5a587170b51be0,a1006e6a58a0447592e2435caa230f78,0,5,1,0,6
5049,daa7b3df61e64d48ae738ec083981738,2016-10-19 18:27:33 UTC+0000,1ba010cdcc1d46eb9379d928c3c77eba,408723f34bf94a9ab5839b068c66f037,2,1,1,1,3
7858,dabd0cae06fc403ca8cf94d15931715b,2016-04-01 16:25:32 UTC+0000,e72861df16c8445fb7f8faf78bf7452d,eff48540ed50477991a095f18899dec1,0,1,1,0,2
6126,dabf25d1842441658e97fad46d1f4a76,2016-06-28 20:34:55 UTC+0000,e8d987296a1641c4aab2b7bfeb430720,b6b1477848fe4b709b4ea7e5008faf9b,0,1,1,0,2
5335,dad94ac0073445a4824d8645b0106ab4,2016-05-12 16:47:39 UTC+0000,761f5e625d4d469294446504006187b3,bbe2f296f6184a18a18ff399017fb002,4,1,1,1,3
7768,dade2366bc754f31927b85306dc0fff9,2015-03-25 01:18:55 UTC+0000,3bde99ab26cd4f69ac04e630d982e2ad,91c4cf836e434af8a78c2f5e937e3635,2,1,1,1,3
6344,dae5406e6b154ccb995621380b7e2e6a,2017-09-15 15:06:55 UTC+0000,a84ad8913e9642dca9d605739a2c2783,95d668c113d040a996a94e048aa33b1a,0,1,1,0,2
7678,daeac51d0c6142b892b602ab8ea0acb6,2018-02-28 01:50:15 UTC+0000,ee804621f9db4c2299849fdd0d3aa5f0,d8652da20e224e5ab51cdf8c9be43fd0,1,1,1,1,3
2928,daf45327733842428eeffd95142e9295,2016-05-09 02:41:13 UTC+0000,057772d0fa0a4ce0b541855b6714f512,58fa5e95fe9e480a9349bbb1d7faaddb,2,1,1,1,3
5034,db037cad09cd4b69b6352bbfcdc25d17,2015-05-15 03:43:25 UTC+0000,4a9db58c71a6448abb73c85816d63ce6,bd9cb8da82354687a865875b4f75a5da,3,8,0,1,9
4041,db0e9454e14847ed84e4cf87d0e21514,2016-05-15 21:27:55 UTC+0000,fa4c740f282f49cc81943eddec316b0d,e3529e64e70643b6889353db79eeea3e,1,1,1,1,3
2064,db12e506842b4d7998a4e7e4bf957e3b,2018-07-20 14:45:15 UTC+0000,b8be0026bdc34a4ba75bf4034c7b47e0,90a44c8e7a5848998d93a58f4b702a66,3,1,1,1,3
2712,db1f918355714ecf9e78691aca92dc9e,2015-10-14 22:49:51 UTC+0000,76af569b1e1a4b76bd7f4961e5ff71c8,c3c345b8e5044054a0544296ac29cb88,1,1,1,1,3
4050,db2f6599974c45c9a202ed88632e0d0b,2012-09-09 12:35:21 UTC+0000,bf4d40c908474bfc833c0d347ad5152d,b1776598991649088c0a00a6e0a2c766,3,5,1,1,7
6252,db32f95f6ee84ddd90b09361a55f9a5c,2016-10-21 17:56:28 UTC+0000,fc5926342682423bbb80b8442d2c909f,d10ff3b541fd40afb27293de3c178804,0,1,1,0,2
1460,db3c2a6593724ceea5440d6db7af730e,2016-05-22 15:13:12 UTC+0000,b1aa6c654d4d4bc58faa3019a3652580,6f2cc9f24a4a474a9adf385929abb592,3,3,1,1,5
6767,db507ff3cfbf42bf8b5b42bc5203d28d,2018-05-06 11:30:58 UTC+0000,0cbbd610397c44a497723f14c5982cca,36ff3b3666df400f956f8335cf53e09e,0,2,1,0,3
5153,db5add06262b4c72b68975068101abb9,2017-05-10 18:41:31 UTC+0000,87232773ccd04fa28801a178d2037d26,652d95ba96764818ae6d943df4c1b904,0,1,1,0,2
1355,db5c851e56594708bfcef146a48861f3,2018-05-12 23:45:20 UTC+0000,759d2c9a8a5c464bbb9b051ca25b0df1,a6d33c38902546849c36ea7e9e9f0870,1,1,1,1,3
4459,db68bcd4b1c94a99acd7794c2860e0f0,2018-11-14 17:43:57 UTC+0000,a52ac276ae8d4f1282e78f6dca2ad069,132c61e0b8e6435f96c0e2b9d872ef59,1,1,1,1,3
2303,db69a1a7f6564a44b5f3d65b0abf275e,2016-09-23 22:04:43 UTC+0000,133d249b72a74911a63fac87bf891ad7,d02f6d9faac24997a7003a59e5f34bd3,5,1,1,1,3
5481,db7525170a6842cfa67964153318697f,2016-05-31 12:37:34 UTC+0000,54a0c56ef2074e40b6632bad50ba033c,ff506465780c44b8a1a662517ca7b04f,1,1,1,1,3
3334,db83ca16a0024313b8ef2087d9ea2a7f,2016-06-09 11:10:47 UTC+0000,d7688ab18ab248d7af3631e0924930d4,de51e745b6354185a0ca5d02dc628416,2,13,1,1,15
7176,db86fd57ca7f4ee783a3ace05a19e6f7,2016-04-29 07:21:57 UTC+0000,8e20df5082c4492389541c6563bbff1c,05444a2f42454327b2ac4b463c0adbe0,1,4,1,1,6
5075,db8b89ab8650427194097b0e364a41b9,2014-03-07 21:41:21 UTC+0000,6b70b4c22e2042b48e087fa393f247ba,05444a2f42454327b2ac4b463c0adbe0,2,6,1,1,8
258,db9cc99bbe1a4d9981789b6bba85d993,2016-05-29 12:59:13 UTC+0000,d6832df6934346a186a92bfba7be3db5,58fa5e95fe9e480a9349bbb1d7faaddb,2,3,1,1,5
7897,dbb614978b30412faa2fd66d704f35c4,2014-03-18 21:44:42 UTC+0000,4ff38805a916485291e8279552f81971,77a65aed859f4b11983cd07399f1e3b1,1,1,1,1,3
1952,dbbe6141819b4bcb82ce8f5f2fa3d65d,2018-06-22 11:48:51 UTC+0000,e4757bad75a54733a356d505c242061f,36ff3b3666df400f956f8335cf53e09e,0,1,1,0,2
1878,dbbfa34393e842658e3cbbe8779b31ee,2016-08-15 17:11:04 UTC+0000,75246a9b30d245128ea3b2195848215d,815d84be0fd6415d973670eba29a69ee,4,1,1,1,3
6458,dbe9a0a7d2b7498a8b257bd346ceea68,2014-05-12 23:59:35 UTC+0000,39aa3e5247444c32bdf8cccadad4d790,05444a2f42454327b2ac4b463c0adbe0,3,1,1,1,3
4873,dbf1c47654fd4100867b1ba3ceb19bb9,2016-05-25 17:41:22 UTC+0000,ed0a84ecbc4045809eb004bfaf2a6c41,cf7f562e3b024eca8cbf346d5186b53d,0,1,1,0,2
1644,dbfb977e78cf4500a048dbf276ab061f,2015-09-25 20:01:51 UTC+0000,75e1d9a271444267968936c0446b2512,a1006e6a58a0447592e2435caa230f78,0,2,1,0,3
5892,dbfe0226066b400fb1bc50566cb5d500,2015-01-27 03:57:20 UTC+0000,2c66db5b42bd4591b4f40bcf8b0b20b3,4520f122d31241f6b83e3606ae3a1922,2,1,1,1,3
862,dc0a49fc26624880b50cceb3674ab12e,2018-05-02 12:03:58 UTC+0000,942dc39531684b1faa87741eecd4f8ab,19b72c6107bc454eaf0785f177f39603,0,1,1,0,2
1729,dc0be635d40f477f8cd7869d3ec6c4ad,2014-04-29 17:06:37 UTC+0000,28cdf880a1d94a99804f7716b3c12c2c,4520f122d31241f6b83e3606ae3a1922,2,2,1,1,4
2277,dc0de085eb494642a34dcd70831cbf4c,2017-03-07 17:40:47 UTC+0000,28370968264249d09470696ce1b2b3e7,369f1c8646b649f6997eae7809696bd5,2,1,1,1,3
3658,dc15a0dfa1a949cfaca3467ee9855969,2018-01-26 00:21:34 UTC+0000,8ad4d30c52a94101a491a70fe333c023,887c5a142b42466fb74740d72989fc74,1,2,1,1,4
3345,dc2829262320410ea72ddb75ecc29c54,2014-04-22 23:12:46 UTC+0000,e7fe6b55b5554b0cb73e508417e51972,e4e7cc05a0b64cd6b02168d404a45d4f,5,4,1,1,6
3181,dc44a4b756c049d3b75eb3c3d4b0bf11,2016-09-20 07:01:34 UTC+0000,e503362878634c3c8da25bd5f8d8ecfc,9d3ad4a464a64e99925341d617ce647c,0,1,1,0,2
7451,dc46d19dafa54cb89ad184115720df51,2015-10-09 18:40:00 UTC+0000,5fce3e285bab4683b16ce0babbb00f60,5743b7ff52704903b7b222337a5dee62,0,1,1,0,2
3868,dc487afe16d140b9af28c1c50ce9fe9c,2018-01-29 00:05:15 UTC+0000,09a92f163784451ea15410867aa4cd0f,23dce13ca6164a73aec7a3cd56a4884d,1,1,1,1,3
4202,dc4bea08b7194c11af5de735efb8683d,2015-05-08 18:41:39 UTC+0000,c5d57e84313e4d8c9aa4b2b3cd1c7ddb,369f1c8646b649f6997eae7809696bd5,1,1,1,1,3
5720,dc55ce6cadda4e818a45b1dab1681e34,2018-01-26 20:08:58 UTC+0000,8c9e2f5c92ef4d10906c164596bf6843,9a1d143c7f604d04bafb35117a4d3c84,0,1,1,0,2
1932,dc793f1e565f45ef97e88d4ae48efe67,2017-03-09 15:46:46 UTC+0000,45a6a714be684585ad613439d2b00bc7,bb4fe08bb5424f08972927d90bad9642,0,1,1,0,2
6309,dc7f21add1224e20b5207abe34bbaab6,2014-04-07 20:02:54 UTC+0000,0eff1f9e54244e8a844e6c2a58043f12,2cb7cd6a004747c1b4b8043085882418,0,1,1,0,2
7039,dc9e4b2e9e01478984e03d63c2400b47,2016-05-16 17:26:57 UTC+0000,c4a6431911e7407aa7db598d26e94c44,944d15d51a3445c3873dff371c1c115d,1,1,1,1,3
632,dcb735e07a9547d7a7c948f730971ae0,2017-02-13 18:56:31 UTC+0000,1d902bc71e8940c6a7e5a2575120f4d0,f1cc078488fa49b2827a9671ab1cc582,4,1,1,1,3
1506,dcbb6ad4eb0840329f1747fb3a10b1fe,2012-10-01 20:58:37 UTC+0000,fead5429ccd14d14a66b8f54dea53228,7d425e8d7cfb4fe7b0702fff4d6d84e7,1,1,1,1,3
5258,dccbf107943f45db87405869f4835941,2015-09-16 12:32:41 UTC+0000,f811ea11ef2d48d3acccb44489e5bd09,a1006e6a58a0447592e2435caa230f78,1,2,1,1,4
6727,dcdaed31452d488f89f2b7002daf5fa5,2017-11-29 15:18:15 UTC+0000,05f516325f2845dc94458b20a770a739,4df3db7955fb4052a6cb2ade9009d940,4,1,1,1,3
6553,dcdd20ef60804219815b521e5b0a041a,2016-06-23 10:33:24 UTC+0000,dc06d7bf83b549a39b1230be852bd5ca,7b6f34a016294760bbf23848c0a8a0dd,1,1,1,1,3
6953,dce1312e07b44d56a5978228f7c6397d,2016-06-12 21:56:06 UTC+0000,10be22882d5d46428d9f81bda40dff6d,58fa5e95fe9e480a9349bbb1d7faaddb,0,2,1,0,3
1084,dcef6f036d954eaf8c2c4b2d10d7a4e2,2019-01-05 00:19:07 UTC+0000,c41ab4b10725458494525205a850df65,d4f48324ada648e79d5d774a25906fe1,0,1,1,0,2
52,dcfce29fc7344ebda78952851652cbad,2014-11-21 21:58:02 UTC+0000,da2f920f2bee4e06933abb31fbca462c,b688e766eed04a37b7abc9218aca1ce4,0,1,1,0,2
4689,dd1c51ecf86c4747b37da245fe0ed7fa,2016-05-13 18:43:22 UTC+0000,9133f1d29e9549fbbda8294cc175b7c3,914aaa31bada4f3b878ba78e0a76ccc2,1,1,1,1,3
6873,dd313449172442cfb7af524031f88521,2015-04-07 19:32:22 UTC+0000,01031a3081b44b939a9d502cd9491673,4d7e991955234eba9515077915bf26b6,0,2,1,0,3
955,dd363c09e4744c4b977499f215289b35,2011-10-18 17:25:03 UTC+0000,fa30fe4c016043e382c441a7ef743bfb,392a273cb57b42389ec01a8fcdaff3af,0,1,1,0,2
4949,dd3cb43780d24a00a884ecf6d3c9780e,2017-01-25 15:03:23 UTC+0000,0596fd762cf247f3863990e535e53bd6,69379a8ec011448d9c14501a7f44d55b,0,1,1,0,2
4135,dd40b810406f40a28da9380e61e82f8c,2017-02-19 16:19:48 UTC+0000,f2693d152afa42c7b30043e6c645a780,faa0fe0510804c4abeffc171acf37ba2,0,1,1,0,2
2942,dd572299e4ca4f52a84414eb0407ccde,2017-05-19 13:02:03 UTC+0000,acc158bf438c4f0d8bf146daadbdc641,b1759ef11fcc4fa2ad9a58f4d9d9b52f,1,1,1,1,3
2288,dd5f49f09db24b0482b311aa61744438,2015-05-15 20:32:26 UTC+0000,ca7013658fd243e49dd94f85c929faea,4bf1020c28714181b8d47bdf4246f134,0,4,1,0,5
5522,dd70959a119f4c6a8e8c32c302441fea,2016-12-12 21:18:18 UTC+0000,b828d4e3883d4d5fa96dd6b05b3d284d,ead34fe989d9426fbe214db2cc3cb08b,0,1,1,0,2
7069,dd71db6e5a724e019f385a702fde87d5,2017-09-03 23:20:38 UTC+0000,000535ea5b584a1195c1dfe34ec16d74,081767c168eb4961bd16e8818fa5cb1f,3,2,1,1,4
2610,dd78646277de4461970f7d4acfcc5972,2018-05-29 19:25:01 UTC+0000,9e22c637ec71464b91a4fb226e278bd0,be5d23056fcb4f1287c823beec5291e1,0,1,1,0,2
1454,dd809065b38d4fa496b841e0be0c2910,2015-12-10 22:26:18 UTC+0000,b81e1c67f99d46659dcbe4043e7da895,f500d3cf13de4eacb449f63f758cbf44,1,3,1,1,5
3289,dd821220c1664aa799866ee0eda60e10,2016-05-13 22:21:58 UTC+0000,c6e7d80e30494f7b81a4fd668cdf7e48,7667c23d26ab409ca3e49758f5367925,1,1,1,1,3
5421,dd8b2dcb4ee2442eb4d433b6606b4d6c,2016-10-24 15:20:55 UTC+0000,9ea542621e3a44cabd78466a0e531d0c,3fe21cc053c54f279a93d933c49bee40,0,1,1,0,2
2789,dd9593ef118041cdb2fed1a9fadffcd1,2016-05-04 16:53:49 UTC+0000,ab7a60d6d151456fa60ba485a321d7e4,44ecf414c6914a82b2b7bdd03db2f59c,0,1,1,0,2
7786,dd974bfec32a441fa5a55e2453802a0f,2015-03-19 13:23:37 UTC+0000,6943b9aec95c469fa580b6f81af3aba7,436567896df64497af006b406ecb1605,3,1,1,1,3
1534,dd9daf635c1c4cd3acb1695e31bf4ef4,2018-09-10 00:15:15 UTC+0000,432e6a31d81948449854ad564451c870,36ff3b3666df400f956f8335cf53e09e,0,1,1,0,2
2734,dda61a7442ea4d849dc656d5808435ca,2018-03-13 17:20:02 UTC+0000,b5dfd99b8bd14e848ef59f1124bef486,6938283635004fe49961bf8c64f6bb43,1,1,1,1,3
5419,ddac29c9342d482990cea054fbea96e4,2016-05-08 13:48:22 UTC+0000,caedafed961c42df8983ffeb2e04060f,58fa5e95fe9e480a9349bbb1d7faaddb,2,2,1,1,4
6534,ddc652c9749c49a0a90b84f8739b61f7,2014-03-18 03:20:24 UTC+0000,2a5cc6c4185e4e599f34013b3d01ba6e,05444a2f42454327b2ac4b463c0adbe0,0,1,1,0,2
7448,ddf4482984224aae98c92f23efbbcfd6,2012-10-01 20:41:36 UTC+0000,947aed51104c4fc6927b8b976a23daaa,624194ea296c49a6a8ef1180787476dc,1,1,1,1,3
4635,ddfe958932654f1a83f7c1157a0b3d1a,2015-02-20 15:01:43 UTC+0000,2771a4d90b9b4c8bb1323016908c1a14,369f1c8646b649f6997eae7809696bd5,0,2,1,0,3
2898,de0cd14f51cc4976a2d33bced2f5e0e6,2016-03-01 19:18:46 UTC+0000,066620227fa24b3385adfec8898f3f1c,d2404757660342c3938b0f10c2c4c148,2,1,1,1,3
2993,de1221d1880444da8e205dbdae32dc1c,2015-06-05 18:09:22 UTC+0000,ab067865d588433cb56976ba228c6e8f,369f1c8646b649f6997eae7809696bd5,0,2,1,0,3
1946,de12788791e540a48ae47566e328579f,2016-07-06 21:48:40 UTC+0000,b4639f42a32e45fabfce8e511fef7e7b,35dd5ef6c7fd43188a001e9acabdf948,0,1,1,0,2
335,de140e000091496a8a6c1c8a5dcdcb82,2017-03-10 15:51:11 UTC+0000,9923ff09bd3a487582f89a941d464173,9a1d143c7f604d04bafb35117a4d3c84,3,1,1,1,3
7370,de19e9235a6e498d9be6fd19dab7f983,2016-08-21 00:35:52 UTC+0000,e0f9f800cdf44d568d20e84fb3cec56f,58fa5e95fe9e480a9349bbb1d7faaddb,1,2,1,1,4
2979,de28485509fb436f9c170aa24abf6fdf,2017-12-07 00:00:52 UTC+0000,9a7b182f4a1b4dbbac232edecca787d6,4529996786334bce8b0bde08fa24476d,1,1,1,1,3
5571,de29115c7b0e4bd5bf3cb7d264a5b650,2016-11-09 23:10:51 UTC+0000,e2f5a52d59e845108b6ab8aaf1072df0,ee531ff603254ded86553946b98156fc,1,2,1,1,4
1353,de332caa696b415ebd3e799fc7db160f,2016-05-02 23:13:22 UTC+0000,12bd0c9fb9244565a3528afdc37b1703,8ebcb4d6c0bf4526a3df1cf3848feb41,0,4,1,0,5
6324,de374d86ec0e496ea571b636bd683b16,2016-05-22 01:04:54 UTC+0000,1bfc341965444fb4b35f9944955b176f,460c189dcd074de0a7dd7c85606eaadb,1,1,1,1,3
5025,de3aa9e9aba14f79914e9783ab4f897a,2016-05-17 22:36:33 UTC+0000,108f02d182774329a3bc37ae0cb1201a,a488b31881134e9e8a607dcb03fac41d,1,1,1,1,3
3390,de3c5591dcf24b229eec2af9a5bc7fd2,2016-06-24 16:14:42 UTC+0000,52d79ed932e84f72a382ed877244b52b,58fa5e95fe9e480a9349bbb1d7faaddb,4,5,1,1,7
1423,de4131944a9b42789b259aa20ed48083,2018-03-15 20:27:30 UTC+0000,0163f2ada9f143d582df8ed006993cdd,2184b3982393494f9dd787b6ec0e18f8,0,1,1,0,2
104,de4e9a20a02242cd85de5aa8d3002141,2018-09-03 15:50:39 UTC+0000,2a6400ea2e254333a0c190d34e750cfc,9fc88a7c3323466dbb35798264c7d497,0,1,1,0,2
4814,de5df11e94224fc69cc1f02ae504fddd,2014-09-17 01:02:12 UTC+0000,82e627437ce34d2384e3aae4cf83cd48,fe4543418c0846e5a65fa22b4ad9a304,2,1,1,1,3
2027,de61231142514073a7b3aa61bdfd2c26,2018-01-21 05:38:39 UTC+0000,81d5df8f21ff46c48d45328940fbe1a6,be5d23056fcb4f1287c823beec5291e1,0,2,1,0,3
2932,de81a5a113d34bb691115978d7e39f2d,2016-05-24 23:19:23 UTC+0000,5c4018b4a0174fe684a6d8caf4952670,6663732dddf845139331f83565ed51f3,2,1,1,1,3
4959,de8e019178224fcdac6b1ba29535a2ff,2014-03-27 21:13:22 UTC+0000,04d10e1d2fd142af85c936ba6431741a,13b55ed4834e4814bb33a4c87001063d,2,4,1,1,6
2420,de941e10091a4da681f2ab6e703af130,2014-11-13 21:34:14 UTC+0000,cc1df2a2c4fe4bcab8ebf1ca07e0d41a,0355aaad83704ad98e6d71b79db85849,2,2,1,1,4
7718,de974926daa84671b5a4880fac62b1f7,2017-05-02 00:35:47 UTC+0000,b0b0c318d7024c24894ca574b4a8b006,b0376b390354402aa04c9958e99c0d66,1,1,1,1,3
3852,de99ea42147047a28079efe748bb9286,2017-05-30 19:32:27 UTC+0000,9335625d36ba473583e0385eb0325397,13b55ed4834e4814bb33a4c87001063d,0,1,1,0,2
2565,dead03b6dcce44cbac23ee9efc2a9348,2017-07-07 16:48:03 UTC+0000,f666cd866b994999b8a5c56b372d694d,bae760919c864ccf8907686630924d55,4,1,1,1,3
4424,deb1c6fcf6614aef816e3c3d433729e6,2015-10-24 19:47:39 UTC+0000,11d9250b974e4ec0a411ebd6a45666bc,8864cdcc69b545c0a034722c58a1cd9b,0,1,1,0,2
6111,deb5f532fa754ba8a991cabb5f7f7aa8,2016-05-09 13:24:25 UTC+0000,99cfeb83f78a4f118a813a34e0c1e16d,ace45cfd0a8f474aaa5228df56dbe3a9,0,1,1,0,2
3348,deb6ba9ab49b4f0f8f519fa62a2699bd,2015-04-07 14:10:52 UTC+0000,b55b4448fb284b29a6380337730a0c27,ba5cdfeb591441788104f31fca40d5ba,0,1,1,0,2
1587,deb98c6f837045e0b69705c9f0dd2c73,2015-05-19 15:40:24 UTC+0000,f42352cc568e429eb6480804fe2fb225,6458180042064606bda4ba880747ad5b,1,1,1,1,3
461,dec67ae824ab4757b016ca189aa02b7e,2014-03-04 19:59:40 UTC+0000,038ee63d913a4b0fa64896f1e9c1b5e8,79b841ed883c42c8a943f673a161f097,2,2,1,1,4
7833,dede8c3437454091a636b5d7eaeac75f,2014-04-29 16:33:51 UTC+0000,4bbbed83683c4982b4deb9f2120c7ff7,05444a2f42454327b2ac4b463c0adbe0,3,6,1,1,8
1837,def7703fc4154443aaf2298e6f8b3b0b,2016-06-24 06:04:37 UTC+0000,b76dd1f9deb24a5b873adfcc90b0e272,614ba4c0aa534b759b73e8473fd5ec88,2,1,1,1,3
7265,defa9f6ceac240ad8de6b2e4a91a4cce,2015-04-03 13:47:45 UTC+0000,428a2b5af14a4d038c9d2cabb8325609,fbcc3736b611439fbf22e6ad73a1cfcd,2,1,1,1,3
2390,df0b0abc37f74b05848dfa360245184d,2016-10-22 22:40:00 UTC+0000,39cf88c8de084a739cb17e6786dd914e,12e8dea2f3534f6dbc31701cf64f9a4f,1,1,1,1,3
688,df0d1250d778403d8849afb10dd6f741,2015-04-03 14:29:13 UTC+0000,be04c6bf769e422990d273aa1ef8b74f,0895796423534563adcec1c208e9e0bf,1,2,1,1,4
4464,df577208c4de4ddb84e598adcbe9f9fa,2016-05-13 12:35:05 UTC+0000,ccdc11ea05ca4e7eb76b6b6a07b21eae,de043e5d7ec64049ae3bec3ec29f2338,0,1,1,0,2
7337,df5ecdd436434c13ad2cdaa644681e64,2016-05-13 16:38:59 UTC+0000,696fb2a8ef724d73b7a72442d3339107,6d15a722012441489d7ddf6c8ad9dbc1,0,2,1,0,3
3608,df7d6bf0ce5f4535978ca23e3433b5a9,2015-05-22 16:01:26 UTC+0000,6b57ac2ab961457d853113a17d6037d8,e3529e64e70643b6889353db79eeea3e,1,1,1,1,3
1059,df8a16a3b7714b2caee473e33c989e60,2014-03-05 20:29:24 UTC+0000,8d3393e1b0c64ddcab1e261a5e385906,a81daa728e2a4894b64cd79f7beae61d,5,5,0,1,6
4862,df8c9d7a0fe048fb940623c026777a1a,2015-05-22 18:09:38 UTC+0000,ba37ddcfee754db58e260b10d549afcb,83cfc4f44b9d4fef8cb95530319d8b53,1,1,1,1,3
5380,df8e21936ec9460ea467da69257ccfcb,2016-04-13 22:23:40 UTC+0000,f02e2c18b6a24e2d889eb4e57e6406cb,a1006e6a58a0447592e2435caa230f78,2,2,1,1,4
4610,df93f98aff2747deb82566a6163c0548,2016-12-28 21:27:43 UTC+0000,b8fbcb61308947bba4e412ebd66e6c5a,dec5ebc4cca44bfea26e90072b17ae3c,0,1,1,0,2
708,dfa2fddae88e4c388b5af847f19992cc,2018-01-25 00:23:54 UTC+0000,95f58f1851e3466a93975126f5e07df9,e658a2ed212041e897347a66ac2db5e7,0,2,1,0,3
4104,dfad3fbf71574a03b9a47ff6f528f14d,2018-04-01 21:25:34 UTC+0000,231c0097c9cb4e908a79fddcd2c498c0,be5d23056fcb4f1287c823beec5291e1,1,1,1,1,3
6466,dfd089e2bf304a759d84a468091f3682,2017-07-09 18:48:15 UTC+0000,c26afe41fce64749b3b47604fedf45fa,7436b0250000405aac5ed212e4f5fd1f,1,2,0,1,3
3573,dfd79bb3d6154331860d6137036e96f0,2017-01-09 03:39:08 UTC+0000,9f501cefb2ba403c914c4f2433d7c6ce,65475d7bfba641c1930f80032b403575,0,1,1,0,2
4457,dfda4997fe494f26a336fb9b28da1453,2017-01-12 22:23:42 UTC+0000,9b62cf542cce41d8a49ba3f7c3592f1a,36ff3b3666df400f956f8335cf53e09e,1,1,1,1,3
2326,dfe23a5f75f142338c40dbf84ec76a18,2016-05-25 22:56:17 UTC+0000,e19fc16344d443e3b1f364a3b01ba860,36ff3b3666df400f956f8335cf53e09e,1,4,1,1,6
2237,dfed4b098661409ba121dd3f02d577d1,2017-01-13 21:15:30 UTC+0000,5a1b75dc90814317abc0c4782fab7141,9496418c2b6a4c059442c81cd73d55e1,1,1,1,1,3
4057,dfefb4a835354ab3ac7821d97ad71eab,2017-05-31 09:12:52 UTC+0000,0e4737aa8158440ab83f40cbfba391ae,8c5ea269b4dc4b60832832a3755ecfff,1,1,1,1,3
6790,dff11d96361a4f84a0c2ee54dc1d4c21,2016-05-15 23:50:36 UTC+0000,cf6e36cd174e499688c6fc2337b5b14b,7873744371da478f8d24242468aa1b3a,0,4,1,0,5
7395,e00037909b6347fd8de27328ecaed8e1,2015-11-06 15:42:55 UTC+0000,0ba052a5a3f64febbdb442337f6233d6,3c478443b2de4f349e98abb25fa347ee,0,1,1,0,2
3936,e0013f85e2b24482a17be22316d194c1,2018-03-06 17:52:21 UTC+0000,ecb8dbb1424747338de5847a31811c2c,5fc76ec033e2422baefbffa8183d0b30,1,1,1,1,3
4849,e0199695c896455cbfa94e8308c84fa9,2018-08-25 02:23:22 UTC+0000,1399f1fa820149ef80e4c39c1d18a825,36ff3b3666df400f956f8335cf53e09e,0,1,1,0,2
7165,e025b0bd96e641cf85a5a5dcc9a4c25e,2015-04-27 14:33:01 UTC+0000,d44a4f3f484444a58e42bbd8966f8609,851529c3f8664de4a5028e8312fe3488,0,1,1,0,2
4764,e02b5ea9afce47469c14e436bd469b68,2016-05-21 04:18:44 UTC+0000,70c156dafda5425cb356aa5d0ea38234,04df52cae7db418faf5f9b285799ea5d,0,1,1,0,2
397,e042de3e274a49d8827bce5e167ce746,2012-01-06 19:34:08 UTC+0000,1e1cc6a8dbfd4b4983689d1c8317364b,b1776598991649088c0a00a6e0a2c766,4,1,1,1,3
143,e043a1ca27ed4110b2e4bbe15e6fecb0,2017-02-26 03:09:36 UTC+0000,4b72a86cedb8405593264f18f4adc054,be5d23056fcb4f1287c823beec5291e1,3,4,1,1,6
533,e054caef2cf34b16a05a798a9b1e3e60,2014-03-17 03:52:12 UTC+0000,db206d4df51e4472b0fdfdafe6239293,23b6df4d73fb4d9bab3eafb6dd8bfb86,1,2,1,1,4
6692,e05d49a06e574b16937150b0b6fc1f91,2012-01-04 02:09:21 UTC+0000,206b36b3f3a7454ab8438068a196381d,07cc545a05c14547927bf38d86dbea0b,3,1,1,1,3
6830,e05fc9df405d4898a9033c3f01b2d0a0,2017-01-31 02:04:40 UTC+0000,f940079d9fac4fb7a82d99a5faf4bee7,9b2764462aee4fd7b615dc79aa77855a,0,1,1,0,2
3250,e05fdff4e1034a989f7e5ba1ec0e41cc,2014-04-09 19:46:57 UTC+0000,2d54dffc7b244d09a7ca076629d2c241,04b72521eb474b8bb79f7bd95e8b637a,1,1,1,1,3
2100,e061ed84f369473b89f8eec0a2b2f1a7,2017-02-27 14:27:55 UTC+0000,e2dfcfe762724ebca7dbcb75cb34521d,9610ba7903e84a04b25b38515609643f,3,1,1,1,3
5131,e073edf4f57b4387b9a2dc8b78503efb,2017-10-17 15:34:02 UTC+0000,492da4bd59bc4b6aa858f5ce7e12fb82,b25b37b931f84c588c38d7225ec31dd5,0,1,1,0,2
2157,e07b125e027147258ae92d9b650cf48e,2016-02-29 14:29:12 UTC+0000,18ff3671751c4a9c81db53704761357e,c5c8f72130f543d8bb487fe5238455b6,1,1,1,1,3
3557,e080f3c297314c38ab59894b98fb9d99,2017-04-12 19:44:08 UTC+0000,ddfb1ff55ecc4bd0837f40d6fba47355,7e425accf80045e7b9ff890a3a78b10a,1,3,1,1,5
590,e087440679484596963c83adb0b6e621,2018-04-10 08:02:07 UTC+0000,66351fa034894dbfb5370c713416e297,744d033f7eaa4fa0b378a15aa010324a,1,1,1,1,3
4422,e0887ea1737c49f1bb4d719659531206,2018-09-19 18:27:45 UTC+0000,739e4f5d44b9407a98cd2a8c4db12da1,36ff3b3666df400f956f8335cf53e09e,1,1,1,1,3
526,e098b6e332fe43c6a5185d2cad953ae8,2014-04-23 14:03:11 UTC+0000,9d485197cadd4a659915f2dd53bddf80,05444a2f42454327b2ac4b463c0adbe0,0,1,1,0,2
6453,e09a6fe9c48a4fb38216029d3aea703f,2015-10-21 02:55:26 UTC+0000,b4e4216827df4fa7a3f5f9328e4d60d4,e3529e64e70643b6889353db79eeea3e,4,2,1,1,4
1757,e09d7ef793ec4e9fa057c536f6b5fb14,2018-05-10 21:48:43 UTC+0000,4d5da17fbe21435c8db9311fad0796f0,36ff3b3666df400f956f8335cf53e09e,0,3,1,0,4
2168,e0c2a4b991c442ffa70dcdc1cfd2aebc,2014-03-24 12:32:54 UTC+0000,ded8016d61c944b490927e866e7547e4,6877d790e8e04303916865c406ec5202,1,1,1,1,3
2351,e0d3a0cad5364633aa4a93137613941f,2014-12-03 14:56:45 UTC+0000,52962dc0c32f41dba9280c01d6c6d994,7d425e8d7cfb4fe7b0702fff4d6d84e7,4,8,1,1,10
5709,e0f0f2cb57254901ba8507c88835765f,2016-07-29 08:57:22 UTC+0000,9d24c6af61154cbd941d581e2550db43,bcdcb395d92a41458d11a43a7d265969,1,1,1,1,3
2216,e0f2717b58a549be9781ee8cc10b17e9,2017-01-20 14:51:44 UTC+0000,220fcf4640a54f15b2a2ea6e72a0e32b,369f1c8646b649f6997eae7809696bd5,0,1,1,0,2
6843,e0f4375183424d918bb431bce51eb9ef,2016-02-26 20:32:25 UTC+0000,694e06416fbc478fb0b8efef2f02c293,1a49821dcc314d9f93f3e6711f7a3cd7,2,1,1,1,3
6412,e10bdd490f524ca28ceafcb75976dba9,2017-01-12 21:59:12 UTC+0000,c9bd3b7d2a0447409fdf62e2ba8f578b,36ff3b3666df400f956f8335cf53e09e,1,1,1,1,3
2126,e10dccdbcc1b44f4a93c4551d0cf9405,2014-12-05 19:13:44 UTC+0000,7fbc74ef98ab4231a6b6b4b9f54c0e87,cfd777ed4f5a428fbe28e76e06ab858b,1,1,1,1,3
6492,e117021e479b4712b1cc6ea4df30f10c,2016-04-01 21:30:47 UTC+0000,bd04ba9c9fb642e7a7d82cb84ad965e7,83cfc4f44b9d4fef8cb95530319d8b53,1,1,1,1,3
6383,e1174d7205d8404c973d88d6bf7c8f69,2015-05-05 21:01:15 UTC+0000,092b4c1ff9fa4d58a56cc2b1e1bc44b8,13b55ed4834e4814bb33a4c87001063d,1,1,1,1,3
5899,e11b21ff6b7144e18939571b63b1bf0e,2016-05-07 16:36:40 UTC+0000,cea5d02e368647a286bc29b258aec457,7d425e8d7cfb4fe7b0702fff4d6d84e7,0,1,1,0,2
5412,e11be153542f4d4fb33582e9fea5a824,2016-05-29 01:39:50 UTC+0000,b39748a3875347f98ee821fa0f62a3fe,58fa5e95fe9e480a9349bbb1d7faaddb,0,3,1,0,4
1838,e129f5f3ba114d9b99263093103c0a2e,2016-04-26 21:25:20 UTC+0000,5fcb360e34554f429366d10272278b06,8e78b562465a4a95876986373c493edd,1,1,1,1,3
6444,e12c83c7b0594fbf8922f3faa51dc45a,2016-10-29 06:16:21 UTC+0000,1ab0ca93e3f0490a9adbfbe7e7ecc2e6,0f32136b796848f59eda325a18be8449,1,1,1,1,3
931,e133a5fed44e4149b1c14ed5344471db,2016-07-05 19:34:38 UTC+0000,fff815408f24444299f88b0f7490cd21,592fee329e344bb3ae973925cf531a2b,1,2,1,1,4
1471,e141fa11ba244d9ca254f8cc7b9dc4d8,2018-08-30 00:37:53 UTC+0000,fa35961041884ba38272d9ce5d4fb8d1,a2a3490912f9435b82172850e907c1c7,0,1,1,0,2
3372,e1434c560eb04ae39bae9a6f753da656,2017-09-29 15:41:45 UTC+0000,5752d79db1d5439fb6b64ff20d9ab047,ea6fab7c12d543bd9a2647534e45bacf,2,1,1,1,3
2716,e14cb205920f46afaff7a9254d95fa11,2018-08-23 15:22:21 UTC+0000,9437f3787c804829b84ebc16076c23a5,5ee4344b0a0849069a65fe471bb4d463,0,1,1,0,2
4617,e15f6de0f3e841e2934de420ecebac67,2016-05-26 00:27:39 UTC+0000,55322191a19f47c18dae4068921ce3f7,06eebab6ea4f421daa1c7ebfb4467021,2,1,1,1,3
5758,e16d777c0d134cc399d654b3f7b2e20d,2018-02-08 18:43:36 UTC+0000,ecda0e453e384359ab9ef1d851559db8,bc46e3699d92477ba8c7aa723e54a151,2,1,1,1,3
4318,e184549a832647f2a17ee2909d4938cf,2018-04-18 22:48:32 UTC+0000,d9f15bf30c4e4af78df7f5c2b2894035,4dc61581ec7b409bbd037e483f53ba0a,0,1,1,0,2
6274,e1860d4512b746a19270e5675efb7b44,2018-02-03 16:34:52 UTC+0000,9d4c7dc806134b54ad7afc193dcd60d4,7c06f09b9d094b708ed15fa6da796959,2,1,1,1,3
2029,e196557eaf054f688abfa1bc6697d485,2016-12-08 10:04:33 UTC+0000,9fe888343e5a420db7b9c596b8ec2743,a1006e6a58a0447592e2435caa230f78,2,1,1,1,3
5276,e1a088e219a54133b1561f08dd176f6d,2018-09-05 20:42:16 UTC+0000,a7bd662e92e6489f87901dc40936e76f,c68ff645a9974a5f8484c2f2ea4d56f3,0,1,1,0,2
2615,e1b398bea33845b6b1e122d4848ef153,2016-06-08 20:21:15 UTC+0000,203f0f23b71f4c31b7cdaa8d981294ff,4dc7d9040592416f98c0bef1ad2c31f5,2,1,1,1,3
7612,e1bb1d5406da402ebd4f81ed5781f523,2016-05-06 14:56:17 UTC+0000,ee737890bca4445395a255d1cdb23874,5611d52913a8466c8f5e5b80b6c48dbf,1,1,1,1,3
7153,e1c31bceefb94f8e8dbc362f7d84c322,2014-03-24 00:57:44 UTC+0000,c013fccd01354a61837037eedf6d4c61,cd33fd35feeb42c8a8683c74dbe0894b,2,9,0,1,10
5618,e1cb52474725474da7df8ee9783533a1,2016-06-22 12:47:19 UTC+0000,d9ad1bc5b91b4675996d69c3a355335f,ff506465780c44b8a1a662517ca7b04f,6,2,1,1,4
5175,e1dff1e41beb43bf9f64f43a883d9231,2015-12-28 16:12:40 UTC+0000,7882b2a1783940e2abf1c425b398ff31,a1006e6a58a0447592e2435caa230f78,0,1,1,0,2
2614,e1e2b4176c3c42e99ee458dd75b8e1ee,2015-03-20 00:17:58 UTC+0000,0cbbac5889c944ca87c1c206582177f6,0895796423534563adcec1c208e9e0bf,1,2,1,1,4
3158,e1ecbcd6d4dd45f785432a01ca2ac17f,2014-12-08 21:39:08 UTC+0000,44e77bbf58ac4020a03163d5636f55e9,60bfb575b826434b84eeaf578854696c,5,3,1,1,5
5071,e1eed97ddda345c3a234218e2c7a9846,2017-02-05 19:06:06 UTC+0000,fabe6d5b81e2490494ef9090cbe9b3ab,926c156d54a44a1780332ba20efc9f8f,0,1,1,0,2
1340,e1fb0047ef84418abf7d836aef54810e,2018-05-03 00:47:03 UTC+0000,1c7f5fb419c0479c8dfe9feee4904453,cff9a9679be1434f93afd0caadea94bd,0,2,1,0,3
2475,e205d54570f04775b677a36fba4e76da,2016-06-15 16:58:40 UTC+0000,0caef3fecca74df98ada46d61b67e15b,36ff3b3666df400f956f8335cf53e09e,2,3,1,1,5
3038,e20a1070d0164c5389c208f9575f4062,2018-04-04 09:50:37 UTC+0000,c7dcc6c3ea154ac2bcd038c884df8340,a6d33c38902546849c36ea7e9e9f0870,3,1,1,1,3
942,e20d5ca6cc4d4b628731bcc568e0796b,2016-05-09 21:43:48 UTC+0000,c9ad983db191426ea2acae76f0ec5519,96bbbdd06a334805a0501034d9df1aa4,2,2,1,1,4
2,e214acfbe6644d65b889a3268828db9d,2012-09-09 12:20:48 UTC+0000,3d56d36b5e644d079d0d7ada4bdcddcf,b1776598991649088c0a00a6e0a2c766,2,1,1,1,3
7812,e21f10f16b894fedb6e312e1820886f1,2017-04-10 18:50:15 UTC+0000,645a9420684a4a72a52fd66a4fb57c72,ebb258d1c8b94a55a339bf610db601ac,1,1,1,1,3
5753,e2320824779d4a28926ecaa61a181a4e,2016-05-07 22:56:47 UTC+0000,bb339659ae604735a8652a32725e6a1e,36ff3b3666df400f956f8335cf53e09e,2,1,1,1,3
264,e233742470f64f28b0160a53dd1ba9c8,2015-05-20 13:45:26 UTC+0000,62a504f2a906410a8f9d1e22cd70ef1d,ba511944f6e848b6b5c1cd02cb41e4f5,1,1,1,1,3
7241,e236e8c5eba042819525cbf8a022aefc,2018-02-22 05:56:56 UTC+0000,9e5e634ba60744c58f7f5f44645c0395,8e7a93e0afa442e0bf63a3cb9824562e,1,1,1,1,3
3184,e23b0d1274934db19c9fc3e0cf140d8c,2014-04-08 18:08:23 UTC+0000,8a8fa77a7dbb4110ab0f7ebd0627bcd3,24fac8940aff427c848b2a59265c1204,1,3,1,1,5
5416,e23ff5959c964431b4c8494c0374c1a6,2015-02-26 14:14:39 UTC+0000,af792d06150c4afd8951b6d038fa2495,b953b3a5cd564558a13b7bbe04dd0fd2,1,1,1,1,3
6365,e25731a44a524652adb113a2e30d24a1,2015-01-19 03:22:46 UTC+0000,d3453c6bf73e4c629acb4786ffd7afd9,24ca0e5f210b40cf8d2af86016e8e050,2,3,1,1,5
6287,e260727524c749f7b0b0dd580895157f,2015-04-24 17:01:23 UTC+0000,cfb1ae08ae134316906b71fb32033dcb,ad7fd347a59a4e6384a18c26b022d50f,1,1,1,1,3
6513,e2656e09b14049a0bcd29606fd24ab58,2017-03-12 00:03:10 UTC+0000,9249bb0f275746298f7e1f45939ca2ff,8136c8653d3a4895b49cac90b88120d2,0,1,1,0,2
6122,e276642d5883427a888995900831d352,2016-04-11 18:02:41 UTC+0000,278737499d6d487e868401b5f64f8f1f,8d525762ada04f7abea2bbbaece94be5,2,1,1,1,3
3959,e278c3eb60914eb3b9dc6ff8179746c2,2018-02-06 14:45:00 UTC+0000,37e259478037496b87a070c8328ba10c,f1cc078488fa49b2827a9671ab1cc582,1,1,1,1,3
7191,e28c06a5c0dc407aa3b6b5d214cc9646,2017-04-19 02:39:10 UTC+0000,8c96bd23e6e34540905f1b9062b3f22b,53636d09137b4fe0b7c46e8269c48612,1,1,1,1,3
7507,e28ca3a636034d169a111fa8aaf26ee7,2017-01-03 18:37:37 UTC+0000,4fb917d0d2c14a529d3af0a5ada89d33,369f1c8646b649f6997eae7809696bd5,0,1,1,0,2
6147,e2910d92b19444a2b05d23345db292a9,2016-05-29 03:09:12 UTC+0000,871bdc2e671245439a9f54670c91de78,08f4c4808d8e4eb1b9b287cda01beecc,0,1,1,0,2
6370,e29202b8d2fd4f3bad4d4cc7399ee522,2014-11-19 22:57:21 UTC+0000,d261ef7d06a64b21809d1e7579e320a1,b937649594b7485c8e667de2011e3b76,2,1,1,1,3
2469,e2a4be92f324441f97adeeef18f466c1,2017-10-09 15:25:03 UTC+0000,05adc203545240b3b6bda24b15734e79,b8b77df14ad94e7bb64f14eeffb72d9b,1,1,1,1,3
7173,e2b8e102a6b24f8b9b2c255e041b5c89,2017-01-22 19:05:51 UTC+0000,fbc1ec8392df4f5d99715822b8c7255b,438d0eddbaa84d59a3bf5ca5056c90ec,1,1,1,1,3
7626,e2bc0bc6558944eebe7bdc40c9453270,2014-05-16 18:55:00 UTC+0000,561f7fa80a9a4851953d7888e3dce29c,ad7fd347a59a4e6384a18c26b022d50f,4,3,1,1,5
1980,e2bdaf6068354c4a8b8de981ee45eba5,2016-05-20 22:06:53 UTC+0000,4daf3881940f470db6ca4e7e7fcf506c,2c9a3b312d13455bb55fadf3c8d4b199,1,1,1,1,3
3545,e2ce2736a06444fb996867506a112099,2015-04-30 18:14:12 UTC+0000,49cacdd8c13f4637ae2d41695c5c48be,369f1c8646b649f6997eae7809696bd5,1,2,1,1,4
5601,e2d464ab13a14452ae29f73d9ffec662,2018-02-19 01:28:00 UTC+0000,aaff40ca0c994571b4d4f505427b1bc4,47906ce028d647549f135db8ebe3b270,3,1,1,1,3
4992,e2dd44feff07410ab47a30e91fe45309,2012-04-27 19:28:56 UTC+0000,2906ca8b6af74d739c32a8944022090c,05444a2f42454327b2ac4b463c0adbe0,0,1,1,0,2
4530,e30b23ed18cf4edab3b9b4e1fa393550,2015-08-11 16:07:26 UTC+0000,9e2fc1917a7e425d9bca614a7372189a,369f1c8646b649f6997eae7809696bd5,0,1,1,0,2
7683,e3266ae708554530b6c289d6d4fc82e0,2014-01-13 01:36:39 UTC+0000,f6dfda79f8ac41c4854139d2c7d7f863,05444a2f42454327b2ac4b463c0adbe0,0,1,1,0,2
7652,e32a0e68932641d08ef006ad0aacffa2,2012-10-15 17:15:30 UTC+0000,a3a1ec0675ff46cda33a41c736bf807b,8442ddfd38bc422fb4677785db0630e6,0,1,1,0,2
4004,e339c03e325c41909508881726260273,2016-05-30 20:09:05 UTC+0000,6564391120094cf6bc020bcadf14b60c,de8dd365c1a44e72a965df308cc4db4a,3,1,1,1,3
2970,e348dca0157c4ee682cd75d183b7a310,2017-02-15 14:37:26 UTC+0000,a2b7ec79d62643dcb03035078606c6a4,41b46910e62a433ebc6c5722bfddcf8f,0,1,1,0,2
6409,e3581e62e37d4f54a9553689b5d6c277,2017-01-12 00:15:25 UTC+0000,596dff75742d4ae3abe942a9939bb08f,36ff3b3666df400f956f8335cf53e09e,2,6,1,1,8
7937,e35d35cb63354e52ad7170aff3efc491,2017-02-18 00:38:13 UTC+0000,7fd61083049f4eebbbb96b24ccdfa2b6,d73c63b4d5be4da6816abb6d100a6371,1,1,1,1,3
3711,e35f162048074f4798cec7792563ce19,2016-04-29 12:50:24 UTC+0000,47eccdd13d9a45b1a4705b890c16f193,215b430910074aeaaf24538cee33e35a,2,1,1,1,3
3906,e363d394cf3e4021890c041c5f204c44,2016-07-19 15:55:47 UTC+0000,33e308b4f3244468a02ffa727397d2ff,b037355697ed40e687368bb233060e50,1,1,1,1,3
6952,e367782409e64895a480689880e313ab,2014-04-03 22:42:36 UTC+0000,35cd77dbf0a64dac86673399eb8388f6,97c796d58f794825b1a9ebd02dd96f34,2,1,1,1,3
2968,e368a0d6aad04549a70b039c0a5bcd1b,2016-05-16 13:49:58 UTC+0000,5d85a90faeba4142bbe2850cd9ef5308,81c4329d8d1c4f499575fcfa99e8cecf,0,1,1,0,2
5074,e369fb0b0d5949f89244573c5ecf89c8,2016-03-09 23:02:38 UTC+0000,5d505f7399d641f088c11735bd7c1750,15d9433982b242d9922714d2b31dcdc0,0,1,1,0,2
2461,e36df3260e4b4728af8fff6a3e0d2206,2018-01-08 15:29:02 UTC+0000,9bc97cfb0da54ecf9c567f0c125f141c,cb5efdb6742143169de54ee11b9eb314,0,1,1,0,2
4211,e36e583ff8d14795a0b5a91d014c1577,2017-04-09 13:08:08 UTC+0000,ff93cb2910214b499f29391aba63e13f,6899b4e2d03e43499dc480282e2c6867,1,1,1,1,3
7188,e383f39de2e54c4bb38723e0c540745b,2015-11-30 21:00:44 UTC+0000,f57e9d12bbb341a8b3ef9c012d7fcebf,e5f9bbec91ca4c5c82c7af021594e4be,1,1,1,1,3
3970,e3861e043373480ea86128a1ba4eda62,2016-06-23 10:56:36 UTC+0000,7bb7023cfdd04a03bbe94c77a9c70dfc,628ba982dfba43c0b6d692983cf5a3a8,2,1,1,1,3
6521,e38c8d0eb4304dec9806ca2ca6ee9d36,2017-09-29 03:24:37 UTC+0000,07f0921783ec4f6f8dc8ff1f50969b70,455b942a7bd9440b9119ce8a76ba405f,0,1,1,0,2
5823,e38ff801d75c4b068efa925273d53bf7,2015-03-25 00:50:10 UTC+0000,bf8ae203345147feb6c380b7e09996aa,9a0f09620c6640718c1792a74f3b8438,0,1,1,0,2
3910,e39368bb73024c378ef113e2e30d4638,2016-12-29 13:30:39 UTC+0000,80e60884eb814f4dbab02868487859fa,7919ea19db274c1fb862f3456cd25ac5,4,1,1,1,3
460,e394e0587bf14503801c45352bd7e9aa,2014-04-23 13:38:47 UTC+0000,7671b552199546128a0440b81ccee1d6,b688e766eed04a37b7abc9218aca1ce4,2,1,1,1,3
5524,e3979a1431924168ae929d6294fdfd20,2016-05-12 03:41:28 UTC+0000,dd89d898ffb64d23ad99f986db967535,805685d049444a2f87561943eb6e4c8a,1,1,1,1,3
6847,e3aabc325b724d14babe057c3d398cb4,2017-01-24 01:00:13 UTC+0000,08380d9b53c146db8e2d5a83e40c4b24,b74860355dcb4cd7a24efc7e16427589,0,1,1,0,2
7313,e3aac2628b32445db32c0aea7dfb7457,2014-03-24 10:32:25 UTC+0000,34f9c1b50b034dd98524f8ca1a83481d,6877d790e8e04303916865c406ec5202,2,5,1,1,7
7019,e3b3edfb2e4646abb5d411a10fc8cdfc,2017-01-04 05:26:58 UTC+0000,3701d284d0be41c1b5922032f2f6edef,5a07ab57f9ff4bf68de55b4f7a48b4f5,0,1,1,0,2
7838,e3b6dbe122d14efc955ce28867dabae4,2014-03-27 21:48:44 UTC+0000,5ea3ea29dd00485ca9e5a5e363c9fd5d,1272964da2504fe8a8a6400539cd8b1f,2,1,1,1,3
4328,e3bdf5a823724f899cc55a88377eb2ce,2016-10-13 02:31:54 UTC+0000,4e4c88299f7843b0bf31740624f7324b,ad9bb6e9545e4bdb942487fb572664eb,0,1,1,0,2
3616,e3c7e3c403074a9bb92741fc90865045,2016-05-20 22:32:51 UTC+0000,14677c446c914e4ebf9b215a9966daf6,30720ecbcaf94e19874425c6fd983716,1,1,1,1,3
2771,e3cd484366c8479abdff33443368c961,2012-07-11 00:29:46 UTC+0000,6ff86c6d4a2046e7a1de43ea414731a7,560a4bb63dad4df7b9a81efa29c11231,3,1,1,1,3
2340,e3d1513a16cd4f1bad79d7a7d3240289,2014-11-06 16:01:36 UTC+0000,60f5709de7e947d29de90f07177a40c1,ccf7cb552f7e4ebf88d27369d8e0fc3c,2,1,1,1,3
2725,e3d34d64e7804211bc9c361fee314351,2015-04-21 17:26:29 UTC+0000,0d441ac5016a4a6598fe3f2c695c0821,b4982c4cf560405f96eede2722eb35c8,1,2,1,1,4
3167,e3f47d8da04741a6ad906caa2d291fcd,2017-05-29 23:13:20 UTC+0000,6da9c1e276114ff098ac00e79462498e,070e6efe12a74c4992e3050ef9076a00,1,1,1,1,3
4552,e4051860c32f4bf095362e0452fdc257,2018-01-12 18:06:23 UTC+0000,c02a6f9812ad4daf8db5bcb0e1cd3236,887c5a142b42466fb74740d72989fc74,0,1,1,0,2
2888,e416e12ddc9746cfa341c084518806b5,2016-05-20 21:37:08 UTC+0000,6a14c93b1ab04a62802d6511d86f7530,d3ba15fee0584d72971b06fb5cff6fae,0,1,1,0,2
2752,e434b228ffbb414b8f7b67f67b81a99a,2016-10-20 20:52:53 UTC+0000,db0ae63dadf8400ab6d7afbb8ab032c8,c96cfb4a7d4f4d3f927e3dbf6e24a66d,3,1,1,1,3
3812,e4459ec08e6348248f6ecd0f5d080107,2018-02-23 02:27:03 UTC+0000,fa131987c52d4684a0ae61324a2e61d6,1bfcd309eb354ee7b56ae36b60e86ef9,1,1,1,1,3
1047,e44d3054a7c84750aed6f1e5ec31807c,2016-12-22 00:00:04 UTC+0000,51b38238054841fc8443d0a3a83fa7a3,d02f6d9faac24997a7003a59e5f34bd3,2,1,1,1,3
2869,e473de74dbee4271b5632b5a036c52bf,2017-02-03 01:25:21 UTC+0000,5c362b00b1e14e689810ce9c185ff7da,d94fafa008594a8fa19bd1186e573852,0,1,1,0,2
5816,e474ed84b6034c24a06b4c3d44d9a0c1,2014-03-05 22:22:24 UTC+0000,8580f7faecd3450d80c793ee5d217a03,3d8847ddc8d04185976a9e78b190ebdb,2,1,1,1,3
5966,e47a69383aa645c799e83a82f8ba9724,2015-10-30 01:54:38 UTC+0000,812d4c1727e841309a8a7998d92300a6,a1006e6a58a0447592e2435caa230f78,1,1,1,1,3
1052,e47c8e01945f415d816eaa303d78f2e8,2018-08-19 11:19:27 UTC+0000,09b072a205b54ca29b8cf1b03167f2c2,b37ebb6de8c4428390b399c3b9072ffb,2,2,1,1,4
5969,e47e45bd4763406db7039056339b020d,2016-06-27 03:47:06 UTC+0000,a47c818cdfe54626952b58a276358ed7,30b1ef88592643dba57c33e4626684c8,0,1,1,0,2
2150,e498e374a5b54aa7bb42a749e1507431,2017-02-22 16:40:13 UTC+0000,582e2598b8df4cc8ada724cd20f72ae2,1d09800aa6804f3c92a89decf1bd7fa5,1,3,1,1,5
5184,e499e7587661452bb73df3e1b72c17a1,2014-03-06 20:19:37 UTC+0000,d3799ccad25a4986b21c5f66a6f43c5c,31a0f209fa6842db89818c08b43870df,0,10,1,0,11
5454,e4c9b2d8118e4dc680ddffc3d88d728e,2016-05-25 13:40:07 UTC+0000,c9dcf3828096427bafa687bad791a2d9,369f1c8646b649f6997eae7809696bd5,2,1,1,1,3
2224,e4d46eb3885e4488a1b3b4cfde37e446,2018-03-21 03:29:08 UTC+0000,a7b445db908f4e8ea565c70955411386,be5d23056fcb4f1287c823beec5291e1,0,1,1,0,2
1741,e5021628b06c4dd5bbdc535288c35606,2017-03-02 13:17:55 UTC+0000,2062d15ff14143adabf4668160d6047b,0895796423534563adcec1c208e9e0bf,1,1,1,1,3
2915,e5073addc84c4a1dab6d5f53b9c6dcd4,2018-01-25 22:44:28 UTC+0000,b3ff765abd514c7fb573e53c1b60536c,3167029a4e404749b7079d30fe2d0572,2,1,1,1,3
40,e50b734364e343eda53fe125bb2e2c7e,2017-09-29 15:31:13 UTC+0000,5a3e165a81474bfc89ee5fbc8fc1439b,32ae1fd679c94e549ed7a78ac5d208ae,1,1,1,1,3
1020,e51e633b36b54d91b9f3c4048ffdbadf,2016-10-05 10:57:30 UTC+0000,b29b6e0f498445c8b48d73ed288946bd,be5d23056fcb4f1287c823beec5291e1,2,2,1,1,4
1449,e5226a025eca404bb2a25f5554b4bb84,2018-01-30 02:54:53 UTC+0000,f16987925b844762937586e268eab598,e6b29607f1504bc9bdb81783016df845,4,1,1,1,3
754,e52cbd712fb94a71a75df75da936de91,2012-05-25 11:08:34 UTC+0000,282640d574344d0fbb79a1a364348457,5309d294514e4064a27469e4f84f58e4,1,2,1,1,4
7226,e534c6d5a43743e8bb091867fe870892,2014-12-17 02:20:52 UTC+0000,cad904521029453f99dd6c5ab88d3062,e1bf7e669a13469fb7bbd0ccedb66fdf,1,1,1,1,3
3561,e545013c48ff4ac39190300ba5a81d2e,2016-04-05 16:40:13 UTC+0000,88fe2919997744e2b2d3b88651f7fb23,2aa05976d30d4cd5a4b878b2da102e8f,2,1,1,1,3
3846,e5736d0f6ee54b98b614d04be2b5a720,2018-05-17 18:38:19 UTC+0000,6e67582cd4d4495dbc7418ced0329ca3,4dc61581ec7b409bbd037e483f53ba0a,0,1,1,0,2
251,e57ae9b7eec6478e986517076aa2f2cd,2017-04-02 23:44:23 UTC+0000,e7a485d3a30b45878495aa7f18c4939d,dc28056163a8447686e5691f4c1475b0,1,1,1,1,3
7715,e57d57d6612d4b9894f3c75834101003,2017-10-22 16:05:59 UTC+0000,4d13f127c05c463f8f4cacfdacb6925a,89b0bf5521a64ea5a8b56895d36a96f9,1,2,1,1,4
1717,e593b16ef6e345038fe26cf64251cfa2,2018-11-14 18:30:34 UTC+0000,edda87df80d14515a784cd940bef3162,942745823db7436495bd371cc8fda0a4,2,1,1,1,3
6611,e59612a9240140829ab7d51821730552,2016-05-06 19:52:31 UTC+0000,ec88407209d74516ab2a7c65869ce932,53939a491acb42a4815463845a638186,0,4,1,0,5
5456,e59b850752ec40aaaed9630dc2ea26eb,2014-05-02 18:38:04 UTC+0000,da91a4068f9e40d08d6b7a65ea50989b,18237fb03c8d4d368085a5dd67c5307e,3,3,1,1,5
1352,e5b4748aff864f3a850ac468f471e02e,2018-02-11 05:59:53 UTC+0000,d28a7efd91aa44d1865242d69d5891e4,be5d23056fcb4f1287c823beec5291e1,1,5,1,1,7
6317,e5b6c7abee194066802e45b2d77c3054,2016-12-24 01:15:00 UTC+0000,f1a76b4e3c024ad1a7549ffc27e482a5,fafeba89ca764bd891862fb8440a2962,0,2,1,0,3
737,e5c2cf223b664eee8e12711a859c06b0,2016-05-18 17:29:43 UTC+0000,b646e1b40f4f4357afccd6a25ec5e9e8,94f6c370e61b4ae8b3f0c70466de7ca0,0,1,1,0,2
7481,e5d542d65dd84c13b8e1384a068d6786,2016-05-13 19:57:26 UTC+0000,e71923af8bd844e58802dde60b242b23,317b35d9099e4f38a3147c514c1db691,2,1,1,1,3
3715,e5dd31ea48184799ab9786d3f70ed5d3,2016-09-08 13:54:04 UTC+0000,4167dbfc678447c79247189671d27547,a1006e6a58a0447592e2435caa230f78,0,1,1,0,2
321,e60e18518448447b99cd6011bdcbd8ad,2017-02-19 14:37:43 UTC+0000,b9ea41332b0f49e68d46c1488bf827ec,be5d23056fcb4f1287c823beec5291e1,0,3,1,0,4
7008,e611c7b36957465198ec07d15d0d1575,2016-04-03 19:06:16 UTC+0000,81c545c8b1a44a2c93d6c49ca416a5ab,93d0c6046a4f456896d9b0057369ec78,2,3,1,1,5
2356,e612b9979c2647d383d26bdad1176f80,2016-02-24 18:04:15 UTC+0000,be1be43c35c344dc9bd2bb513ff15bea,67dda43361744abf9b9c0ddfe47c3f8a,0,1,1,0,2
3511,e62392f718ba4a71ab4c7662905a6869,2016-07-09 20:46:00 UTC+0000,ef18569ee6ae42e68de340523043b433,58fa5e95fe9e480a9349bbb1d7faaddb,0,1,1,0,2
4703,e627162f407a4bec82b544c4683e8ee9,2016-07-08 02:00:32 UTC+0000,5ce4c338c31a435d9310d3263d5983f0,c258f388f42b4f608dd6fd8e9b6c1dd6,3,1,1,1,3
776,e629bb6e14cb42f0ac12a99a19565491,2018-07-30 14:28:07 UTC+0000,922350893bc04f57979bc6fd27b5c610,1461a61d272047eba1df6f809d245f1c,1,1,1,1,3
4756,e655921939594c63b962eab99d0ab7db,2015-11-01 18:44:26 UTC+0000,c2159a5e0a2f44ffaf34ccd6b50b498d,a1006e6a58a0447592e2435caa230f78,0,1,1,0,2
7160,e660bad11ac94878b61c1cd5ae741af9,2014-05-15 21:06:19 UTC+0000,0723e2c56e1d4ae3baf33359f33c0dd9,c072734d440147b794ce3a56fba504ac,2,1,1,1,3
1872,e677ca43fe47492094d631cb597c4fe1,2016-05-15 23:18:04 UTC+0000,b9bab7d27c55436882191c4f368c08c0,4e0f0fffe8c941ee844e650082267fb9,3,5,1,1,7
7037,e68b5b7ef39b4b289a283b228ac97f36,2016-10-08 17:54:04 UTC+0000,c5ada48e7561401d984e3f77b7ac1bd0,0b17f4e9d93c40eb9a5d087865084ce6,1,1,1,1,3
2526,e68caff15569428d8d657e181f159b08,2014-04-29 18:00:35 UTC+0000,eab58cb685a4410eb2de97727794640d,0355aaad83704ad98e6d71b79db85849,6,9,1,1,11
7478,e69c396f30ee4843972d03bd58d2732c,2016-10-02 01:15:18 UTC+0000,31d33f3516594b06922d0bd215b05c41,e773d6ccade64f38b1b960c6b64f0a2a,1,2,1,1,4
4480,e6a0ea1d37014c9fb9ea91b8179769f1,2018-02-09 01:38:41 UTC+0000,7a87733ad34740d195c0d9cbb55ef0d2,a6d33c38902546849c36ea7e9e9f0870,1,2,1,1,4
3318,e6a454efa32040fc9659b0fc31724ba5,2017-04-20 11:31:08 UTC+0000,596eb46307cc45a99f43c79a301cf768,be5d23056fcb4f1287c823beec5291e1,2,2,1,1,4
2429,e6a4a48c7d784e23bce9a83c7958b7a5,2014-12-03 22:37:32 UTC+0000,4c7b848be7da42f3a037d7803ff445f2,12b90373b0994c6b9a32ffa8ab9a970a,1,1,1,1,3
7551,e6b1777cb5014e41a448c8e425ba3425,2017-01-27 03:25:17 UTC+0000,9373fd97e7dd485fbed54b3ec09f195e,6806eb65d3714622bd3b0c47bb7e9342,1,2,1,1,4
5267,e6bb6eba48524d1fa5b93953fe9c0a5b,2015-10-28 19:38:34 UTC+0000,884bd5c7e7ee4d669210c670a15d5c28,a1006e6a58a0447592e2435caa230f78,2,4,1,1,6
3508,e6bc875bdf0245eb89eeafac00abd864,2016-03-04 02:19:59 UTC+0000,cb38af93ffbf4ec5b586b0f161ebe406,542df64cb09748f8bbb480f63ada12ca,1,2,1,1,4
1304,e6bf91d6631e4b5a968f8c771dcad8e8,2017-01-20 02:29:26 UTC+0000,09690389989d4437a63bee0837f568bf,3b0d687829024e34a666a19daf42d5fa,1,1,1,1,3
6220,e6f5d51a25434ebc9c6e4a066c0c76f4,2016-05-11 00:20:21 UTC+0000,f5aecc08d3be45a082fd040d03a64b49,de51e745b6354185a0ca5d02dc628416,0,2,1,0,3
4019,e70c232643f84e92ba9f1926ea8a13cb,2014-04-01 18:44:46 UTC+0000,0a490bd5b72b4870be729adb29383bb5,fec9c7d2c98641979665c0e8a0a0848a,1,1,1,1,3
2067,e71121d8560a421bb1f1567781bfacc1,2017-11-15 14:29:50 UTC+0000,f0571896659245bd9f1baeb97d7c9d18,5424ee250804424f8b98d1a5f2832390,0,2,1,0,3
7450,e714bbffc4b3440e874a4643d8bc49cc,2016-11-05 15:51:45 UTC+0000,59b6817415304a3a806ec8d177a3f116,899d9edd944048aaae4faf23bc96493a,1,3,1,1,5
3464,e714ca5c5b2040d6881b63c26cdb2e76,2016-03-01 21:58:02 UTC+0000,99ca11106ffa4539b30b97e50d07b422,96bbbdd06a334805a0501034d9df1aa4,1,2,1,1,4
6881,e7162f1589034a478b99b87190ea492e,2012-09-10 16:30:44 UTC+0000,d9adda6a098d4485846f9bea920f51e3,4cf8fd05248647a088f3e2c4118f052f,0,2,1,0,3
337,e72bb327027945bdae080da34ec3a0e4,2016-05-17 22:56:18 UTC+0000,05c2365c6619487787bbb889c2db5797,387eabd8aa1143a1a38e175b65925bc3,1,1,1,1,3
6338,e74bdb86dcfa42f183b5497c16c90b72,2019-01-19 02:24:19 UTC+0000,dee2a0bb57f446578fc9c73b745c7b15,2d6f5c8e73be45f7ba23c28f03ff7c6d,1,2,0,1,3
5023,e750780e19e545a789056a86df73c1a6,2016-04-15 15:57:46 UTC+0000,2e2d858a7d4b41178766de18d21f171a,42f9b0e8b8294edfaf60a987eacc297b,0,1,1,0,2
2955,e754a0d2cc3743f8b0d08459711ef3b0,2017-09-05 18:10:21 UTC+0000,139f9ce12f244624865c62701d8b8dc5,4e9fe7ffb54c42eba0987c6119da9975,0,1,1,0,2
4310,e75b6f24e5d047b1ac1712713f3ff770,2015-10-20 15:35:27 UTC+0000,7d0661b4a2ac45b59470a8daf44526a3,9b42ab65e8214132809e2863a7bbd054,0,1,1,0,2
5595,e767d0fdf54b4b31ad83330051c228a7,2015-09-24 17:26:39 UTC+0000,b6f2145f8a5145528abecf1f6b87375f,369f1c8646b649f6997eae7809696bd5,0,3,1,0,4
5909,e76d0d15b6314c6db21d8499feaa42f1,2017-04-17 22:23:28 UTC+0000,f53b05811e6c4be8be1533d61918384b,c5c2ca95fcd3463a8852b8bc9d636313,1,1,1,1,3
3848,e774682e93c44d07aede8bfbed1f25f5,2016-06-24 15:39:50 UTC+0000,9a748a0f90114018886e4b5e280c038d,4d70d8e3a4954a6780d91832cb040719,0,1,1,0,2
3172,e779f977a0ca4a25a1edb8e56fdfc0f6,2016-06-23 21:24:47 UTC+0000,745b208d836541baa6b4e4852d8ee3aa,ff347be2a46543598867792e3e6a54b9,8,4,1,1,6
3518,e77a8497a08449178daf4818c0b15c72,2013-10-01 17:07:33 UTC+0000,4667987f82e14aebaf00f787046ac71c,986a00b486d9421c872bb527f015cf42,4,1,1,1,3
4584,e78b55baebdf4b208ca0f1502891c49e,2014-04-09 04:35:27 UTC+0000,336e3784eced4afd9d3503375bc35aff,6774ee9e8f9247728dbbe896726e911a,0,1,1,0,2
3694,e78b95b476be425892dd8b99be6dbc23,2016-04-25 15:29:04 UTC+0000,f5ecec7e2706499093ae1190a66521c7,43e46835a4af467186a5d108072a4999,2,1,1,1,3
957,e79bf4570af646d5892cf42b031c2a52,2018-02-07 16:17:02 UTC+0000,48c1d221fcd54547b292e04596465832,2037358605a34ccf971bd857efc63d82,2,1,1,1,3
1236,e7a123dab63243328324497ed1b92648,2016-05-12 00:09:08 UTC+0000,6b0e8c86afa74b23a4d9b56c898b3c54,7bffa1792d474359b922e5de700d7a82,0,1,1,0,2
544,e7ac50f7734f4312823c5c8d5f5e21bc,2016-09-14 18:11:22 UTC+0000,0b14109f3fc74d6091ff0ed883d254b3,e589ea1d909f4eee9c85b936512dc9b2,1,1,1,1,3
2489,e7d121816b1b4dfe979d878fc1de8634,2012-01-20 19:20:03 UTC+0000,a00771beeb65469b863b24abbe6bc37c,177f482adc1a449284471f7c556ee8f0,0,1,1,0,2
5613,e7dfc9d9f1534c1b9a1ee5014f3fc042,2016-05-22 21:24:58 UTC+0000,5e9625344e8d4eedbd7b6a92c217cdea,8cdeec41de5d4893925deb57220a6d2a,1,1,1,1,3
897,e7f5fec4e57141fe9ae3872b4cf4cb3f,2014-05-22 20:11:03 UTC+0000,f7be4e951a74445987eadef8008efecf,60759729a4ba43b18771fd2fa55c3497,2,4,1,1,6
2495,e7ff271abefe460a965fee4549980557,2018-05-03 16:20:05 UTC+0000,2ef1f8697f6e43a785dfc4c6a1e4b23c,fafeba89ca764bd891862fb8440a2962,1,1,1,1,3
7177,e81e9a05dd9f4f8d8f96aa88c4fcfb82,2016-05-25 13:23:11 UTC+0000,d994ec1e8d83451c8d3c7e30672bfb7f,5ec9d442785a423ab4c0bf1dd110071b,1,1,1,1,3
7558,e8266c98673845ca84b65486c99a8023,2016-06-04 19:48:53 UTC+0000,786c6bc7946546628d467de4c8b6a15a,58fa5e95fe9e480a9349bbb1d7faaddb,2,2,1,1,4
5006,e8300ad1d6cd4777b7a17bdfa4a7587a,2016-03-21 04:58:02 UTC+0000,e3395b9c326244c7a9c27c15501e72ee,58fa5e95fe9e480a9349bbb1d7faaddb,0,2,1,0,3
7098,e830a37d2d7f4799be1c459975b9bbf9,2018-02-24 04:15:37 UTC+0000,6ec20e6e19c844de803d8e152ccc7f47,30a510b81eed40d08fc5e5fefdd87226,0,1,1,0,2
7007,e843fdb7c86d4d4ab8ccaad46dd3ddbd,2016-10-31 03:04:35 UTC+0000,e1b7026a8b014f70a78a315de4034795,1d59452d50644b15a359e52dc8e51895,0,1,1,0,2
972,e84a2eaacc6d409fa43a08242a5bf9a9,2016-10-19 12:43:20 UTC+0000,74b3c18c9cb74528b105b1d5944240ab,ee22a21283674d348b90843f88e10f7d,0,1,1,0,2
1689,e855a5a2505a463782755ffada56920f,2018-08-21 03:43:52 UTC+0000,a34255a91d074bc7ab29f4074d300acf,aa0f20adcfc9422cb0391b1b364070f0,1,1,1,1,3
1295,e8685cd1071040949a5aef7e6d042657,2018-12-29 18:22:58 UTC+0000,f2b45558d78f4cec8b9db6b17f24ca78,ff165c6b122b47b9a5d4db2504086460,0,1,1,0,2
1660,e872376bc33d4b818a340936f117f2da,2016-06-26 02:54:46 UTC+0000,d3d4558efa534f2898cef4652ca7b2c8,30b1ef88592643dba57c33e4626684c8,1,2,1,1,4
5798,e89449e928df4391b3c7cd247bcfd6c7,2015-03-24 23:11:13 UTC+0000,5871a80bce1642e28e38e0625c2bae54,bc46e3699d92477ba8c7aa723e54a151,2,1,1,1,3
7185,e8a10c5f97534d3987d59c5c474f13a5,2016-05-13 12:28:00 UTC+0000,578ab66ae60e45d5b5557fd833eae056,81c4329d8d1c4f499575fcfa99e8cecf,2,2,1,1,4
3914,e8a9a51f1d8644c7be8052390470209c,2018-09-27 23:01:48 UTC+0000,f5c72dbc069049a9ab75c1cdd6f71537,cf25490065f24c63a4b94f6e60712d36,0,1,1,0,2
63,e8aa1c6f02904d519b162aa7ebcdcc41,2016-09-16 14:42:11 UTC+0000,b66509ed78d144028697de2426377cd6,b0e916f9368640afbf1db030c4ead872,1,2,1,1,4
2801,e8b56b040b1948aa9a05481d20db2daa,2016-06-24 06:27:46 UTC+0000,1c35e8bce06b427194c09c9d2fb11a55,614ba4c0aa534b759b73e8473fd5ec88,1,1,1,1,3
1937,e8cb699a12444cb686c0cef71e25f1ee,2018-05-02 23:04:30 UTC+0000,26079b410b6a4ecda9a5cca6b64371da,6a471a70c7c842eaa210ccd12e4e97d5,1,1,1,1,3
2573,e8e25feea6234d549a7a8fb7c82ce9e1,2012-09-09 06:05:59 UTC+0000,7a61eba8cd2d4ce3985f02b572a6a18f,f05b33a454c048f3bbc73f5f3f7f5127,2,1,1,1,3
7319,e8e94304453c41abac31c3fabe2420b4,2016-06-25 04:16:55 UTC+0000,aeeb3427d9824b7895fc40b61d8d8d90,58fa5e95fe9e480a9349bbb1d7faaddb,1,3,1,1,5
7635,e902529d8e5245ec9b8b25cb35ca9952,2017-02-16 14:44:42 UTC+0000,68d8a21ab3eb414d9eb78a323afeaf9d,8255d452e1204678a846123954b72491,1,1,1,1,3
5208,e91a6013c34642c9b7eb638d2ded7d26,2018-03-22 20:08:21 UTC+0000,38abc37aac0f42b688c42ac68a5a8082,9f75172537204b83ae8761fe4001c318,1,2,1,1,4
7383,e929abba002a4fcca31b1def7b8860df,2016-12-23 02:23:01 UTC+0000,1a8927d7298f44978debfa5fe6bd8f56,a1006e6a58a0447592e2435caa230f78,0,1,1,0,2
2293,e92a1879a4c642879f59b1ea7d881919,2015-09-02 22:18:52 UTC+0000,734aad4d20ce490f883e338b878f659e,a1006e6a58a0447592e2435caa230f78,0,1,1,0,2
2855,e92f6f59b06d4a11bbf8fa493ed05ac6,2017-11-21 03:08:51 UTC+0000,cab192216af7470c9e35765c2f0f767e,d7f9afe721af42b1a03a993909e0568c,2,1,1,1,3
5614,e93aa99a7d2c42c180c463c817837ee2,2016-03-03 19:15:07 UTC+0000,d6ce5ca047674d60be850747af30ab80,a1006e6a58a0447592e2435caa230f78,1,1,1,1,3
3752,e940fff222f641ff8f232a5f440175c4,2018-01-24 21:19:48 UTC+0000,13694f7a7ad04db09773ccf4e215f8dc,369f1c8646b649f6997eae7809696bd5,1,1,1,1,3
543,e952454fd1e24818a3eb2441a9b52da3,2016-11-01 14:28:09 UTC+0000,553192ede9634e0da6bb7e32e0dcad8c,7f3b11c0f75b44e39543a21c1e320f12,1,3,1,1,5
3398,e955deed1d67405b88814c88faa25ed2,2018-03-02 20:11:39 UTC+0000,184f21d487974914a831853cc3ab50bb,8d0e1246c2b44f5b846cd5e4f5dd71e8,1,1,1,1,3
7701,e961c94d0d444c20b7d155a3fdb0c97f,2015-10-25 22:31:05 UTC+0000,3be39e34259d4422ba73cec0739b029d,7907ca29169846c6b5b65c74c57e33b1,2,5,0,1,6
5211,e9643b48c9794999ab22888f38910fcd,2016-03-09 21:46:27 UTC+0000,2af2f4404c5942daa02c581561bc79da,96bbbdd06a334805a0501034d9df1aa4,2,2,1,1,4
5942,e964ad9381f6453397f20a3a7893c292,2014-03-06 00:21:29 UTC+0000,83b19498ee35407c9b1ea8aef00242d2,3d8847ddc8d04185976a9e78b190ebdb,2,1,1,1,3
2440,e96914a94197476ba0ec75bc083be325,2016-05-02 12:50:23 UTC+0000,c57ea3d2081649f398a464ace79aa79b,9de7d2b62abb427aa0d0039f85bcd974,1,1,1,1,3
1324,e975a99e9a8d4450a68c9f20ed87cb6e,2018-08-25 11:31:00 UTC+0000,1f054ff297804a47b31181f55715c507,36ff3b3666df400f956f8335cf53e09e,0,1,1,0,2
5217,e97c1ba93ecc4243b3e6d9d790b9d421,2015-03-19 18:07:34 UTC+0000,0797b8926b4242efbdef7997c4e86b8f,6d3aeebadc6a403a814b2ceafd79862b,1,1,1,1,3
3820,e980e0db3e494996b5ce7cc8f6401bf9,2015-10-19 21:14:32 UTC+0000,4cccf1647a64410d84bac9b09b3ab50a,36ff3b3666df400f956f8335cf53e09e,0,2,1,0,3
7123,e999912603ee4a5c908c4aa68f8f46ba,2012-01-09 05:37:28 UTC+0000,ea0d1620028e49edbce31e248e0a78e3,977428d851b24183b223be0eb8619a8c,1,1,1,1,3
7907,e999db15da1d4102b63ae1798a67c93b,2016-03-10 00:23:07 UTC+0000,38d45e060aa34c0b98054f8f1cb03faf,a1006e6a58a0447592e2435caa230f78,1,1,1,1,3
2750,e9a54ba310c843c1affa0953b5ba8cd7,2015-06-25 21:44:19 UTC+0000,e17b24a7b21f42d983d2d4a1ff7b7d02,369f1c8646b649f6997eae7809696bd5,1,2,1,1,4
7800,e9be326724674a2299520e640a8d8868,2018-03-02 23:04:35 UTC+0000,227c3d63695e4624bc94867651f23c96,6b6e86f0c146410f8f37b143571509ec,1,1,1,1,3
4758,e9c0f1fa29fb47c7b50ed814346ef305,2016-03-28 21:55:19 UTC+0000,47c4c9ae5c3b424d85d1e0c1e1fbef5c,e26f2117e7224c3ca42f0019a4831a9c,0,2,1,0,3
7447,e9cf03468ea64e588b879105e6cdbdf9,2017-01-17 23:55:49 UTC+0000,e8a8a76920db4488bc198921cb5bc0d2,5f95b0ac821e4e8e9b4fa9fc8eb9ff61,2,1,1,1,3
7640,e9e147cc779e41d28cce17d6dec907fa,2016-05-12 10:23:55 UTC+0000,c24442b816dd40029835bba8ae13235a,54976f119d3a42d3ae3d85956c1b6338,1,1,1,1,3
7827,e9e5903d8256409f99bc4f356ac65161,2016-02-19 16:50:59 UTC+0000,cb353c4103f54d41ab72e678e22f6e87,a1006e6a58a0447592e2435caa230f78,1,2,1,1,4
2769,e9eb37751ff04e86bf00e5caaf6c300f,2015-03-17 22:40:54 UTC+0000,14adddad24134bf0b261df4cc3911062,f96f59f78b4c4c4dafff870b194d8794,1,1,1,1,3
6527,e9f134f3be324036b1315d544a53dd40,2013-03-31 22:15:26 UTC+0000,828eeb492a474b6b861993c5d6036b62,cc66003a03cd43bc9dd3edf00d071a35,7,3,1,1,5
6563,e9f59244d1d14ad6934fd85f4680c8e3,2015-05-19 17:04:22 UTC+0000,36514c2426eb4f5289daad1f1bafdbc9,3b6c69dadf884d2a82f0d04c365e19eb,0,2,1,0,3
6976,e9faddf44ef74432be612d700b9559e9,2016-05-24 18:59:30 UTC+0000,0221bcfa37644a6dba3ab877f7f6d7ff,2cd87f827556435a8e4b903157ce0f77,2,8,1,1,10
7679,e9fec8b874d44d118535333a04b55f72,2017-11-21 16:23:02 UTC+0000,4f6e8fdb7b104d0eb0278412e488d36d,eaabc3fb410648e1af6ad19b93e5f430,1,1,1,1,3
786,ea0db66d0c994af6b2c82909c5d01e57,2016-12-30 15:42:20 UTC+0000,d06edab9035442a382c189520c466219,d1dc7e671e05451bb4b4c19db0e9d48e,1,1,1,1,3
158,ea15e20e2dfb421aaf1a241ac47a5a04,2018-05-11 18:37:50 UTC+0000,d49bfe8fb02946f2989f7da4e2e476c6,4dc61581ec7b409bbd037e483f53ba0a,0,2,1,0,3
1652,ea15f8f1509e4235b63f769fb5a253f1,2016-08-17 10:25:24 UTC+0000,03750d614fa440cb90caef4f8ffcdfb4,9d3ad4a464a64e99925341d617ce647c,0,1,1,0,2
3857,ea2293dd0bc64bc1b825c59d9413f7d0,2018-08-15 00:49:47 UTC+0000,902ecf76eb8e4caeb80bc3c679592096,209557664ca9450eb724652cf366dac9,1,1,1,1,3
3385,ea332fb5b7184616bab7b7225d1ea288,2015-01-30 11:28:04 UTC+0000,5c1d75c2ba354d6db9b216dc5722ab7f,e54f9b0de46b4bfd991ee2c845c0733e,4,1,1,1,3
7787,ea3eb4f5e29e4c4ca3993f2d134f422a,2018-05-17 20:32:18 UTC+0000,dc8b79bb1a494dd78ecc37191a1459a5,511b829793e848c4b39b0b5e0b75c4d0,0,1,1,0,2
1243,ea418152c75548b8a4af2054d197df2c,2016-05-15 15:27:59 UTC+0000,41907c8ff128447a8b38310f86ab5c38,58fa5e95fe9e480a9349bbb1d7faaddb,1,2,1,1,4
1677,ea50dd464cba486bab784dc257553d8e,2018-08-14 01:28:02 UTC+0000,a371804917604781aa76a84bf69981c8,f2a02778da294b7f8635c63fc77b8abe,2,1,1,1,3
5263,ea5ddadfb9364e21a7c34632ef37e5b7,2016-01-22 19:08:03 UTC+0000,37a825d835524b38903d20d24a12a649,a1006e6a58a0447592e2435caa230f78,0,1,1,0,2
7020,ea69fb90b7aa49249973a1b78c537900,2016-06-23 08:08:27 UTC+0000,2b98efdf2a2842639e4dbc64c481edc3,35896fffa3e847fe8700f9d52c5d23cc,3,3,1,1,5
6769,ea715237e1a947dd8bc409985e2dee9e,2014-04-13 13:47:10 UTC+0000,dae2bdc75d27442ebd77a0f40a9c2aa2,4a71c85e58dc4c1a8546574188582a92,3,2,1,1,4
5026,eaa001fa96374779a61f479d5d9ee51c,2016-03-17 22:32:16 UTC+0000,a185679827324dd09cce1cf67fd1c90f,1789e76814c548a0845717fb366572c0,3,1,1,1,3
7398,eaa6ed701a7c4723adfc7ae61858d7d6,2015-09-07 19:48:22 UTC+0000,21e89c0331034975a0dd5f52bd9baa2e,a1006e6a58a0447592e2435caa230f78,0,3,1,0,4
3785,eaa9102c960b40b7880762e1517766e7,2016-12-06 19:45:05 UTC+0000,279b5e260a6446ca9208005a01cb7bb4,190edfdea5d14dea9463802453782419,0,1,1,0,2
6494,eab00500a1354bd1a1e32d73f32629c7,2016-05-18 01:50:07 UTC+0000,fd9d2694ae284a8fa14154f863d80fe0,bc46e3699d92477ba8c7aa723e54a151,1,2,1,1,4
516,eaca0dad2dac4530b4d68dde8ae5b304,2015-02-26 21:45:49 UTC+0000,f2f84197399749fd8a7bf48fe970769d,369f1c8646b649f6997eae7809696bd5,1,2,1,1,4
5040,eae2f0efff914edf9e47c5ec68939d0f,2018-03-13 19:49:38 UTC+0000,a2ee4ba68d344f7d85c3c75ebdbb85eb,243c51ebbd71471d9af55cc34ce305e0,1,1,1,1,3
1184,eaf25f65fd684eff8adb72074b1d7398,2014-03-25 16:23:32 UTC+0000,78066ac3641549eea4ae75b7d20a1416,95f1104e8b604c98ae237020a98921c4,3,4,1,1,6
5387,eb0a643ea62048f2a7c379cf2b6ec063,2016-05-01 00:46:31 UTC+0000,16e7aeb3c18c47c1935ed887c085b113,a203d27f5d054ffd829771ac7a2fe4a4,2,3,1,1,5
6548,eb1ee20ec9d94de880b93aa21329e3bc,2014-10-21 19:35:55 UTC+0000,0f0ec675d73e472984275983c1471fb1,f3f77cdaafed4729b0fe95decacea3df,2,1,1,1,3
2051,eb1fa42eede245228361963e48e09e41,2017-07-13 13:37:28 UTC+0000,196b1408e5aa4f6aa27025b023a3bd84,3b0d687829024e34a666a19daf42d5fa,0,2,1,0,3
205,eb2ffd54930a4283ba352784530e5038,2018-02-19 20:42:50 UTC+0000,8b6f2acfb36b49e79642ec815f7cb784,ce9d21f7eefc42ec88f27e2cac7ff833,1,1,1,1,3
8004,eb300dab32394cafabacf0bb19165620,2015-12-11 15:15:32 UTC+0000,44ff8a38157340e08506371525bbdad2,c1fd4048e28346a48f301c410f2a6d52,4,4,1,1,6
4923,eb353da4974f4eae9f2fa7a766cf8108,2015-10-27 21:26:08 UTC+0000,e436af05d88d402588ea80a45ccc5383,73e520a49c864919bf439ea61c913ed4,2,3,1,1,5
457,eb35b25eb1714313b2961441ea34d940,2014-10-02 15:19:08 UTC+0000,878258d8ba7b4f339f7dfdb583eee819,c1bda2764ee642b3859b1ca6839fa16c,1,1,1,1,3
3740,eb3c2c6dc8c34c2487caae8d842e7c27,2016-05-17 02:20:33 UTC+0000,4773c7dfac7b44e69a2cd799a2229a60,dc28056163a8447686e5691f4c1475b0,0,1,1,0,2
1396,eb4256c893734622a8334def2e0357c8,2015-12-17 00:27:25 UTC+0000,68f3f0d497cf47cfb528db7c4bcfe4ea,349db306672e425f9481e6c30d84afe5,2,1,1,1,3
3069,eb47b21440fa4204a3f9951dc7e53c54,2018-03-02 21:36:43 UTC+0000,0cc1b77230fe4c5e972b4f76dc55d163,7f3b11c0f75b44e39543a21c1e320f12,1,1,1,1,3
4398,eb66317c5706436b8fd07354853910e1,2016-10-24 16:35:08 UTC+0000,b42b4e32842044c1bf4caaf038aa66bd,49dba8c375214760bb7ab8e616a5f91b,1,1,1,1,3
5002,eb741b670d9e4ec7bfc152bca8f913d1,2016-06-27 03:39:31 UTC+0000,cd8a3edc19de4d5686eb3e46f5531012,30b1ef88592643dba57c33e4626684c8,5,5,1,1,7
1242,eb7656fad4e9410e89a19a8e523d332b,2018-10-07 00:02:08 UTC+0000,bec34f207eff48edabe07637df4e80e9,36ff3b3666df400f956f8335cf53e09e,0,1,1,0,2
7262,eb7def6298c9497ba1070af1ddb12976,2018-03-19 14:26:35 UTC+0000,d85491cc36bb47128dc9cae43b11c0be,b4ff3cc803624ad1bf3b376b04bf40c1,0,1,1,0,2
6072,eb82502337f1436c8b63e962e330be74,2015-06-10 00:38:34 UTC+0000,5d33e8aee928491f9403d5ace3603bd2,78240bcd03e04ba4af564a155fc8a028,3,2,1,1,4
1926,eba9987e549a492e9d18fc0516370c40,2016-05-16 21:11:11 UTC+0000,908e4e82bd844c17a089afbf42f0d89d,36ff3b3666df400f956f8335cf53e09e,0,1,1,0,2
2345,ebd869857f074c498430287d8d3ba004,2018-11-28 19:37:57 UTC+0000,97b9b72fcfe546ae8b0938d69dfbe3fd,6f0b0b7296274a179b58e1e269a1b106,0,1,1,0,2
3861,ebe9af7bddb14bd4bad56f61dcb3cbec,2017-09-29 12:42:13 UTC+0000,25cf790b26074118aec12eb3739326e7,9d88c9d801364dd394036c67c3492a3e,1,1,1,1,3
2992,ebee2297a52b4691a4dc3477ff638820,2016-06-13 16:44:58 UTC+0000,3eed7084ea5a4e2194bc96e4d362ffe0,cf8ca985ff3f4cb7859756af654f6bce,0,1,1,0,2
7014,ebeef6d614954fdda1912fbdb1ae0bc1,2016-05-20 01:47:01 UTC+0000,2fa9c90f3b3f45f38ce4b0be6e559a3d,08f4c4808d8e4eb1b9b287cda01beecc,1,1,1,1,3
5253,ebf600c220274737aaca9367e389804b,2012-09-12 02:46:26 UTC+0000,52234bc51aa3439b80ab63c15f62d090,aef2e9377f994faf98219268b7e0bc3e,1,1,1,1,3
6081,ec07b085ed294508af9ac1978c48236f,2016-03-27 23:06:59 UTC+0000,e7c65fa5fe7048569193dd9e8bd4d8bf,58fa5e95fe9e480a9349bbb1d7faaddb,1,2,1,1,4
6590,ec122a3a9ac84e408b97c380dc6e7bcc,2016-05-17 21:55:53 UTC+0000,f687990e82224e0ba066957a52a53019,7cfe60fdd41b431ea5b97037fca2e35f,1,1,1,1,3
679,ec15ba39038943318cde0871f60127db,2016-07-23 12:18:10 UTC+0000,1a2e7f93cc954bf6a5f2cbac7b2cdcd2,3483a87fa53141339e10720095a20318,0,1,1,0,2
6216,ec279186dd29423c9b3cbe11b7ffa149,2016-06-26 23:38:17 UTC+0000,34ad69bf05cd44ec8d33f81c7e1fe413,58fa5e95fe9e480a9349bbb1d7faaddb,5,4,1,1,6
5588,ec28c434d60d4c3cadede6b1b171acd2,2018-12-18 11:11:15 UTC+0000,44fd798f15844b1abfb850486f68fe49,6ee9c20eddbe41e890dbde50fbd63f44,0,1,1,0,2
5749,ec2c079523dd4cb899546e01c72840f5,2014-04-14 13:45:57 UTC+0000,f87b98ea9e0e41b79e7253f6a6c5659c,05444a2f42454327b2ac4b463c0adbe0,1,4,1,1,6
232,ec36eac1c86b4ffea63ee0928deba05e,2014-06-12 07:45:26 UTC+0000,90dd1d534d544faca98bd226d0593c9a,ad7fd347a59a4e6384a18c26b022d50f,1,1,1,1,3
1864,ec370bbfc00b46ef8b66235ea584702b,2016-06-22 22:51:29 UTC+0000,bc545ac71b524354953842030c4d777f,327e3aeb0e174b8bb49ab6bc75ca3f89,7,13,1,1,15
4620,ec4af5439f5a4abeab0777f1a759dd75,2015-06-26 22:21:40 UTC+0000,db9709216090408ea07666f25fb2f360,484ba21a3e19494aa036d3baeabd89dc,0,1,1,0,2
2034,ec6550a986f24fe8aa752f9848bf05e1,2018-09-09 17:18:20 UTC+0000,46533f5fa75d42b3ab36934b49c163c2,36ff3b3666df400f956f8335cf53e09e,0,1,1,0,2
1269,ec780884c0354a49875eb280a120e711,2016-11-13 01:58:56 UTC+0000,1a545cf92b8c4810a28074dd1fe1f1ce,dd319483145542869315868c5aa1accc,0,1,1,0,2
1555,ec9518451ff74cb1b4b3de4cf73c2772,2018-03-02 20:07:07 UTC+0000,2a83a860ec0840af8fbd9c61bfdd6f5b,a6d33c38902546849c36ea7e9e9f0870,1,2,1,1,4
5400,ec9e5fd02aa94f20becdef8ff36efdfd,2014-03-20 16:00:13 UTC+0000,a780d7d8c23a4e0d9e646581b42ba320,95f1104e8b604c98ae237020a98921c4,0,3,1,0,4
5590,ecb13028fea941568946267761c85038,2014-04-10 22:31:50 UTC+0000,93ca30929b4148bfb77a91f06dda7a0a,6774ee9e8f9247728dbbe896726e911a,0,1,1,0,2
1951,ecb74c0251b743708bb71f5ed222571c,2014-03-13 13:20:21 UTC+0000,3dac8223aff44a2595e1ff1f71af6974,6d3aeebadc6a403a814b2ceafd79862b,1,1,1,1,3
573,ecb7bbd7fdf446cf8ebb405e954082a0,2018-03-02 15:40:25 UTC+0000,4e82dee7a23b4966bca2c01d8957128a,25f5e94c4cb14e569aeff7cb2c98222f,1,1,1,1,3
2773,ecbb981f7991411987f04333376561d9,2016-08-06 12:08:16 UTC+0000,dcd70244f3fb41b9bcf3c8ed855073ca,36ff3b3666df400f956f8335cf53e09e,1,4,1,1,6
4204,ecc90c64e885416ab69c7e1e81724a1c,2017-01-26 19:56:05 UTC+0000,b27c4222069f492895d4a136781c6013,6dd29d5757d343eba6eae82e719835ee,1,1,1,1,3
50,ece22e7d91f742d1b09c12ed6b76b147,2018-11-09 00:50:40 UTC+0000,4bd93594143f486aa02259da73259bec,e2b4c84bf1ca4aea9b108869692d8017,0,1,1,0,2
2332,ece597ea79314fb795cd9029be98ea77,2018-08-16 02:42:32 UTC+0000,01a9bcdca66448fbb3a62a6ecee6f2d7,36ff3b3666df400f956f8335cf53e09e,0,1,1,0,2
2854,ecfe11a052574e8993be4339868c65b1,2014-03-27 18:44:42 UTC+0000,e3fb99a0345b421bb16ad0fc682eada0,cd33fd35feeb42c8a8683c74dbe0894b,1,1,1,1,3
2336,ed00f8ae1b0a4a2397ee7df6bcb66d66,2018-04-04 21:04:55 UTC+0000,762297ef51054670b358bf8e51121c05,161f6a140d8748d491093fff31c7125b,0,1,1,0,2
5179,ed176712ec8c48488ab37128cc701275,2012-01-04 02:10:53 UTC+0000,2f736ed64b354b2d91b9fcf38589f9e7,3516b29f88ec4ea69c46e4cf0adfdb02,4,1,1,1,3
3196,ed21d7dbdb264658ab53f611d63940c9,2016-05-12 16:56:47 UTC+0000,25b10cd1215641c094cc6063962cc4ae,81c4329d8d1c4f499575fcfa99e8cecf,2,2,1,1,4
853,ed358cb30e234c889f49001e9507f32b,2017-09-05 02:00:03 UTC+0000,c71d809b52554f28a33332f353b23b9c,ead34fe989d9426fbe214db2cc3cb08b,1,2,1,1,4
5322,ed4cf7dc7b6c4a6590786398a3d51b0d,2016-10-12 02:27:03 UTC+0000,0d24fb6c1a634033965c5e052caefa46,9428eb3c67e540f3a1d3e5f2649656dd,3,1,1,1,3
3964,ed53ae40fca145d58ca2776dbb44e80f,2019-01-14 14:27:47 UTC+0000,abab16b7b49a4798be5594d30fe1d3aa,92905288bb93461f846dbc8f1721e310,4,1,1,1,3
2866,ed55be3b05b34f6ebc49ff131217f87d,2015-06-19 01:12:08 UTC+0000,0f3d518e7b164d9ca06fa8d1bbe4b408,9d487728738c4ad59b3520fae53cdeaa,0,1,1,0,2
4303,ed60cd8a5fa4457abc156188b83b02f4,2018-03-23 06:48:37 UTC+0000,5fe46144360f4016a2d44624d9b33b3e,6a388a0aecba4e25a7c06cb389577386,0,1,1,0,2
1986,ed66751caf9a48c1af8a7d70bed7b796,2016-10-24 19:03:41 UTC+0000,4b9b7279434348dd945ade7126042c41,fc1f95af33ff4169a4190c00b7a4c6d3,1,1,1,1,3
1509,ed6950ba389945469ddc9f942b97db8e,2015-10-09 18:17:24 UTC+0000,a4ee44c2b10048ff8fc90d7757c5dbb6,8f80d9dea05243608687b7e131144469,0,1,1,0,2
3225,ed69fdada3ae443a9eafe0365ab088d8,2015-03-19 21:10:00 UTC+0000,6743f7aca8594172abdd2ffd7eba5223,369f1c8646b649f6997eae7809696bd5,1,1,1,1,3
4427,ed7b84a70ce9421e94d4f4283f628b81,2017-02-26 17:20:06 UTC+0000,8b858b095fd148538ddba83d4b84d5b9,be5d23056fcb4f1287c823beec5291e1,2,1,1,1,3
2917,ed8708189749475aaeb942ca71dabc3a,2014-02-10 21:29:52 UTC+0000,126226be6f404fe98fa50bfcc23a2463,95f1104e8b604c98ae237020a98921c4,2,2,1,1,4
5130,ed8a6ec34b9c499aa9cc04d01c5edbcb,2018-03-16 17:54:16 UTC+0000,09ccbd6e5d3d44cfaa3b37384f4f27e0,ffba48ec9c234f918f563f2b93d4927a,0,1,1,0,2
710,ed9d2de3c70d4c49a4b113e5255a1d45,2016-03-29 05:27:56 UTC+0000,67e47615429144e3967c9c3bc48fad56,0df1f621ffc545eab04f6a8ceab65588,0,1,1,0,2
6142,edb77a5355c8476f9505452c4ddd5327,2014-03-17 21:59:33 UTC+0000,d495ce01569341d5880da521e4412239,1fbcd8b315de45c29ff87cf912b535fc,3,1,1,1,3
2427,edb8c179c5d64c9cb812a59a32045f55,2011-10-05 20:33:04 UTC+0000,7b2bb0fc0d384e298cffa6afde9cf6ab,05444a2f42454327b2ac4b463c0adbe0,1,3,1,1,5
1761,edc8fd9de49e431796480d5337dfa8b8,2014-12-03 19:40:51 UTC+0000,9b23a34c80aa46fcb6c049ad4ce793fd,23b6df4d73fb4d9bab3eafb6dd8bfb86,2,1,1,1,3
720,edce38ff4b984533ada9f0a45bb8362e,2016-06-24 22:07:54 UTC+0000,f85a4a0f9e804c3d8444e86c71f7fc91,41149875d05f47a4905cc1466ed6ab34,2,3,1,1,5
5706,edd169c74b9348cf983a890f8b3c5066,2016-10-20 23:49:32 UTC+0000,b6ace7a16d8a4d3ab919def8aaa6377b,e3529e64e70643b6889353db79eeea3e,1,1,1,1,3
7968,ede5a978d651421192ee4ab5ea10741c,2015-04-26 22:44:53 UTC+0000,f74a96c552fd46cb9b9f521a6c4cf812,7aab6fb9a4ae4d0197fd2bc05960ba56,1,1,1,1,3
3790,ede824ab7b0045de9d63ca06458d3ff5,2016-06-24 03:54:13 UTC+0000,cebfafb8cb0e4ebda59540d1044f2d1e,3acdc39164aa493ba72c90fade4425ed,1,2,1,1,4
2065,edfd796e2e834968802721dd29d1cd7c,2014-03-25 16:36:15 UTC+0000,48a849b218284c8593c7d4095e08390b,05444a2f42454327b2ac4b463c0adbe0,1,2,1,1,4
2115,ee013bd449274984baeab464f48c9070,2016-04-25 22:47:24 UTC+0000,28909c9a607840168ef97bf00696e36a,fe95342734e04864a7923f6da4351ac8,2,1,1,1,3
7174,ee0f420ce26243e1b906a4ed5566655c,2018-01-15 02:44:35 UTC+0000,8843c6811f5044b3bf2115da0c955fe3,598351eefc5d436dab91070c7a0e6ba1,1,1,1,1,3
6752,ee177658a70242dda77fc0003ee1a6e2,2014-12-03 04:07:37 UTC+0000,14830efa64ac4762bf6ff551fa2f0daa,e54f9b0de46b4bfd991ee2c845c0733e,1,4,1,1,6
2252,ee3db0226c604300b4688926366decc4,2016-05-19 13:01:31 UTC+0000,c8f45f423ddb48e08fb23db75b01e667,7667c23d26ab409ca3e49758f5367925,2,1,1,1,3
4417,ee4027f9ba6a43d599f22e04dceabcf6,2016-03-03 04:18:45 UTC+0000,91530a713d8c45799f16bebd144ccd34,b9b4dd3e497548d0b5c2aba2b069430e,0,1,1,0,2
4907,ee4361057a7e41fea44b320c94927428,2016-09-10 23:17:22 UTC+0000,032c8791aa1e4de6aa4ab10e1b1dd9a9,db959a523bb34ff4a254f2411a40cd37,0,1,1,0,2
7454,ee4dcea95cbb428fbb67593e572c0a12,2014-04-24 18:00:06 UTC+0000,92c3a1bcd11a42c2bbf65ad32a31acb4,05444a2f42454327b2ac4b463c0adbe0,2,4,1,1,6
6332,ee5286c13b844d36803546930725d1f9,2017-11-16 20:44:04 UTC+0000,6ca2342c414d43e385c748515d757e81,4e9fe7ffb54c42eba0987c6119da9975,0,1,1,0,2
3437,ee62484a77fc4a43a5bff757d109a867,2017-09-07 13:07:38 UTC+0000,678d46e1948644c6909405a0190d317b,d1f04208de3643c088f4a25e57f1cb2d,0,1,1,0,2
5353,ee62efa992414005833ec1ff92f6d678,2014-04-10 03:32:28 UTC+0000,10aa842cb7274055a54ff04a8b200ec9,6774ee9e8f9247728dbbe896726e911a,4,4,1,1,6
3068,ee74c8024d8242daa1973828b474a627,2018-09-05 02:23:07 UTC+0000,12c8895b647b4085bbd3a99a6ad747e8,e2b4c84bf1ca4aea9b108869692d8017,1,1,1,1,3
6515,ee8af74b651c4ed9931ac7c1b99423ca,2016-05-13 23:15:56 UTC+0000,d0d155e79b3b47df94df758ec1ed8ec9,20dbfec7ed9d4c74bc18bf3a25795b93,1,1,1,1,3
5202,ee902ca4e1fc4c4ca88b4b70900bdaf6,2016-05-12 00:27:51 UTC+0000,7c523539ccc04becb12fd4fc403f553d,7b0d60a968da4e49b6e4ee60bd782110,0,1,1,0,2
3604,ee99e93e2f9a4700b6b90c71384fd4f4,2016-01-20 22:30:16 UTC+0000,f2b8cf18d7674c30bc73afd591d0527b,36ff3b3666df400f956f8335cf53e09e,1,1,1,1,3
4934,eea4a5fa21714d21be6f26f3a6e8e3f6,2016-06-28 18:22:08 UTC+0000,f81deb5e87d9497b8f84971bdec84267,89ffc7c3266344b68c2dbce832d102f6,3,6,1,1,8
1463,eeb03f7a719d43e09fb37a27d2ee0573,2012-01-09 04:23:34 UTC+0000,398ff3f3bfce48ab922a23b13ff08a9f,392a273cb57b42389ec01a8fcdaff3af,0,1,1,0,2
1829,eeb7bb7ace0b4964aa803454141c8a48,2018-04-07 13:04:54 UTC+0000,a30805e7fe8242eaa3b1ec6dbe653884,8b30413febb749f582781486ea22f40b,0,1,1,0,2
974,eec2101d3f5749388ed053da3873cce2,2015-03-27 13:36:47 UTC+0000,cde1edb661414f27aa1acd70586446b2,369f1c8646b649f6997eae7809696bd5,0,1,1,0,2
8024,eecdc737f0ec431ca3979e8324ea61bb,2017-01-07 01:27:15 UTC+0000,fd111edf395144ccab579d034371d961,bc46e3699d92477ba8c7aa723e54a151,0,6,0,0,6
4596,eeecf59f2a0c45f5b66d75a92cb32e5a,2013-09-29 19:31:36 UTC+0000,cf5ba241ef6a4a9384d0b951503d9aa1,0dc4c381bda94701a967703ccec5c676,2,1,1,1,3
909,eefbf71bedc8498293952163566e94f4,2016-04-10 17:12:08 UTC+0000,232476b643ef4cf0aa6a37009eea6d5c,58fa5e95fe9e480a9349bbb1d7faaddb,1,1,1,1,3
2382,eefed7a9395f4cc29270fb2bbf23b38e,2018-02-02 22:35:07 UTC+0000,c0c5ee5c3a754c39a3140c755aec4639,a6d33c38902546849c36ea7e9e9f0870,1,2,1,1,4
1140,ef0b4bae85e442df82cfd4807f460d2d,2017-05-08 16:48:33 UTC+0000,c68c384df8ac48b1a248e75ba52778bb,74caff936fcf44fb8d2074cf0b95e07b,3,3,1,1,5
6649,ef1213a0647242539b0550feaadcd9a3,2017-08-21 11:54:24 UTC+0000,f125c17997964c1aa4a9851d7b6e9791,e1d39b665987455fbcfbec3fc6df6056,2,1,1,1,3
5694,ef15fc03d6cd45b786bf2f5a9fe071c9,2018-02-28 23:32:20 UTC+0000,6c37e05b342841fdaf8e3b7e60299c4e,56b2039cc2364c469a039753229a09ed,1,1,1,1,3
7472,ef16cc092a3a4b69b161935c3eb349cc,2016-04-13 00:17:47 UTC+0000,a0e8f1ad4b18452d867aed599ababa4c,1f29954e507c4df38db0ed1931695ef1,1,1,1,1,3
5250,ef2ccd145073469c9b4855a4c002a3c2,2014-04-22 03:52:49 UTC+0000,0c045e1c26554cf1ae5bcc2561789951,fe4543418c0846e5a65fa22b4ad9a304,1,2,1,1,4
4372,ef4a4d68494942cdbcc18a1cf2f81a11,2016-04-13 22:45:25 UTC+0000,ee338f3e55674986b7c5e5dddbe06dd7,a1006e6a58a0447592e2435caa230f78,0,1,1,0,2
6068,ef65467ac27345f6898590e6d740f5ae,2014-03-22 10:38:11 UTC+0000,1cf9c6bada0d435ab0bbe09f71d38ac7,f33a960155944fb781de493e371ae46f,1,1,1,1,3
1886,ef6ac6ba148049d19bd931b02e47a2c1,2018-03-02 22:30:06 UTC+0000,1590760744974795a2c265ac9f0a531b,58fe1bcef3244ea0b027bcfdca6e8134,1,1,1,1,3
4140,ef73f9c6b07243db839eb1eb83cafb17,2015-03-17 21:54:14 UTC+0000,28c1177fd9b64995af626f8d0c57f96d,f96f59f78b4c4c4dafff870b194d8794,1,2,1,1,4
6070,ef75944e5d074cf4b62ff35e781f9c90,2017-01-26 02:26:30 UTC+0000,4889ccc4f677448585cdc8e3dd3fa9bb,aa27976302f04c74a36ac18825e490c5,1,5,1,1,7
5718,ef77b472e7fc424299b7b93cfba06760,2016-05-27 13:27:07 UTC+0000,af94f61fdf904f75b274012f04fb3a07,a5806385db1845cc996f66a99cc19dab,1,1,1,1,3
2582,ef8473680b37471ea18541221b113199,2015-04-10 01:41:41 UTC+0000,42cf02e09ef049e1988974ec4408e7d7,198ab88e6873420cb781f1c7f041c1cd,0,1,1,0,2
3776,ef919d0c9c254caa8b11f329ccdad643,2015-11-18 18:18:14 UTC+0000,7465c37e1707456ea43221be3a5b6624,a1006e6a58a0447592e2435caa230f78,3,4,1,1,6
4021,ef92791c60ce4ebab0cc17e65953f5b1,2016-08-24 00:30:40 UTC+0000,1ed2969b4c4a4f84a66ae206b57126d9,50d1429c5c6b44b59e581b53c92c60b5,1,1,1,1,3
7013,efc89bf99fdf4ff2a7f1e33c2f7712c1,2017-01-24 14:24:07 UTC+0000,53c88bf90b2841459ba9218a8e285888,e798ef62c6974392b037e93acdfb5aa4,0,1,1,0,2
3870,eff4c632bde140de9818bfca1d0661a6,2017-09-03 22:38:05 UTC+0000,051032482b644237ac457b6554d89639,637df4b5df8842a396d7aad92bb498a1,1,2,1,1,4
4123,f005a131ce86488e89b6cb688a6558c1,2016-05-05 01:32:41 UTC+0000,0d68f462f9fb46689ed7f887a6e1ea39,e1d39b665987455fbcfbec3fc6df6056,0,6,1,0,7
5811,f012afc8eb3b4c659a546f742dbf5d76,2018-01-30 04:19:00 UTC+0000,567e94a6a22b4beb9e8b3781714b8e5c,4b7737cb8c46400795bdba3a4f333997,1,1,1,1,3
4228,f0174046ee1b4353b8399b356c89e982,2018-02-23 22:39:10 UTC+0000,69adcfc8a3dc4d96acbd28a3d638e2df,864b256290d243d38afb68afe60d847a,1,1,1,1,3
4110,f0180900ed804359bffdf3f56c8ff1ca,2018-01-29 17:51:25 UTC+0000,ece2c789e45a40e3a84d502428a60637,369f1c8646b649f6997eae7809696bd5,0,3,1,0,4
756,f0570c67196742a58bd69d03dcc438a8,2018-09-14 21:19:58 UTC+0000,62210071cc3c406c9bb8af4737ca153a,f04eda3e22244009bef72f4ee0cfb3b8,1,1,1,1,3
5,f05b579f2cd3432898f3ba54feee86b6,2018-05-04 15:07:45 UTC+0000,9d1a775e148f4e0190a24dbebe53665f,b9d984e161c64171a9018e02b03eab3e,1,2,1,1,4
7349,f05c3076bbcd47e5beeef4f201e3730a,2018-02-16 00:13:54 UTC+0000,1ccc33a6788c4b4393d7722b192561c3,8e7a93e0afa442e0bf63a3cb9824562e,1,1,1,1,3
3781,f063a08a10f6452ca0d586ceb4a4e23d,2017-02-13 17:17:14 UTC+0000,4c04e001a285471b84f49249f9b16da5,dbfc21fbff414832beed41c7a5966096,2,1,1,1,3
3085,f0678b750f3c4077af60eec8021655e4,2016-05-20 14:00:36 UTC+0000,76868af5faa14df5b07af796272d453b,c045fc0d5b7445128cb945450ac8fe66,1,2,1,1,4
7202,f06c97eb1ef046baa8047fdae9126933,2018-01-31 19:55:12 UTC+0000,28d9b5dea54e41df9a13190b6e673eab,f7314586021f4459abd41ede3a031919,0,2,1,0,3
3242,f0965ac5d1594177b1a933a624545fb9,2017-01-26 23:09:42 UTC+0000,a8a0cbe6ce934bef92d4fa0c6ade3e63,12e8dea2f3534f6dbc31701cf64f9a4f,0,1,1,0,2
6660,f0a69098406f403f91e8ed1db2bca097,2015-10-27 16:56:46 UTC+0000,70b953b29db24c999459db9dbf505621,a1006e6a58a0447592e2435caa230f78,0,1,1,0,2
4098,f0c3416565454c9f97b87484809ffd4f,2016-04-25 16:13:17 UTC+0000,a3a945372bad43afac4d6794065a6486,36ff3b3666df400f956f8335cf53e09e,0,3,1,0,4
3111,f0d4bd369c704ae888b600a8cfa00244,2018-10-29 01:17:29 UTC+0000,74e59bfd5ffb43bd9c05e8b3b4fa0071,95bf1a3ddaa24e68a153984e081b7b58,0,1,1,0,2
5620,f0df92bfdcdc416aad47ed26e8fd9fc2,2018-02-15 00:09:35 UTC+0000,ef984e9814844de891999c9d6fe14703,c2052c6c448b42449e25510a69e4046c,1,1,1,1,3
917,f0ef991da1da4abc8dd2611f3a6b3f07,2016-07-20 16:09:07 UTC+0000,170696bdd2704b1d8f84c6de3f15f65c,a6009911b9cc4d09a19d885a95947e6d,2,1,1,1,3
695,f0f74e63b05a4ad7b8a92e6e108ae545,2015-10-28 16:42:32 UTC+0000,56936c44426c421f89f39f6b0c394096,369f1c8646b649f6997eae7809696bd5,1,8,1,1,10
5872,f1070a4d3d4d443096bda466eec7e8ff,2018-03-22 21:47:57 UTC+0000,b46f3498d08241f9900dc69427ad215f,19c30dfeabb64b108617c81d87f538fe,1,2,1,1,4
3303,f1175bdf8ecf4e18ae55b0820d1c9bf7,2016-07-22 22:02:31 UTC+0000,ada1d4d8d10c4228b1503e661f884130,51f8b7887c204f71b3feb33693d9f08e,1,1,1,1,3
8011,f1309bc2ef094e5589fb7114fb28ab81,2016-12-26 16:15:46 UTC+0000,4d53aa12d84e4f8ca8d1e633a22c34f8,36ff3b3666df400f956f8335cf53e09e,1,2,1,1,4
1856,f138ede350344113858ceaa2f5feebae,2018-10-30 19:23:48 UTC+0000,fb7d99f0031d41edae1c735f48c0ca37,e27c43e8671242e1bfb80829744ee3ad,2,2,1,1,4
4878,f146b2aabb6c45ea907b21f9027cedd9,2016-07-10 00:27:04 UTC+0000,5173753bbbd143c4bffa969b2445c43c,1ea72b656c6c4dd8830aafae206e3b3f,2,2,1,1,4
213,f14a85dcf0614e39953d0294791b9a73,2014-03-06 20:28:21 UTC+0000,48b3de66ff7b4f9287767583102be111,31a0f209fa6842db89818c08b43870df,3,4,1,1,6
2306,f14cbed086904382831821b6b1dd634d,2017-01-23 23:32:31 UTC+0000,4310b7e9845a4e3891002059f7598930,c423b56f85034f50a12b0a8600ac6e19,0,1,1,0,2
2431,f1599206a978403ba61372db4e7401db,2018-06-18 17:06:54 UTC+0000,c7efc6bda3bc44a7adbd0093354ea86a,cbf0ce871ae44dc2bc40a804ffe35611,2,1,1,1,3
5252,f15ef3373aa44fc086ee84dfea986d97,2016-12-14 23:40:28 UTC+0000,583c5d695ace4bb7a0d79df3bbf294cb,b0c289fe05884b889ac98cea3d47a111,1,2,1,1,4
4970,f16892506e5546afb1aab275eccb3ada,2017-02-15 04:42:30 UTC+0000,beed4e5d4d2649a6b0bffa4a6ce8bae6,2a3644c6f5d140ffbae97dc57f9ce2f3,1,1,1,1,3
764,f16b73e6e0b347a4ba021d35a106380f,2015-03-02 19:37:32 UTC+0000,6716f3e2cda34d708fe063317bcc503c,369f1c8646b649f6997eae7809696bd5,1,1,1,1,3
4958,f17aaa2acd274701b715422ed488f4f6,2017-03-29 03:54:36 UTC+0000,5f9478b6598a4d359580c8d4aadf3bba,1d09800aa6804f3c92a89decf1bd7fa5,1,2,1,1,4
7081,f1a3fcf817034fcdb91310ab420a7107,2016-09-20 08:03:22 UTC+0000,8135491882634423b6fecb37837d8091,8ee08a03d4db4eb7b34e378d6d3d31f4,2,1,1,1,3
7750,f1a52030c1914059b895333748d32680,2016-06-22 03:19:33 UTC+0000,c7932dea8cea4ffa961a7327d75c3ffd,f4759af9b17f44c9865b041a0469dc45,1,2,1,1,4
3116,f1b079963cff4758a23b4df39670155e,2015-06-15 01:25:16 UTC+0000,da3face4e962498a884abaaf331ee4d1,9428eb3c67e540f3a1d3e5f2649656dd,1,3,0,1,4
2425,f1c39c95e0974870926f903e9a8dde75,2013-06-11 13:58:54 UTC+0000,231fc3e19860422a820a8348db08146c,3b36e9551869457e80bce144cda7c7a7,0,1,1,0,2
1210,f1c7d867b33d416db6af5de3a2c3a46b,2016-06-17 23:36:21 UTC+0000,1259191e23f048b9a69f7e5ee7f2a2e7,f0f24b013551445a9039e1f11455c581,3,3,1,1,5
4661,f1d598f2a7034b0da73c39666b3d69b0,2016-06-19 20:23:54 UTC+0000,1d62c038a36043009942d7cae954873a,58fa5e95fe9e480a9349bbb1d7faaddb,1,3,1,1,5
5530,f1dca534c8f94e60a2cf076ed2f062d9,2012-03-29 18:04:58 UTC+0000,f227847e08024cb2a6b1025f2766a3d7,f43cb922135849c58ef534f2e3069b51,4,1,1,1,3
6152,f1de63fb14404c0baca2e1908bbab321,2016-10-23 18:25:45 UTC+0000,eda06b3aa8d34c90a86738846be8c7b9,b9b4b982f64c40388281e97c7d5cfaeb,0,1,1,0,2
3164,f1ded33a92de459ca35333396e076b55,2018-06-15 11:32:23 UTC+0000,8bc77f12daff44dd97ecae521b7dae33,3b5c5425b24d4ba0ae123ae746dae9f4,0,1,1,0,2
5108,f1eb046d1a084c7bb437c577fc3f75f8,2017-10-04 16:00:21 UTC+0000,f83ca887d84f410a8b9c3bff43febef4,6781088591b4446ab9fb3ed9e2d92ddc,0,1,1,0,2
1318,f1f8eaf6574f4569aeb05c25447523bf,2017-06-01 22:26:58 UTC+0000,0368e42b046148f1839f3bfa2dc1691d,da5f0069bf65432680a6807651c41228,1,1,1,1,3
5612,f216e48b55b649799039b2239cf846ad,2017-01-24 00:03:30 UTC+0000,f8de51bc63f34acaa72be2fc87131a19,b74860355dcb4cd7a24efc7e16427589,0,1,1,0,2
4810,f22da830560047e6ba7e6cc10ff503ef,2017-11-07 18:43:43 UTC+0000,09cd02a0edf84917ab7838db36c30f0f,74854c5906b944f88548e0db1db3c5b4,2,1,1,1,3
2002,f23650d94a1248debbd152bcdc28c58f,2018-11-30 16:57:40 UTC+0000,7bdd4b8c57f941ef884299ecf5d04c18,9c3c40cbdbfe4ee3971a3d766aaae221,0,1,1,0,2
4899,f23b7c0ee26c485a963b8dd0dfb7e30e,2016-10-17 13:35:56 UTC+0000,8dd3b4fa16bf451c8a666376f7d52326,e6b29607f1504bc9bdb81783016df845,2,1,1,1,3
1369,f246aa586f3b433ab6977dc44fae644c,2015-03-24 21:23:07 UTC+0000,64385758a6b14815929d123734c40252,e248a06a65c148dbb3f2c166dbdb2148,0,1,1,0,2
7818,f2495ca1ce7e43d0847205d83f350105,2014-04-08 13:55:34 UTC+0000,a06b731939ea4867b6e1ccfc91d39781,fe4543418c0846e5a65fa22b4ad9a304,2,2,1,1,4
8019,f2522d2c4f8a4e0a88eb0046f2501806,2014-07-18 14:45:25 UTC+0000,caa34fac7d894dfabe687e02ab84f775,dc083654ba84490d914a698ffb0e1de4,2,3,1,1,5
1535,f262475db8a14c11badc9034495c5e7d,2015-11-09 19:06:17 UTC+0000,7167bc8e3f9846da913c6c205a9f5435,a1006e6a58a0447592e2435caa230f78,0,4,1,0,5
1174,f275dd9de9114b89863e15da0311f9a1,2016-06-25 05:10:18 UTC+0000,ae3dcf3527194eb28eafa0845cb95df4,327e3aeb0e174b8bb49ab6bc75ca3f89,1,2,1,1,4
1097,f2a9914f10584a1d9645acba4220758b,2016-11-07 17:53:33 UTC+0000,7c6ab6af9ba341ed8f29bc8ba9921707,369f1c8646b649f6997eae7809696bd5,1,1,1,1,3
965,f2adc88e4f7d45468701042638c34a13,2018-04-02 05:41:33 UTC+0000,3df7c4f9a25e402593950e31da898702,be5d23056fcb4f1287c823beec5291e1,1,1,1,1,3
3657,f2c6ab01a7d64eaaac26ff706ca56db3,2016-10-28 09:33:45 UTC+0000,64f294e004eb4ca8b8e12e45547e045f,28ca854bc69c4630805fef5d6cad0ca4,0,1,1,0,2
7610,f2cdda1f7d9f420f879e697fae1869f2,2016-12-12 21:08:52 UTC+0000,74a04f296fe94eaf99a378560abcb8be,ead34fe989d9426fbe214db2cc3cb08b,0,1,1,0,2
5484,f2cffa6d72f641ebb1d68c8e4992e3eb,2016-05-26 00:40:22 UTC+0000,38a1c35d185e4266bfe01ccec4657d20,c232fdc3917c48ffbb7c9375a460d358,0,1,1,0,2
2905,f2d218bbb3ac4b0ab195de809238c86f,2015-12-19 21:39:10 UTC+0000,fb1114881ec04ea0ab64dcaab43e4d31,a1006e6a58a0447592e2435caa230f78,2,2,1,1,4
2837,f2d64fa2bb26459c87d0f37e8dfd5de0,2016-10-29 13:29:39 UTC+0000,e9ec069f52834dce858a83c14cb7b39c,1e7901381ecb4da48a854bd4e826d14b,0,1,1,0,2
381,f2d7443288a24b9095e9c225c2efbb71,2014-05-08 16:08:24 UTC+0000,4066830e0cd34197bc9365857eb00b90,1c709c47de234afa82d00b3f0fa624ae,2,2,1,1,4
1122,f2e27be961c548d3bcc7b58326a19192,2016-05-29 20:13:36 UTC+0000,30e74bacf4b742d99aca41e0eec130a9,36ff3b3666df400f956f8335cf53e09e,0,2,1,0,3
5018,f2e2d1a316a84e7b9f18c9c447179d08,2016-03-22 19:04:53 UTC+0000,34ec14fcd1a641db8986196f8a879daf,2895012229734b66b36fe1ad2541b975,0,1,1,0,2
1994,f2e8f05d4e46477ab58b445514fd262a,2015-10-06 17:28:30 UTC+0000,db0c3fdd780744e9b4ffede0720ea57b,a1006e6a58a0447592e2435caa230f78,0,1,1,0,2
7805,f2eb331033ac4224ab79c46139c1af53,2016-09-13 06:57:23 UTC+0000,4d85fe87486a4409a393500677607774,fafeba89ca764bd891862fb8440a2962,1,3,1,1,5
7224,f2fe200ba8ff4b19a77fdb1afb5c0dde,2018-02-15 19:56:05 UTC+0000,5a841d0e3af44be9a5770788f1dc407e,cb51085938ce437398ef1648feb580ef,1,2,1,1,4
4931,f2ff1183ce004206943b54dcff1faab4,2019-01-14 23:31:23 UTC+0000,4d9d7f5214634b6a8167c9fe331f7b7b,528e3d220bf8419a843b30dd4627b958,0,1,1,0,2
6606,f3044aa00cdc4a3f8bbc34dbb329ada4,2016-08-22 01:19:01 UTC+0000,3157775b47cd4823844d4cd3fdb62a58,58fa5e95fe9e480a9349bbb1d7faaddb,0,3,1,0,4
7651,f304c9d80bbd49e3b2d7056dffcc3c33,2016-04-29 14:11:15 UTC+0000,3da4488630474d9491cec9a829dd6c4b,677f47d4daf5467f9ce9b5a0611d3ffc,1,1,1,1,3
2863,f329df993a774109bbf8d840f3848cfe,2017-09-18 01:56:05 UTC+0000,5ce39609f95f489bb24c59057efa8ab0,688e670f4f324ad693c7fdc00dc058d4,3,1,1,1,3
3029,f32ef2ea4f994e34851ec5be64e815c1,2016-05-24 23:27:59 UTC+0000,967a31ce144845a1b43b5641b9ef40c9,030fcbbba31647938b176a90c04e38df,0,2,1,0,3
5141,f351f0bc7693427d8c1ac89c05ddd9e6,2016-03-03 14:51:57 UTC+0000,1b81a44fb3d142dd8561e2ca21d8c2f1,67dda43361744abf9b9c0ddfe47c3f8a,0,1,1,0,2
950,f362833053e54c919213936c0b192317,2014-04-13 13:23:10 UTC+0000,30e1a74cdd7d4c18ac3109a93021ac51,4a71c85e58dc4c1a8546574188582a92,1,4,1,1,6
4322,f36808fbaaf34ba19ccbf9669afe640b,2016-05-12 00:31:50 UTC+0000,13c0ea29f1814fea9b2d5a1be50207a3,7b0d60a968da4e49b6e4ee60bd782110,0,1,1,0,2
228,f38310cbe26f49c9a660601430d369f0,2018-05-21 16:11:39 UTC+0000,896a34c1159d48578a89c1b220826aa5,899144674c394f31acf3aaa93c998099,0,1,1,0,2
5011,f39f40aecb134d9c835ec996b369d436,2018-07-10 15:27:49 UTC+0000,65bf513c4b3a48e396074fafb5a8113c,36ff3b3666df400f956f8335cf53e09e,1,4,1,1,6
6597,f3aaa7b09dec4089a1cfa6fe6f0f4524,2016-05-13 01:52:46 UTC+0000,642f736a341546458941a4fb39e7425e,be5d23056fcb4f1287c823beec5291e1,1,1,1,1,3
1858,f3ef71ab776a4eeda55014fcf306fa85,2017-04-02 00:27:35 UTC+0000,efe570cf19f74c3e991115560b77eb7d,eafd52f2ce7d4a33a2438ac316aec4bb,1,1,1,1,3
3682,f3f67d59de0a4581995a361834e8fd0e,2016-12-07 14:24:14 UTC+0000,27a0d6cb2c9b4004bd56b9be138b55b8,4c691b8dafb24b5db301250a3964867d,1,1,1,1,3
2330,f4075fbd561f46efbe8bf3b3bf2b90ee,2017-06-28 17:15:00 UTC+0000,208f1b4963304cb49f76b0a66700d529,706f283944ed4eaba869416036950377,0,1,1,0,2
3994,f40a5b1187254f97b16b07142920b2f1,2018-02-28 01:35:52 UTC+0000,dc00977e690844fd826153536ebc5ec3,7d18b6b5c2ab4c038c8a1f0a4753c35a,1,1,1,1,3
8006,f40dfdcfe6b045e1b13d3b0eb5e2fe69,2015-03-18 17:09:40 UTC+0000,ed553958567043159bb5cdb35db8916c,369f1c8646b649f6997eae7809696bd5,1,1,1,1,3
4993,f42fbb70309940cf935cb4bf71b1f7aa,2016-06-04 19:12:15 UTC+0000,c8f7ec23b2b5421bbdc5486a52a4542a,58fa5e95fe9e480a9349bbb1d7faaddb,3,6,1,1,8
1957,f43e21d4141747248a71bd073e68c117,2016-10-28 04:03:52 UTC+0000,142cfb285ffc40bdb39aff5bb26082b8,98dab85fdb8e43519a1ab1138c0f706c,0,1,1,0,2
4999,f445df4afcff49ecab62a8fc62e4eda1,2018-03-20 21:35:12 UTC+0000,183311682852455ba09f5a4d92b117c9,96ed93bcfb6d4a2aade68c91520b9994,1,2,1,1,4
6845,f446f4caddb24ebf8053dd2f54acf2c0,2017-09-20 16:58:23 UTC+0000,3093e28c6c37453e9190e07823cf174f,85d29548f8ab4f4da9f383ffac05023e,0,1,1,0,2
4287,f44eb6368c6a48e2954011ad10dd909b,2017-02-27 01:23:29 UTC+0000,1763bd69580649ee89d5331824097278,7919ea19db274c1fb862f3456cd25ac5,3,1,1,1,3
6904,f455b6f63d2445b1b48d429b2b9d0b0e,2014-03-24 01:07:41 UTC+0000,375e67ea5b854145929c026e4a470af0,cd33fd35feeb42c8a8683c74dbe0894b,1,1,1,1,3
6741,f4563845d0fa4b879c50c2df22520f57,2016-05-04 21:11:32 UTC+0000,b9ee572c5d794db4a401188346a1c0e3,656f79a3e38d46f8b6a311209cec6690,1,1,1,1,3
4510,f4572dbbe99f4e3fa36ccd832daed02d,2015-08-04 00:58:49 UTC+0000,64461a9b6b3b4815b316cfec1d2bcce9,5d80b9cf27af4e4e8a214e5e0c344b4b,0,1,1,0,2
621,f45a9f62d4894f6dac4a6be5e7d1f0bf,2016-05-03 12:08:50 UTC+0000,669f50d546c94e638e6719cb8205f850,5ec9d442785a423ab4c0bf1dd110071b,2,2,1,1,4
1982,f4629753f97d4f2ea482948082217bcb,2016-09-28 15:00:47 UTC+0000,a28683ea4eca47bdb15fe042ed3e396c,94f6c370e61b4ae8b3f0c70466de7ca0,1,1,1,1,3
2021,f470aac3452241d4a41322279f7c2d4a,2014-03-06 00:01:01 UTC+0000,af239743913446b0a4488cda542ccace,1fe901e0f6bd4bc1824a094571366be4,2,1,1,1,3
4698,f48caf4353714e18a837ec26855dfbd8,2018-03-02 10:53:32 UTC+0000,4680a20f07ff409c86fe08ec3077774f,9b30b20a961b4f41842c93887417b455,1,1,1,1,3
3104,f48de567d0ff4584a4cf190dfd17c94f,2018-03-20 23:33:37 UTC+0000,8258fe23d4474900ace518e11b6b2e50,e6fcbaaefe104845ae12fec9cacb00f2,1,1,1,1,3
4801,f4919658c7874a4b85c5d3390ab0635b,2016-07-13 00:37:32 UTC+0000,7be6aef2430343ed99cf765e0635f14b,f68d6ad3610b42f48b470e10defab872,0,1,1,0,2
6500,f49a517e37964c58a3077cf905de9ff7,2016-03-07 20:12:58 UTC+0000,32f19d90e9334850bd41c798356de633,a214262be8684318b78ffc54ec4292e2,1,1,1,1,3
1826,f4afe46ebe3b42949d349c162f63bae5,2018-05-23 23:18:01 UTC+0000,610922ea429d4656b38c455556b26834,4dc61581ec7b409bbd037e483f53ba0a,1,1,1,1,3
523,f4b9903114c84abca94378356ec1e7e5,2014-12-23 01:59:59 UTC+0000,5feb695e9b0b4b7dbb557fe18c545090,2796213fb0324530bb206915156dd136,2,1,1,1,3
2189,f4bc5ea881fc4b8483220c21acf1757a,2018-03-23 17:51:29 UTC+0000,12aa6b47651a41baa8369f9b159874da,ee923f80ae2d46ee96ad5677da81cbbd,1,1,1,1,3
5727,f4e5d03a994848edb5f1ac2465c37f7c,2016-05-25 00:07:38 UTC+0000,10ce606ddcbb436e869abbb5759613db,7197b8bc171241989c50e1ac93836947,0,1,1,0,2
604,f4fc15d4b9fd4f6f8d4dbb8cdc90d332,2017-02-13 12:41:12 UTC+0000,df4cf45c085244f29e71f0815527e14c,d9bae0de3da04c7ebbe0879d410a8179,1,1,1,1,3
4397,f4fcf0fd8c25495cbc02040d0957413a,2016-09-17 23:47:47 UTC+0000,0b87e265ef00407abf0061db99526ccb,be5d23056fcb4f1287c823beec5291e1,1,1,1,1,3
7951,f500a7d37bd4434383cf8854baf0b223,2016-05-02 23:38:45 UTC+0000,510c78840efd41ff84a2a3d66cd572dc,32099f8cb6a846148eea6b7444c913ca,0,1,1,0,2
5499,f51fd20b594c4400a8cf473fcd635109,2016-05-18 14:54:22 UTC+0000,4efbc550130b45b180c8b780f9e0f09c,7bffa1792d474359b922e5de700d7a82,1,1,1,1,3
295,f5339d3ebe484da7829fdb839a5024fc,2016-09-29 06:44:04 UTC+0000,4c23ca80ac8949b182e0de59c3fdde01,80393b804c5f47dc99ff42d55fdfdd58,1,1,1,1,3
2301,f538c01ffb2341aeae5511121d9f44cd,2014-03-18 02:01:18 UTC+0000,7e3b1868044948b99e3b6c3465191dad,f33a960155944fb781de493e371ae46f,4,1,1,1,3
7910,f53af4783ce94b6d949dafd1b85fd3b9,2016-07-14 15:42:54 UTC+0000,d86e2c36cdda4e6a949e3e3c280645f8,a6009911b9cc4d09a19d885a95947e6d,2,2,1,1,4
247,f53c3029d8ce4b56b5c652fe70153147,2012-06-03 20:52:06 UTC+0000,d282bc1a75e04b7688a1b1b654d96a76,392a273cb57b42389ec01a8fcdaff3af,0,1,1,0,2
3033,f54945c5539b42d895d4389436b7cf26,2016-06-23 11:23:07 UTC+0000,c9c78191ce6f444d98837d54f44eda02,58fa5e95fe9e480a9349bbb1d7faaddb,3,4,1,1,6
4983,f54a33fc8f3b4fd387e8c3841c12f228,2017-02-05 17:29:40 UTC+0000,614e0727309f4a4d8a16d1a737545053,988a944fd88f4b22ba4e8d25b2ee39f9,0,1,1,0,2
3473,f554a8bb11474a27852401800b137513,2014-04-08 22:49:11 UTC+0000,0822d62c9e1c40ceadcac3f50b3055cb,b688e766eed04a37b7abc9218aca1ce4,3,1,1,1,3
1390,f558ad9a4cd0464ba6dcddee3344739e,2017-05-15 04:07:46 UTC+0000,b171590adaba4fd7881cf5a1ddf152ed,dc28056163a8447686e5691f4c1475b0,0,1,1,0,2
6975,f59a33b823fe45629cc68d4613788165,2016-06-23 21:42:23 UTC+0000,8c57f256d5d6477496e34c3ce7681332,ff347be2a46543598867792e3e6a54b9,6,3,1,1,5
7159,f5c5352d52e14408be069b5baa0711fc,2016-01-18 10:47:09 UTC+0000,27b128d41c9d4229ac089bb78f92f88c,c3534040428b4827a7aa1fbb69d11c61,2,1,1,1,3
7215,f5c95818cb534d5dbb741e050ac55f25,2016-06-24 12:54:36 UTC+0000,9885749af4214aa4b92a3194cf1bb827,36ff3b3666df400f956f8335cf53e09e,4,2,1,1,4
4722,f5d4ed469e814f1b926bf2425b5bfe3a,2018-01-27 01:46:46 UTC+0000,afa9e07b8f2647279a342acb0bdde109,3d8847ddc8d04185976a9e78b190ebdb,0,1,1,0,2
275,f5dab822f15f4ea38bc16a06a9ee8db5,2012-04-03 03:24:23 UTC+0000,4e4f804b65dc45fbb6e29de5db274d0e,c08a0cc55fe9429d93aaa18fddc5266e,7,4,1,1,6
4535,f5f06f23487c407caeb8ea933f6e944b,2016-03-21 22:59:22 UTC+0000,20cd4e8949074c96b3056a8d08db54c9,a1006e6a58a0447592e2435caa230f78,0,1,1,0,2
7538,f60393d9dfa041218ec28d3006575630,2018-01-02 04:42:01 UTC+0000,6a90e665a9fc491c9c347c040fdf9462,42408798c75348cc9e9a244eef5fcb67,2,2,1,1,4
2944,f6045f68cb384c819a2025f2d37aef82,2018-04-03 01:21:52 UTC+0000,672054e8be4a4297a01e77b767926fa5,e3e0ef78006d440c892e26cfca963dd0,0,1,1,0,2
3687,f60a5a6cc6c2419e84759ca79cb19123,2017-01-03 18:33:38 UTC+0000,008e01860e3f467dbf00713877e370bc,369f1c8646b649f6997eae7809696bd5,1,1,1,1,3
1828,f60b1c1e62244d25adfb7df6fe56fb05,2018-03-20 16:31:29 UTC+0000,79525854e53347f1af9eff48e66f0bd7,79fb430fd8964aef80a70167f84726ea,1,1,1,1,3
4875,f627979c515344bb9ca20d1df6186af1,2016-05-13 16:11:19 UTC+0000,29d72b791f18479bbeefb8a800465647,e719c3b6acc64682872a1ab413b851b6,1,1,1,1,3
1833,f6392fc29caa402bbe65b7fbeaaff4cf,2015-06-29 20:48:39 UTC+0000,62bb23184f67475288c24833cb421b5c,89fdcd2a7a944b1cb08b3ac8c1b8a855,0,1,1,0,2
1581,f63e17d855764851be9f324af9c8296b,2013-11-07 07:08:23 UTC+0000,2a44b6ddc19b4b1c9f5acad604859bab,4bce59e2537b4228adb73b856d2c6102,1,2,1,1,4
1307,f64933896d1f4813a7b2ef1dca107238,2017-02-18 00:19:44 UTC+0000,60e22a2387dc4c219841bc85db14a10d,d73c63b4d5be4da6816abb6d100a6371,0,1,1,0,2
902,f652e17a5f2546c69eba64cce7691a32,2015-12-08 21:04:11 UTC+0000,7cb82b9512bc44afb626d6f901c2cfff,a1006e6a58a0447592e2435caa230f78,0,1,1,0,2
7042,f653941763fd48718d4dfb80e082555b,2015-04-06 17:46:40 UTC+0000,785db86337be46b2b7c151bc44872e31,369f1c8646b649f6997eae7809696bd5,1,2,1,1,4
5249,f660ee6f49874b46b629f92962e5e416,2018-06-17 17:02:47 UTC+0000,d5a62bc0ba964e058e4de3dfaeb37180,909eb5c8d66e4fc185656ea6772b127d,0,1,1,0,2
2049,f66cc06f76304c1eabc65a3b1acf7345,2016-06-26 22:26:55 UTC+0000,516dde1118c848f6a8e82ec981c780a7,58fa5e95fe9e480a9349bbb1d7faaddb,2,3,1,1,5
1024,f66e6743c6954d798fc2f2fa888db6a4,2016-02-08 21:59:45 UTC+0000,b33dd49da79f4f9da67edd9b87f7ae99,a1006e6a58a0447592e2435caa230f78,0,2,1,0,3
809,f672ed3978ce40599ac01b662c425789,2014-03-12 21:16:14 UTC+0000,231ba039a5b14b1385ece8ffff9d1f50,05444a2f42454327b2ac4b463c0adbe0,7,7,0,1,8
6788,f67420b9b0854674b9405b39a4690385,2017-05-18 15:26:10 UTC+0000,f8525cc1284849e9a034d047474575ca,a8075e66d81847ea837a3ef3651eafbc,0,1,1,0,2
4321,f68163a8684e4c27a9f52fe28a5443f0,2018-03-09 05:07:24 UTC+0000,e7aaa0483d5b4419903984aaed5184ab,53939a491acb42a4815463845a638186,1,1,1,1,3
3239,f69e88c7cb104e56bf4c6c76601afd06,2017-11-01 22:53:34 UTC+0000,779d9073ce204e7f9db9bcc854806583,d7f9afe721af42b1a03a993909e0568c,1,2,1,1,4
351,f6aec5fe583c4b0dba47b4d44b788569,2018-02-21 06:18:12 UTC+0000,a0462609424046c3acf55301816c04fe,2f9b97d81e4945ec8e545477bfd9a856,1,1,1,1,3
7364,f6bca28ed0334b8d82a96e59a8d39f11,2017-05-10 18:37:01 UTC+0000,382c0108fd544f1e866e4885543ff047,e26af290b0cc4ca381f9241d661f430e,1,1,1,1,3
6032,f6c71e401ac343f6ad70124b3582f51d,2018-03-02 19:18:24 UTC+0000,1f791bc048e145f8890f18bab0cf7a12,0cf5ac636d404c3d8874a90c0b2f9442,1,1,1,1,3
82,f6c77f7bc22d419ea070398edf6eb979,2016-09-07 03:51:59 UTC+0000,dda9fcd93fa445a98844b9655796cddb,89ffc7c3266344b68c2dbce832d102f6,1,1,1,1,3
4869,f6c94afa9f6d468f9219f32674116ddf,2014-03-28 19:12:21 UTC+0000,69e6497db8be41ed955f6ea7bc06f474,0dc4c381bda94701a967703ccec5c676,4,5,1,1,7
4158,f6d7e4718e284664aac154e6d10ab18e,2015-03-21 23:44:23 UTC+0000,736a2fababbe4c87975f24bd030616bb,c1341204dce1463dad3964c3f3f462c3,2,1,1,1,3
3143,f6ef440cf7464cf3945792031e9ad829,2015-07-12 23:39:18 UTC+0000,1a2d70ac41e746cd8ea2e43178fbd04a,9d487728738c4ad59b3520fae53cdeaa,8,1,1,1,3
6737,f6efa41fd45f4980a78604752253bdab,2016-04-26 08:38:39 UTC+0000,ddd0d1be03c548e587a0516c88bc6c55,e01894b52bfb4eabb8791beaef276fa7,4,1,1,1,3
5365,f701caa0b4b84e71aac31088790484d3,2017-05-02 10:56:29 UTC+0000,1b3fb9d89f094e5da67631da462a112b,5c48a65be129431eb2669079b7941c21,0,1,1,0,2
6129,f70599f9e9af4bdfaee9cbe23136769e,2016-06-24 17:41:07 UTC+0000,9a2122f2f49a40c08c7c917ee4c9b337,42deada7c50c4859a34615d70193317e,2,2,1,1,4
1961,f731c48efeeb4499a4918a7fd3038efd,2016-08-23 17:23:23 UTC+0000,c44110aa78a7471b8947c348a5fd41ba,a1006e6a58a0447592e2435caa230f78,1,1,1,1,3
7207,f73e571df3454826a5792014a4e8997b,2016-10-14 17:30:33 UTC+0000,e3eb535a6c444ee38c87f8f87b09e291,36ff3b3666df400f956f8335cf53e09e,1,2,1,1,4
2929,f75245e0eaf14f74837f38cf85e0dbd9,2016-04-29 15:31:43 UTC+0000,38780a78af834e5c8a9775c767f3b814,677f47d4daf5467f9ce9b5a0611d3ffc,1,2,1,1,4
1288,f771c8cd09cc4d958cc593948009aef1,2016-10-29 06:08:04 UTC+0000,1ef9e30f8826498a9c5f098217b5763b,0f32136b796848f59eda325a18be8449,1,1,1,1,3
2965,f777f526f1b54ddca81f2759f0c96cc8,2015-05-21 20:11:50 UTC+0000,1cc01014a3c548ae9ed536b15b5a3238,a1006e6a58a0447592e2435caa230f78,2,1,1,1,3
4950,f77f6c70f08c4063bc3072df55dba4c3,2018-08-18 02:09:42 UTC+0000,c5d56ebf2b0e404f9b717f06261b1db0,02fa095b47fc49e3b7cef7f5565015ea,2,1,1,1,3
6981,f79edee4780e408ab339a919d0769b90,2016-05-29 18:40:01 UTC+0000,2b3eba20922d485494be6f3f50a0968d,e1d39b665987455fbcfbec3fc6df6056,0,1,1,0,2
5442,f79f3285fb46464cbfe737c6519242b6,2017-09-03 11:44:37 UTC+0000,d0a1d0c0ae344bd285aa01b5b02663cf,be5d23056fcb4f1287c823beec5291e1,0,1,1,0,2
3629,f7a249ea11bb4235bd048f5dbe997b14,2018-01-30 04:00:28 UTC+0000,bf729192d5994f66a4479c2193466ae9,be5d23056fcb4f1287c823beec5291e1,2,3,0,1,4
3822,f7ad8171570342c78b3d9aab6c659cf9,2016-11-16 18:06:50 UTC+0000,5405e9b589bc4e5e859e1cb5e55358b6,c95e299f6a6f430596493f500886cf01,1,1,1,1,3
7949,f7b8c57b20674845b74b609c9a6da55f,2017-01-12 00:07:20 UTC+0000,1b5ebdb5a89b4b3a88b7bf574547b7c3,27635b0b3d00420e8cb8c10f8ad9507e,2,1,1,1,3
3397,f7c01096a4464da6b43a4b74c1b0cd8f,2018-02-28 00:45:31 UTC+0000,32162378e0344f87aa933247ecf89b01,1ca4ea131d464f2c9b81ec2d50602f90,1,1,1,1,3
6364,f7d47936c73b49b2b480c7375a52acdc,2017-10-16 08:55:36 UTC+0000,01f64187bd264a8998f3521b11322a4e,cc108f1440844808afe5a249fe084490,0,1,1,0,2
7944,f7ec724c58be4b0583f79bce1e858514,2016-01-15 13:54:14 UTC+0000,c14f90c3ff584a56b4245c71a66e493a,653e3844ffc842e1af30923b14c17660,1,1,1,1,3
297,f7f020785e644658bb7ff407236306f6,2018-02-19 01:21:38 UTC+0000,0c205cd1b1484d4d95075ecfe4fbef76,a6d33c38902546849c36ea7e9e9f0870,1,2,1,1,4
661,f80431a80d344c838bafd0754ad4c4c3,2018-01-14 04:41:13 UTC+0000,e67b2648f32a4028b5037094651dc483,be5d23056fcb4f1287c823beec5291e1,1,7,1,1,9
6662,f81f2a783018492fa5aaf3c6092a70a7,2017-03-16 21:09:56 UTC+0000,5d253e8eae654c8783d2cf3086a365c3,0d806ccc4626495e958750103af56a18,2,1,1,1,3
3109,f8237c63598a40b0a1d2ee49db17dc59,2018-03-20 16:17:05 UTC+0000,eb446d2bb7d04e9fbff80c7521d472f7,24ddd9054e774b51bb92ab4d8668659f,1,1,1,1,3
2585,f828baec624e4959b1205e742dd96c22,2017-10-14 19:59:06 UTC+0000,63a08006f77c4812aa652b82713df1be,5a9f090193b84e73a32ce9ed1c4f161b,0,1,1,0,2
3291,f8294444f2fa4f78bc829f04ccbc06b7,2014-04-02 14:55:51 UTC+0000,7ea7d3f7ab8f45f5a6cf99ec4cee320a,5f4c8c5868cd442e8e0bc218b9a10e03,1,2,0,1,3
6739,f82ebdb8e9d04c3598ea8aea569aaa4d,2013-12-26 01:49:56 UTC+0000,4992c44a5e704312bc67ec76aa1a57ab,5eb80ecaf463458691b1f1d4af86e237,1,1,1,1,3
4639,f82ee54927af4873b0cded0cb3afbd62,2017-09-01 20:34:42 UTC+0000,a613806e55734d7d8c4804ef234cf1d1,88fba04fb7bc42e6ab416599067f6440,0,1,1,0,2
411,f836857360fe4ae6aab20138ab615978,2014-05-06 21:47:04 UTC+0000,8de19037337e4ea39b165089a37e32c1,19c30dfeabb64b108617c81d87f538fe,2,3,1,1,5
4508,f83ac86acdbd4d2b9b2b4671b8ba80b7,2016-05-02 21:52:26 UTC+0000,800dd4995f854d889b5f15d290fcdcb1,afb25a11d14c40e2ac3c6f790f64313e,3,2,1,1,4
1732,f83e0a3b04754c72b4d9e8e6e17644c2,2018-09-12 01:52:34 UTC+0000,7e21966962ae4f61b74f05d55a297ff1,36ff3b3666df400f956f8335cf53e09e,0,1,1,0,2
3204,f83f9f8f39034c5fb974e33082ea0449,2018-12-13 15:20:33 UTC+0000,8e9adfce8467423691d81cbe966dcfbb,a7bf251a290b418e923e8f04a67b7ebb,1,1,1,1,3
7050,f8483a1c5ffa44b5aa802440dfbbaaec,2016-12-21 15:54:07 UTC+0000,3f68dbd20d95403d8f807a3cb2d7fcae,55d363f3502e42329ec1896ccecb1b1c,0,1,1,0,2
7122,f8497e352d264c1a9f503393a8b0a91e,2017-11-17 16:05:11 UTC+0000,2b8184c36dd24f518b1094335f9ae4d1,4e9fe7ffb54c42eba0987c6119da9975,0,1,1,0,2
1041,f84de3711c484237981da90b4e945e0a,2016-05-26 13:56:30 UTC+0000,ad22b7e6d80c41ef8e412f4b4a1ada50,e00ca8adf6514ababc3d1d4548fa36ca,0,1,1,0,2
6654,f85528d267da44e8a46db24f0b0231b5,2016-06-26 02:56:28 UTC+0000,d8bcadfcabe24b8aa31575ec2338e029,c39329e6c790449f812590c3b897aca8,2,3,1,1,5
4772,f85d48e35cf34f83908a35020aa5fe3f,2014-04-29 17:32:44 UTC+0000,4b464bb8e4504788b2da69365f963b69,2873dd3ab32540958460316783461531,2,3,1,1,5
6349,f867844f1b904fc8bb3cf1afaec0d7dd,2016-05-27 11:28:47 UTC+0000,4fd2bc3927994cd08c3d8473a63af0fe,8c135c634fc14af2a15eb06303ca1f0b,1,1,1,1,3
7408,f8a11313c1bf462da97d171e1d4f868c,2016-04-25 22:46:36 UTC+0000,f5390ef93a4d4b7ba856726b2eec6ea2,629b2326269b44f2b691d3c8be7011d7,2,3,1,1,5
1208,f8b2c0f8e9694a999fe129e88f84e4c2,2016-05-19 14:16:21 UTC+0000,03788a2eb0c847bda215818e3503f944,3e03883293e94a8782beb98e18f37d2d,4,3,1,1,5
5808,f8b3c45a196f4577b12ff7581da6ba03,2018-04-25 16:34:51 UTC+0000,31157baffac445cb8004e07c298c8df8,bc46e3699d92477ba8c7aa723e54a151,1,1,1,1,3
7293,f8b6c2dc7baf4bb6a0245e926153e28c,2016-08-28 07:19:44 UTC+0000,8b9fb72b6de24af5ac338403642bb281,18770c021ef64b488ccb8b25a6e430b1,1,1,1,1,3
5843,f8ce516f49f94e37b10e370dfd2ea420,2015-10-27 04:40:42 UTC+0000,16682071500d4bb29b84da8b0213db4f,1731d1ea92604b7ebc5fbf15a221cabb,0,7,1,0,8
333,f8cecb7e8c9048fd810ee0c2f31c3c56,2017-05-08 17:43:03 UTC+0000,3dc33b86f31a4e9fa2a09f22dff8b03a,ace7c8056c834104a8378c86e7fd0180,0,2,1,0,3
1296,f8e0068cb83c41e1a8f1d23021ffe48c,2017-07-06 22:53:22 UTC+0000,e770ecf7fa214b87974c8bc6fd34cdb6,53939a491acb42a4815463845a638186,2,2,0,1,3
1695,f8e2d05bf64f4378bbe75ce1bc2a3227,2014-07-18 14:40:00 UTC+0000,528e24f2ffb446219418d634e961c3a1,dc083654ba84490d914a698ffb0e1de4,1,3,1,1,5
1663,f8fbc4bb4e73493e8f4d007cf49bd901,2015-06-08 12:26:51 UTC+0000,52bb312c7b754e318584629b30390649,e47ddebc38cf490c95ead61942815cd7,3,3,1,1,5
4711,f918b15d015d4936808e37908b77db96,2017-04-12 15:02:16 UTC+0000,b78781f9c2c9441fb38dc3d185d53eb9,36ff3b3666df400f956f8335cf53e09e,1,2,1,1,4
2927,f91c78b7ed584bad8d82c620a07f0b85,2014-04-15 18:20:01 UTC+0000,250c40c440f34ca598e2dd7097b3162e,95f1104e8b604c98ae237020a98921c4,2,2,1,1,4
3656,f91e5d59142b40e69cf2381c61a9e035,2016-10-25 16:09:56 UTC+0000,d6c3bcdce9224254a9c2b23c87e5a7a0,e4cf99a1cc884d97a46eb375f23834d0,3,1,1,1,3
7620,f937a88e44014ca89ec4cecf466c4197,2014-10-21 13:55:52 UTC+0000,5d056a488cb34776b13ffa5560bb821b,f3f77cdaafed4729b0fe95decacea3df,1,2,1,1,4
6638,f93d79a74a834e02877914fa83f4f035,2013-12-10 21:22:01 UTC+0000,60af05b257c24aa2a85ef33c8e1b7f04,f33a960155944fb781de493e371ae46f,1,2,1,1,4
5044,f943b90b1fad482faf997901e9f710f0,2016-06-22 23:41:07 UTC+0000,c89b973dcc6c4627a657cf71a94fd085,3843a956582a434eb0ebee396a71982c,6,7,1,1,9
5554,f946f4b7501f44e6b7a8c1c73257e6e1,2016-05-23 13:37:31 UTC+0000,b1a6e621142946f38d5214eeb72cd220,13b55ed4834e4814bb33a4c87001063d,0,1,1,0,2
6393,f94b6c5eba1b4ad79c462dd78c59b5c0,2018-03-18 19:40:09 UTC+0000,7d7f1cb859334dd98eef541fb46ca0c8,48116a8d267146dfa29d9fdd468b874d,1,1,1,1,3
929,f957f2f37db74412a41a9bb2ab756a3d,2016-06-16 22:56:56 UTC+0000,6103ed29e7f6470e84b3ee7ee932e5ca,359217d73a984f118be4a248464868ab,0,3,1,0,4
4282,f9733987790d44ce80be38e4e83b6f02,2016-10-21 08:42:16 UTC+0000,2eb72a50f17e425cb9401c3fe4fe428b,4862d9b69b2c4f7f99da8fd235cfa3fc,1,1,1,1,3
1016,f979162af52c4826ab66b38dbbd4527d,2018-02-10 20:52:18 UTC+0000,de24c7ba0d194356bd346a91f2ace6d1,a6d33c38902546849c36ea7e9e9f0870,7,3,0,1,4
5078,f98926dd2e534a9ebc2deab7bcabed4b,2014-03-25 16:40:36 UTC+0000,b762517d942945e2b0ad022e26a5d660,05444a2f42454327b2ac4b463c0adbe0,1,2,1,1,4
5594,f98bf54c4de64a81937c11c43afea779,2014-05-07 01:02:49 UTC+0000,346f120b519440089873ca95ddff9d3c,18237fb03c8d4d368085a5dd67c5307e,2,2,1,1,4
6621,f9a8e30b98df4e7fa71d349af463a03c,2014-04-09 05:05:53 UTC+0000,b7b002cf2079425d8ea3b8001f5f518d,6774ee9e8f9247728dbbe896726e911a,1,1,1,1,3
5539,f9ae66add0f44763889d8c05adf04c3f,2016-05-11 18:47:16 UTC+0000,594951e4a2e7492e87cd608b85455e22,7124c5c604ee4f6e997a92d5e172c4a7,1,1,1,1,3
7744,f9b3b5f844f54eb7bd8680d201c2852e,2017-01-09 22:38:06 UTC+0000,2dc732d87fc64da09d85a39c2f0ccc0e,369f1c8646b649f6997eae7809696bd5,1,1,1,1,3
2718,f9b6d10886bf44e8b24148cf50621ee9,2014-04-29 19:29:29 UTC+0000,4f360a9d362c47e08f26d8aa904cbb16,1e4cc96c24344c8b806c26c3e6746167,1,2,1,1,4
2960,f9b863eaf4f14844ae1cfefee10154f3,2015-02-26 14:09:39 UTC+0000,9542e0ac3af143cc8e2bcba1308be65c,b953b3a5cd564558a13b7bbe04dd0fd2,1,1,1,1,3
5778,f9b9de1e93654acaab7bc9cd85daa991,2016-08-19 15:05:38 UTC+0000,742597b60993444694998247d00d906b,e0c3c9fc3634444ca0474c231b2f5959,2,2,1,1,4
4450,f9bd3316fe064d8c9dacefe8441b5c58,2017-02-23 00:13:28 UTC+0000,02662d36a8a946009db25466697fed87,729ab1c23fce471ca1bc3741bbbbdeb2,2,1,1,1,3
3323,f9e46f24486747d38f21f351164e1ee3,2018-01-25 04:37:51 UTC+0000,d8e3bc46aed4472ab225a6e071119ab0,914aaa31bada4f3b878ba78e0a76ccc2,1,1,1,1,3
1740,f9f7e7dfa456476b916411c0c1ea2d02,2014-03-07 19:09:33 UTC+0000,e984465dfe654233a6b198112b156525,0eebb6c7f960452fa457747129577f85,0,2,1,0,3
6903,fa03edd91fb54c77afb6a6dad575df10,2017-03-08 00:36:41 UTC+0000,1961e86dd6fd40d68cee381085f6a535,96bbbdd06a334805a0501034d9df1aa4,0,1,1,0,2
1093,fa099e75798342ebbe68de0df9c8577b,2016-08-29 10:46:36 UTC+0000,f0c0cf17bbd74268aabee6e72afd7509,373809641ef04ce68113c70f3d50ef98,1,1,1,1,3
6716,fa0c5c18f99b4fe3bda74111c7877148,2017-01-26 00:26:04 UTC+0000,ab9de5f65abc4062bfc2e278822ad209,6232d3d12c824cbcb3abe1739fa21bd9,1,1,1,1,3
7847,fa0f280fc4f74801a4db1af378c76007,2017-02-13 22:59:44 UTC+0000,7c97c3e0e8cd4fa39806528050726e78,eea5a196d80746bdbfe0d49eea82a670,1,1,1,1,3
3223,fa362cb8334343e0ad4b16ca874f3fd2,2014-03-06 19:52:16 UTC+0000,86e882ace303481987d7423012830b26,4a71c85e58dc4c1a8546574188582a92,2,1,1,1,3
4272,fa366ad9af324869beacf8653622bda6,2016-05-14 01:01:04 UTC+0000,def1a7de39404b79b08799767085996f,20da6628c4074b0eb2f97b04895fdffb,1,1,1,1,3
1720,fa3b5e194a0a4cd095a1f7de8d4f656e,2017-11-13 18:30:52 UTC+0000,af42a4646a0d49de87839c67152ada5c,e5c1b1e23d33414ab51689f793e58625,0,1,1,0,2
7655,fa4e815f260f49a784a1eb0dd78217ab,2017-05-08 11:42:56 UTC+0000,7ffc5e549d9c4aa58955554806880fdc,34e6995ff9cc41ac853af7da4c15cfce,3,1,1,1,3
1556,fa4ed3f5400c4b008d4d870031895e5a,2017-01-24 14:30:55 UTC+0000,ee1626c3249b46688b390dbfcc1b2911,30b1ef88592643dba57c33e4626684c8,0,1,1,0,2
859,fa7378c347d04b0997100c3780330ac1,2016-07-29 14:16:03 UTC+0000,7df60bcb0759415792f8fc1127f0f7ff,986a00b486d9421c872bb527f015cf42,1,1,1,1,3
7732,fa78d00ddcc54be8abef54268342573d,2016-03-01 22:10:27 UTC+0000,28561fe7269f4957befa5420fd30bf8a,96bbbdd06a334805a0501034d9df1aa4,2,2,1,1,4
5292,fa8465fb8bba49858643f1604f21d914,2016-10-28 13:21:49 UTC+0000,7d2dafff89a843dcaa6959b98c8c3df9,87df4dd6d825487987c131a8396c722c,0,1,1,0,2
4320,fa8e049fe34b4dc9893c7b3ecc53d10c,2017-03-28 16:12:55 UTC+0000,4dd017630208486bb93870a5dc3778bb,369f1c8646b649f6997eae7809696bd5,2,1,1,1,3
4988,fa9258484a4840d396b4452c57b83e53,2016-05-15 13:31:11 UTC+0000,cbdfd0177fa541ac92c1c87a8ce65178,58fa5e95fe9e480a9349bbb1d7faaddb,0,2,1,0,3
4440,fa93b1b0d68642718c04c4ac24cf790e,2016-06-01 22:13:00 UTC+0000,bc6da863f8f741b2b6997ebbaed10334,60b50d4d77334a9b9e6a9e353ded4858,0,4,1,0,5
910,fa969422a69f421e9f0f8ef623be6f8f,2018-03-22 02:49:24 UTC+0000,0de14a05266b472584c00993c687b994,7f73dba5f6f546e98a6405bae3a30ea9,1,2,1,1,4
6200,fa9b23d873584fef8aa0350d5ee8e469,2014-03-29 14:50:29 UTC+0000,bcc70b71156142c584e6657191e6be34,b688e766eed04a37b7abc9218aca1ce4,0,1,1,0,2
4547,faa1a2f58f6040e1a215b4c2e47febbc,2016-05-25 03:07:55 UTC+0000,0b9abf99159a4de6890f9d1cdb501284,c89d81cbcc094414898c84bc242d838c,0,1,1,0,2
4707,faac89091c3944da8c72e291fc23874e,2016-11-14 21:06:37 UTC+0000,3c2cada9f4c64c1da17dcc31399de296,77fbf1608de84052bca5b42a28360a72,1,1,1,1,3
2487,fabf05923e3147888885a935359fa317,2016-06-16 15:16:51 UTC+0000,6787ff831fb746bbbaaa399524652820,58fa5e95fe9e480a9349bbb1d7faaddb,0,1,1,0,2
4465,fac4399b29e64f32affcf63319dc013e,2018-04-05 18:38:05 UTC+0000,fe42bbb68a3c4fa9ad5bddc071e565b5,674513a492bf4c85a2fd7678831d205d,1,1,1,1,3
6019,fac7757bd9604cc499e102b668aabc7b,2015-05-29 19:24:04 UTC+0000,b60d5cf481124a34a443f97c24b76b76,a1006e6a58a0447592e2435caa230f78,0,2,1,0,3
6659,fac7db0b250a4c2cbd9b21134b5ce01e,2018-03-02 23:09:25 UTC+0000,2f7309c4422f44bd86aec80869949855,e261d2548fe74a30a386257961c536a6,1,1,1,1,3
8020,fada3586efcc417689d0636ffebbc7aa,2015-07-15 22:25:51 UTC+0000,8153e4b01a124b8a9ea9a51a7a4fdab2,d7afa4e5783641f2844d3979ee8f02fb,2,1,1,1,3
1481,faeac60353ee43bcbf9d1e0cdf1e4d08,2016-08-12 13:27:10 UTC+0000,7f4ac3323beb4dd1b3503e3cb7f3c0a6,757a51fd3f2d4b4a8c0f209046e55810,2,1,1,1,3
2543,faec9ad91a0f488a89847a7fc31c27c6,2018-02-16 04:25:28 UTC+0000,e880c1a4e9ee4d10ad6c2b6ed4904d79,30a510b81eed40d08fc5e5fefdd87226,2,1,1,1,3
2805,faf2e0e889844968bbbf9df3081c1b83,2015-03-24 20:21:54 UTC+0000,eff92913b5fc463b82d0040866e703dd,3b7e352267da403695a5c0f50f28da8b,0,1,1,0,2
5684,fafa2dc176e6479fab722acf1fd0d2de,2015-11-05 05:46:06 UTC+0000,c856f5aaf7fa4a43a67f4652eaa15269,c62aed408c31483e858a51109bf42a1a,0,4,1,0,5
7138,fb0157e60d244beba5023f169099dece,2017-09-28 10:57:58 UTC+0000,bbebcac7cd744d609140853c1cea3d2f,02c8eda16f214461b44884870666433f,0,1,1,0,2
3474,fb05881cf8ff41229d8a8a5f6f6b6425,2016-03-02 15:28:31 UTC+0000,bfae76b6c10744a39d5321af667e995c,96bbbdd06a334805a0501034d9df1aa4,1,2,1,1,4
482,fb25d6445bf442148fc2fa3c747ebc3a,2018-05-17 17:04:33 UTC+0000,062b19e485c74678b22baa3eacb70c22,01b97ca1d76a4cd4af5907d17cbb7da4,1,1,1,1,3
4217,fb2a5b2f6bfe471fa690ec3c4aa2b76a,2018-05-21 11:11:27 UTC+0000,0d44e89241fd4654b2f1bd8d36b57ad6,be5d23056fcb4f1287c823beec5291e1,1,2,1,1,4
1841,fb5291b45ea546cca7a3a60afb985aba,2016-02-21 04:57:06 UTC+0000,894a3b9d8f7b4e53ae01cd2ff73af847,ed54d56550da44a897658c588dd5032a,1,2,1,1,4
1798,fb626218b7204100817c2c08663fd44f,2018-02-20 22:37:43 UTC+0000,c486d3ebcd9640549193ab18804f0b7e,a6d33c38902546849c36ea7e9e9f0870,3,1,1,1,3
793,fb6ad6986b8745758d8f0be6510c539f,2017-08-14 22:02:18 UTC+0000,1b79799563ae4fb1b04e51cd3d2d2a53,6d8860fb9c81435cb5afb20df04ccd5f,2,4,0,1,5
4517,fb76a2dcd9164b7ca4552e7eff59998d,2016-07-09 22:37:51 UTC+0000,9c1f8488e23849aeade1a84215437654,5b85a1dee8b74d79a87d53e758d897c4,2,1,1,1,3
7893,fb7b8e8bc46b4e49910a649f057f5f8d,2015-10-09 18:30:47 UTC+0000,42afa4bbfbc1414389b75b44d73b7f52,8f80d9dea05243608687b7e131144469,1,1,1,1,3
7029,fb7e4948dcb84f6b96c873285774a9ae,2016-07-26 21:57:48 UTC+0000,9ac80ce1a61e46918fe9c0c142c7d7b0,a1006e6a58a0447592e2435caa230f78,1,1,1,1,3
6656,fb85805827994b0197ef2264e3a85cc8,2016-05-03 00:16:42 UTC+0000,a08157b3db15454ea1d9f588331bf6ed,20397ef7d30443eaaa3ab464d6f14b8f,0,1,1,0,2
5105,fbac097b4946480dbecc1071b47e2104,2016-07-19 11:19:08 UTC+0000,0b2a72eb70df456fa8aeb198e8d642a1,36ff3b3666df400f956f8335cf53e09e,1,2,1,1,4
5853,fbbefc52313d4e25b699007afa66ff13,2017-01-14 16:55:12 UTC+0000,740d972d8f27491885a7b5be75363fb6,6232d3d12c824cbcb3abe1739fa21bd9,1,1,1,1,3
4727,fbc277c8d1f043799c73273f9f847a61,2016-05-13 20:01:52 UTC+0000,55a7169681f14968b61c67cbf54e873f,63aca8fca6f349b8bb2d7d1bb3c5b0f5,2,1,1,1,3
2090,fbc42efc1c9247bdbdaf4fb56593458f,2016-05-20 01:59:13 UTC+0000,bf640fe024314a44b9bff5fb6f7f5ca1,ce4132b1842e41edb9a830f591f2bc39,3,1,1,1,3
7264,fbccce2b3e1840e89ca3d115a8e371a8,2016-09-09 11:39:14 UTC+0000,01324b0c0df74c2682e931d20cd6e573,35896fffa3e847fe8700f9d52c5d23cc,0,1,1,0,2
5801,fbd420a75f6749c18332f1867d2ffb94,2015-11-02 22:33:08 UTC+0000,2a024a301f31407a9aa7898811bd69f0,6f92bbe4fd154f7eb4fb87697999cb14,1,1,1,1,3
7706,fbdb8d6ee3024294b59f8cab8d5e4f51,2016-07-26 16:56:41 UTC+0000,e6934591fbc84b14a6987842f0dfbb2a,90275e799320405bbd2521b88a580ee9,1,1,1,1,3
3853,fbe15b7b17ee4333ad2425bc426eb295,2018-01-27 14:06:56 UTC+0000,d0aa474ae4204c6388b99108815b978e,81a594b683d54e6dbb4b04ea00a5e25b,0,1,1,0,2
1216,fbe429d9a8a141a4a60f341db2e5ae69,2017-06-20 06:37:35 UTC+0000,4d1d9f844c544881a89e29a8972ead4d,c3b31d9a9e8547a5ae73916e95f26d29,1,1,1,1,3
5722,fbe8361ee0b9401190c85905caaada03,2016-10-12 13:28:09 UTC+0000,97a6a0e0138347f9b9aac05ff7ca3693,369f1c8646b649f6997eae7809696bd5,2,1,1,1,3
3423,fbef77e9895e4badb9a3d6cb7baa5c3d,2015-09-24 15:15:37 UTC+0000,fbe3a9c6b6614ff98dbbf96ead7a4ab3,369f1c8646b649f6997eae7809696bd5,1,1,1,1,3
5930,fbefcf3d7c32468fbea4e0695bbd760a,2017-04-02 19:17:41 UTC+0000,badfb5f6e0e942adb8fecf1cfb052e0e,a1006e6a58a0447592e2435caa230f78,0,1,1,0,2
2634,fbfbdbd0415f422c9412e3e05c82f613,2016-01-11 01:28:14 UTC+0000,fe1ecf7228ea4d6ca7fd39bfde182a28,a1006e6a58a0447592e2435caa230f78,2,2,1,1,4
1436,fc098dc09b1449f08ccca80e705490fd,2016-12-17 19:39:35 UTC+0000,a70d35070f6442eb8d7492dcb2690cde,899d9edd944048aaae4faf23bc96493a,0,1,1,0,2
1019,fc0c00a6c9f940b39dacb4ac3f2e044d,2016-08-30 01:10:53 UTC+0000,887651de7b09419fbd41e6c444ac361b,4e0f0fffe8c941ee844e650082267fb9,2,1,1,1,3
694,fc0e49e743d04e7c8c010660aa46da07,2016-12-03 14:14:12 UTC+0000,0bb847630f60489ab20825c502361db6,7e721be7613246dd9f1aee1fb31271b2,1,2,1,1,4
1639,fc1108544140455cb48681adf3835abc,2017-03-09 23:30:26 UTC+0000,6827812aa8b94c64aee8c543595c0049,44a614e4c62c496b9b52f9dbd076be13,1,1,1,1,3
676,fc11f3c547664f2a859a422da50e0665,2017-02-21 19:09:11 UTC+0000,f3bdbb6a7c9e49d99242018b81aa6a2d,cff9a9679be1434f93afd0caadea94bd,0,7,0,0,7
1622,fc18d7ab9ac446aca04b80d4f7cafe8d,2017-11-10 17:40:19 UTC+0000,3b315c9409ad450e9c6b9a58fec47152,d938178ba7454d3d87bbe72cebb24256,1,2,1,1,4
6107,fc295546bfbf4d41ba968f73fa81e91b,2017-03-02 13:10:27 UTC+0000,cb96be855ea64557a6229602cf1513c2,0895796423534563adcec1c208e9e0bf,0,1,1,0,2
5583,fc380ef1bc6e462fbdf96e9a33f08dd2,2013-04-13 21:53:09 UTC+0000,1071e9b2edf044d1ad21232748da5d33,ea2d696eb4374341a22145ca07fcd3ff,2,1,1,1,3
3940,fc3ae330c1b34dff8ae61cbff6f75886,2017-03-07 08:48:33 UTC+0000,cf33925387164d6393b3f215fa046e1d,211e39ac71694bb5af233b205a0f2057,1,1,1,1,3
6754,fc5b785ccbba48f5ac7c929f16cd20d4,2014-03-13 17:06:31 UTC+0000,935dcf43a7cb4ae398585a79d4d171cd,1fbcd8b315de45c29ff87cf912b535fc,3,2,1,1,4
6226,fc672127796b4a7cb82ee6b1f988ad16,2016-05-20 16:53:55 UTC+0000,31f587823a8d4d8ca16a5882f3155e7f,774aac067b9045b68849d5ddc37d2f5f,0,1,1,0,2
2043,fc75f7cbffe541419a9ba0bb7e278eba,2018-03-02 23:15:34 UTC+0000,85d8ff642dbe4cc7acfeb4aef991fbc3,4635dfed8f674c0eb5d40fca91b42599,1,1,1,1,3
870,fc7be362b0ef4207bd5751c725542cb9,2018-11-01 02:26:11 UTC+0000,88c436dda5464679b3978a561c362631,a7bf251a290b418e923e8f04a67b7ebb,2,1,1,1,3
7904,fc7f8b830f9748239127709ee31f0dd9,2016-10-24 13:27:49 UTC+0000,1d3c7f6fee384780b62938828df1dd6e,899d9edd944048aaae4faf23bc96493a,0,1,1,0,2
7382,fc86f9a5287446f79717a61b0e472a4d,2014-04-30 00:01:09 UTC+0000,8c1d9b1dfe564da2997f6126632e3d79,fe4543418c0846e5a65fa22b4ad9a304,1,2,1,1,4
7755,fc8cad6f0efa47ac96c62fb29e288a0c,2016-03-23 08:21:24 UTC+0000,7cbcac657b6144b3b839c66e57c35624,0487120f6a2545048565c620542ead2f,4,2,1,1,4
5056,fc8dc26ff8b5453095cf9299250ce07c,2016-10-23 01:12:22 UTC+0000,22af31a78605407cb3dffd9d7e56ee5b,36ff3b3666df400f956f8335cf53e09e,0,1,1,0,2
272,fc953e7a31b94a31801c5a5c5a7de51f,2018-06-22 05:22:36 UTC+0000,4df796a27de04f52a7023cb1f20fd25a,59ad63ce14fe4cf2bad9f3de2501a324,0,1,1,0,2
1959,fc9628d58ecc428fa52620325c1a6eef,2015-05-19 17:20:56 UTC+0000,07061ca4b23d4fa39302cebca9d14641,b403493d43fe434c98ee997ab23de7f3,1,1,1,1,3
123,fc9b180ee0894c5ba33cbed6752773bb,2017-03-19 00:12:19 UTC+0000,463310880b5b4e8d8f29bb32819e8fcd,34ed19c6ac89412d9ed7b2f31cb394a0,1,2,1,1,4
469,fca26e9d66af4e2e841f2394dc5b746a,2014-11-05 02:04:48 UTC+0000,483ce14b70b440eea0c5bb1d1ef8c27b,1d8d4ea9cd03402cb4b34aa41ad9f3a0,1,1,1,1,3
6822,fca7b7455bb44bb2ae6f8360a110aafd,2017-02-09 17:24:59 UTC+0000,b28b97cbb3ab4dddac3d041c45e51bb9,d67ce930870945109a7ad86d29ba2035,1,1,1,1,3
736,fca9a434ed8045f58950d24e66d7a4b3,2016-06-22 19:55:20 UTC+0000,5ac52c1a206d4f309f8aee8f41dbec34,fe5fc534894e45c191e87f8c2ea0c6bd,3,6,1,1,8
3505,fcb9e0d5959441feb0d781f06cf4eb01,2017-02-19 15:25:06 UTC+0000,ebd04c372f944480a996d74e9bda40fe,36ff3b3666df400f956f8335cf53e09e,3,2,1,1,4
7909,fcec198d49b541b2846008718b17a13e,2018-01-24 18:24:08 UTC+0000,bfb0030ceb65413ab41f113693220304,12dd7a9788bf47078e0a123d3677aa0b,2,2,1,1,4
4174,fcee43dddcf546baa6837013213de7f5,2018-05-01 13:12:44 UTC+0000,984c279b69d84c72bd65919ef973dfd7,4dc61581ec7b409bbd037e483f53ba0a,0,1,1,0,2
2669,fcf0676436dc471ebf54bea9bb1b7aa3,2015-02-26 16:53:23 UTC+0000,4534d593a0ef4c359e4c46b75f486bf5,77e2af08888a4965aad9689d9b9b34a1,2,1,1,1,3
4893,fcf3461a2f3c4415a62edee9c4e98c04,2017-01-26 18:22:03 UTC+0000,0f5f3d188d4d4dffb5002a03c8287adc,5688325ccc864f5fb814dbb388f83411,0,1,1,0,2
2195,fcfbdf7edc3142b0b65fdcbca38d4e45,2016-03-17 18:59:56 UTC+0000,b869a5714aa2496ab15a713d95ca7757,e445f0a390ef45b8987347f6054bc8c8,1,2,1,1,4
7749,fd0392951d424546bb3e4670ae5dcb12,2016-12-14 13:49:43 UTC+0000,a73a790c5aaa4d69bd990f5ff956c4e7,9a16c085d12445a49a2faf2a3c68a4b8,1,3,1,1,5
2162,fd23df0863d6494785782e2775f09ebb,2017-05-27 19:38:45 UTC+0000,57061560969344caaba3439c2afb4861,be5d23056fcb4f1287c823beec5291e1,1,2,1,1,4
5274,fd260b0ff41d4564a794d97cdc9da8b6,2018-08-06 23:47:42 UTC+0000,5f637683c8504294a62269a27093f97c,a851324e19584e9e8785b76543c11d87,1,1,1,1,3
5567,fd2a1f9148554d0e9a965f581dce3a16,2016-04-25 16:37:57 UTC+0000,48c24290d0ca4440b7f7fefc58aa35ed,73e520a49c864919bf439ea61c913ed4,2,1,1,1,3
194,fd2d09b748294ab68157dc732e198605,2016-08-15 13:26:43 UTC+0000,f4b2c542e7d748f6be1e0438f9667b47,f197389752254bf0847cd33cb9c8d9ba,1,1,1,1,3
6350,fd5e0d9a617f4e81bca845871aac1c07,2014-04-05 12:40:24 UTC+0000,1f9c60f916364a268c8d65b8210bc5c6,f33a960155944fb781de493e371ae46f,0,3,1,0,4
4470,fd8fb54f51884b05bb3d4533f380c5b1,2015-10-22 19:28:19 UTC+0000,e4afd4f10cac4f258185467c27b1dd5e,369f1c8646b649f6997eae7809696bd5,2,2,1,1,4
4205,fd99c40c15d548d29ef2e10d3fbe5746,2018-03-22 23:21:32 UTC+0000,176f780360ca476a80ef2f67314a487e,887c5a142b42466fb74740d72989fc74,1,1,1,1,3
6751,fda79ec6aae04cf9b8af49ab019accd9,2016-05-17 23:21:27 UTC+0000,c44cbdff294d4fd19834a887f2345384,e1d39b665987455fbcfbec3fc6df6056,2,2,1,1,4
6673,fdb9b62628f542798b5ff16efa5d3727,2015-10-28 18:17:11 UTC+0000,85bc7916fdb1494cbc2bf7c8541d192c,a1006e6a58a0447592e2435caa230f78,0,1,1,0,2
1129,fdbc63ea39a342bc9dbcecd9ada526d6,2016-01-11 23:22:44 UTC+0000,d76a0ac4eb41444087580038ee864239,d2c9d0b9fff54e5f932144d5eb5015f0,18,1,1,1,3
5527,fdbe920df0a34b5f985e3e94b63c4cee,2014-04-25 19:12:37 UTC+0000,261d2c164ad24fce9becd90d7b8e8426,fe4543418c0846e5a65fa22b4ad9a304,1,1,1,1,3
7150,fdc84496953549edb46c90745595fd57,2016-05-29 17:16:45 UTC+0000,95d152a9c9ea4e63ae11712d11a930ca,1272964da2504fe8a8a6400539cd8b1f,0,1,1,0,2
5069,fdd2222f3eff453eb4a3db0aef364931,2016-05-12 21:35:27 UTC+0000,0c7e5be0816b427289a2f617e441d4a9,5b85a1dee8b74d79a87d53e758d897c4,5,1,1,1,3
7167,fdea1804e8454cdeaa60a6f54ee94ed9,2012-01-09 16:22:37 UTC+0000,c643a5cc6a4f4f02bc91bd663cf33577,b1776598991649088c0a00a6e0a2c766,30,3,1,1,5
3120,fdec0920e1914129903131688496b39d,2017-04-19 11:28:48 UTC+0000,ce98c244a7144b9f93809cf682bd8856,be5d23056fcb4f1287c823beec5291e1,1,1,1,1,3
465,fdf3f99b17f54b35b0884ba19466acc4,2016-07-02 23:32:49 UTC+0000,7349c17766b4451b99a5961f92b76c79,42deada7c50c4859a34615d70193317e,1,1,1,1,3
5304,fdf4fb1c340c40a6b95e903ffa25236a,2016-05-12 17:05:18 UTC+0000,700f21ed213346dc8fc68847b496a3cd,e08c6ad14ba24315afc5985dedc71be5,0,1,1,0,2
1347,fdfab11864c0494a8264ad5cf2ede38c,2018-10-04 00:49:33 UTC+0000,84dc56d1ab374d75b4a98639467a2098,9d156b9a1650453fbeeb196f47c89576,1,1,1,1,3
284,fe068ab2674e45dfb88b158f56121bed,2018-07-30 00:42:41 UTC+0000,d276e232803b4bc1b59195f69d6588c7,826e706f2e564d52856aa71abff6a00e,0,1,1,0,2
7467,fe17f87daeb746b2b47b84982bbd6f20,2016-06-24 12:49:06 UTC+0000,9f00c65ca01d45a6b349e834c53d8a48,36ff3b3666df400f956f8335cf53e09e,0,2,1,0,3
6558,fe196f1fb0314cc486a998a08c72683e,2016-06-12 00:14:43 UTC+0000,861c1b8bc11248a9b7ea570f245ffacb,58fa5e95fe9e480a9349bbb1d7faaddb,2,2,1,1,4
6538,fe41cc71e6874532b55adfbc422ccbb4,2015-04-08 19:24:51 UTC+0000,f43803ba80d54f838f208a4e2096286d,1e4cc96c24344c8b806c26c3e6746167,4,5,1,1,7
3296,fe57fb165c364afeaa6f8fcef6e9a2e5,2016-05-21 16:57:19 UTC+0000,21059dfbfc00426d80509619c3925f07,58fa5e95fe9e480a9349bbb1d7faaddb,0,1,1,0,2
4956,fe61c07279dd47669595b29dc3cf8f20,2017-02-22 21:54:08 UTC+0000,93bd02520a2c4fa7a8b81067d72b2170,9e0cb2a2914c4d05be76c85e7ca356a7,0,1,1,0,2
1524,fe77da4d6b69473ba55439257b3c9655,2016-10-22 04:10:06 UTC+0000,88ce6fe22ed44e1aa4a6d7d36801698d,41149875d05f47a4905cc1466ed6ab34,0,2,1,0,3
3836,fe7a1f1606ac43c382ba6095ab5608b0,2017-06-20 17:25:26 UTC+0000,5c6aff78d45e45f49f0681e0cdc0d4a8,076b94e4d4e5471c97a9d42b0f4fda1c,0,3,1,0,4
6930,fe7bd5ab276845dc84328e6fe4347f63,2017-10-16 07:20:11 UTC+0000,05bf1bcf76f1494eaf5051aedb039cd3,cc108f1440844808afe5a249fe084490,1,1,1,1,3
4733,fe8920de0e014b94be016c8d2785f913,2014-04-09 04:43:03 UTC+0000,d576ec3316a0400780d0c6b20486b77f,6774ee9e8f9247728dbbe896726e911a,6,2,1,1,4
727,fe8de6caa05a4c93903d34924e4e7ce6,2018-04-11 14:31:03 UTC+0000,f0ed257ba24743369d220b9b0593852e,674513a492bf4c85a2fd7678831d205d,0,2,1,0,3
3165,fe9c44284fd747fd9b9089ce52a48541,2018-04-03 18:20:35 UTC+0000,276706d8d3c74875a8bf9f555dede62f,05ab77d4c6a141b999044ebbf5415b0d,1,1,1,1,3
2845,fea6b8dbb0c54fe583d9c75729a0d19c,2018-08-20 15:04:23 UTC+0000,0688b307d52e427b915b385ef0f2a3ad,36ff3b3666df400f956f8335cf53e09e,0,1,1,0,2
1632,fea935775d7c466ca5cb947cc0421062,2016-05-04 22:36:41 UTC+0000,b6307856e59a40579c5d779419eb8438,656f79a3e38d46f8b6a311209cec6690,1,1,1,1,3
3638,feb9306289f44ede92c94656d153a766,2018-09-03 05:19:06 UTC+0000,fa4416613920459a8a91b1f2bb5d8b28,0d4cd29c55c64547b0488a9cdcb218ce,0,1,1,0,2
3880,febab3205ee148c380e0eeb6bfa0c45e,2016-04-29 19:27:27 UTC+0000,c8a9a66253974619beb6d551186f64a9,369f1c8646b649f6997eae7809696bd5,0,1,1,0,2
7057,fec5ff8a51914a378111db5db8828fc1,2016-06-22 05:14:03 UTC+0000,69daf88afa2147248c19a805c0fd3fc5,4dc7d9040592416f98c0bef1ad2c31f5,0,1,1,0,2
3408,fec9bd052db1463db19d54e087008671,2016-11-11 21:36:15 UTC+0000,059576c0c2f7444bb985dbc56dc2f13e,2345ff01e35a45a4bb9f863c2907be39,2,1,1,1,3
6805,fece32ef57304e7eb3d88f2fa74c826d,2015-10-25 21:04:18 UTC+0000,c51887df20b941e48b8bbde8b1c87324,a1006e6a58a0447592e2435caa230f78,1,1,1,1,3
1010,fee844aab7a147c2816bc2f1d3c20dbf,2019-01-28 23:57:24 UTC+0000,30901132449849b2aa18f308306e89a2,d02f6d9faac24997a7003a59e5f34bd3,1,2,1,1,4
4716,ff2001540cc841818d434284446f2d7b,2018-01-17 05:22:00 UTC+0000,7fdbb5a38ced4ed5b885b13a7d38b88c,49ad078f92f74c5ea4892fdc9337b926,2,3,1,1,5
1795,ff2fd106d1b34701a6d065dfa4cb35ab,2016-10-23 21:29:22 UTC+0000,15680f43b0ad40089d1c9378d5c181d7,5f95b0ac821e4e8e9b4fa9fc8eb9ff61,2,1,1,1,3
5448,ff370f5516984405be75626575377889,2012-09-08 15:32:20 UTC+0000,d7ccd7bece7e4e48bdd1c3c23b4053d0,38bc1866f29744f9a003e2e826e3fcb1,2,2,1,1,4
5864,ff398e9a1f0042d1bd86efcd37238659,2015-03-09 20:40:26 UTC+0000,62e524ee9d0c4f08acad62896915745f,bc46e3699d92477ba8c7aa723e54a151,3,1,1,1,3
6445,ff4237248d494dbea25d4404a0f7ce65,2016-02-17 17:47:56 UTC+0000,c6fd06cf931e4f8a8ed1b2c5975cacf7,a1006e6a58a0447592e2435caa230f78,2,1,1,1,3
3146,ff55f240ea6746be9f8443eb4aff9e7e,2014-04-10 03:39:36 UTC+0000,9fbc7b1de5794975b3a574b8d69abe01,6774ee9e8f9247728dbbe896726e911a,1,1,1,1,3
1252,ff5c2567db8f4514b3a5924bb17b8613,2014-04-08 18:38:25 UTC+0000,e14ed3431f1f4a6782dfba1190016eb0,24fac8940aff427c848b2a59265c1204,1,2,1,1,4
975,ff61e9c5edab4730b95b9b5a5ad22521,2014-03-12 20:36:56 UTC+0000,f30c11fc50c1416ab0bb8832b2fcfb75,2adab7916b3747af85b2d82e188c1dc3,4,4,1,1,6
3259,ff692fbec8174535b8996aad239f0d8f,2016-05-02 23:45:23 UTC+0000,122a1945e5a4402b8498d8d56a66efc7,9cedda83713f492cbc45a2d1999d41a1,2,1,1,1,3
6933,ff798f02dd91487bbe1db8f5cd369536,2018-03-02 21:34:06 UTC+0000,afc4fe7668714bc8a0b936029af29595,46be2cf3b8fc49b6b8b3e62ee72a75fe,1,1,1,1,3
7766,ff91b4d257d049d5b311dba555160f47,2017-01-13 14:08:21 UTC+0000,3f48f0a6f2c54a4eb48cb6950a997214,36ff3b3666df400f956f8335cf53e09e,1,2,1,1,4
1899,ffbbae76b05e4eacbe7d358d041bbe19,2016-10-26 01:22:51 UTC+0000,f9c0a616e8904dcbab66ca15091e45f7,fafeba89ca764bd891862fb8440a2962,0,1,1,0,2
1684,ffc201f33712429a8e9feb51f106cdf8,2015-09-18 19:06:42 UTC+0000,2657812dde9648c69438e3ca87d07625,a1006e6a58a0447592e2435caa230f78,1,3,1,1,5
6215,ffc401dcce5d437c86f5f0576c5f3d69,2017-03-25 15:15:33 UTC+0000,45c0a57deead4bd0b641b047aa0ddcd7,65cd85193d2d43c385ca5a5abce62e63,0,1,1,0,2
7074,ffe4bf409a1a48baa004654eb0d2e6f2,2017-02-24 02:18:24 UTC+0000,b98a4e35599e44d495022c71ac3f5516,1806af6b93c74d159c7aad68c6e7a35e,0,1,1,0,2
1818,ffe4f998cf7c4bf5a38f5406db1ca746,2018-03-01 00:41:33 UTC+0000,1190ed4125aa4a2493b40ad9e37bca9c,84e133c3aa6b402392920181f7077830,1,1,1,1,3
